date,stock_id,buy_Dealer_Hedging,buy_Dealer_self,buy_Foreign_Dealer_Self,buy_Foreign_Investor,buy_Investment_Trust,net_Dealer_Hedging,net_Dealer_self,net_Foreign_Dealer_Self,net_Foreign_Investor,net_Investment_Trust,sell_Dealer_Hedging,sell_Dealer_self,sell_Foreign_Dealer_Self,sell_Foreign_Investor,sell_Investment_Trust,net_Dealer_Hedging_5d,net_Dealer_Hedging_20d,net_Dealer_self_5d,net_Dealer_self_20d,net_Foreign_Dealer_Self_5d,net_Foreign_Dealer_Self_20d,net_Foreign_Investor_5d,net_Foreign_Investor_20d,net_Investment_Trust_5d,net_Investment_Trust_20d
2024-09-23,2308,55809,124100,0,3390484,13000,32809,94100,0,1092483,-97000,23000,30000,0,2298001,110000,32809.0,32809.0,94100.0,94100.0,0.0,0.0,1092483.0,1092483.0,-97000.0,-97000.0
2024-09-24,2308,111060,60101,0,2363412,3000,51459,58075,0,718274,-223444,59601,2026,0,1645138,226444,84268.0,84268.0,152175.0,152175.0,0.0,0.0,1810757.0,1810757.0,-320444.0,-320444.0
2024-09-25,2308,175567,391100,0,3908162,181000,119628,341100,0,-2025826,-25415,55939,50000,0,5933988,206415,203896.0,203896.0,493275.0,493275.0,0.0,0.0,-215069.0,-215069.0,-345859.0,-345859.0
2024-09-26,2308,214412,544374,0,3310502,626000,171301,479300,0,-2079670,385129,43111,65074,0,5390172,240871,375197.0,375197.0,972575.0,972575.0,0.0,0.0,-2294739.0,-2294739.0,39270.0,39270.0
2024-09-27,2308,218405,457275,0,6483536,11000,150985,423764,0,877361,-120378,67420,33511,0,5606175,131378,526182.0,526182.0,1396339.0,1396339.0,0.0,0.0,-1417378.0,-1417378.0,-81108.0,-81108.0
2024-09-30,2308,64797,121000,0,4580063,6000,-246082,-211831,0,-1838205,-171378,310879,332831,0,6418268,177378,247291.0,280100.0,1090408.0,1184508.0,0.0,0.0,-4348066.0,-3255583.0,-155486.0,-252486.0
2024-10-01,2308,84344,94000,0,4054050,4000,-16043,-48913,0,1455005,-325690,100387,142913,0,2599045,329690,179789.0,264057.0,983420.0,1135595.0,0.0,0.0,-3611335.0,-1800578.0,-257732.0,-578176.0
2024-10-04,2308,307906,248000,0,7687410,45000,-22382,-556199,0,-7675786,-262444,330288,804199,0,15363196,307444,37779.0,241675.0,86121.0,579396.0,0.0,0.0,-9261295.0,-9476364.0,-494761.0,-840620.0
2024-10-07,2308,218029,291000,0,7900149,97000,145081,233039,0,-928846,-2556500,72948,57961,0,8828995,2653500,11559.0,386756.0,-160140.0,812435.0,0.0,0.0,-8110471.0,-10405210.0,-3436390.0,-3397120.0
2024-10-08,2308,168364,51250,0,8127097,56000,29367,-125950,0,2552709,-170523,138997,177200,0,5574388,226523,-110059.0,416123.0,-709854.0,686485.0,0.0,0.0,-6435123.0,-7852501.0,-3486535.0,-3567643.0
2024-10-09,2308,44847,32000,0,6504822,7000,-195756,-198100,0,1894826,-187689,240603,230100,0,4609996,194689,-59733.0,220367.0,-696123.0,488385.0,0.0,0.0,-2702092.0,-5957675.0,-3502846.0,-3755332.0
2024-10-11,2308,55979,90000,0,3694285,38000,15575,-6997,0,118667,-336979,40404,96997,0,3575618,374979,-28115.0,235942.0,-654207.0,481388.0,0.0,0.0,-4038430.0,-5839008.0,-3514135.0,-4092311.0
2024-10-14,2308,210532,51800,0,4499238,68000,83675,1800,0,1447003,56166,126857,50000,0,3052235,11834,77942.0,319617.0,-96208.0,483188.0,0.0,0.0,5084359.0,-4392005.0,-3195525.0,-4036145.0
2024-10-15,2308,307659,301700,0,8441038,244500,210509,274050,0,3328743,64122,97150,27650,0,5112295,180378,143370.0,530126.0,-55197.0,757238.0,0.0,0.0,9341948.0,-1063262.0,-574903.0,-3972023.0
2024-10-16,2308,109000,235000,0,4406405,34000,-293800,93969,0,-1002578,-589133,402800,141031,0,5408983,623133,-179797.0,236326.0,164722.0,851207.0,0.0,0.0,5786661.0,-2065840.0,-993513.0,-4561156.0
2024-10-17,2308,131577,179000,0,4950050,89000,88119,117076,0,2638005,-591000,43458,61924,0,2312045,680000,104078.0,324445.0,479898.0,968283.0,0.0,0.0,6529840.0,572165.0,-1396824.0,-5152156.0
2024-10-18,2308,290259,285591,0,10254650,203000,64807,185591,0,5362369,193622,225452,100000,0,4892281,9378,153310.0,389252.0,672486.0,1153874.0,0.0,0.0,11773542.0,5934534.0,-866223.0,-4958534.0
2024-10-21,2308,30057,118000,0,3128351,103000,-3853,-2000,0,-248516,52311,33910,120000,0,3376867,50689,65782.0,385399.0,668686.0,1151874.0,0.0,0.0,10078023.0,5686018.0,-870078.0,-4906223.0
2024-10-22,2308,77356,56900,0,5095442,136000,30904,-32100,0,1793764,101311,46452,89000,0,3301678,34689,-113823.0,416303.0,362536.0,1119774.0,0.0,0.0,8543044.0,7479782.0,-832889.0,-4804912.0
2024-10-23,2308,22049,40000,0,1597466,154000,-40067,-116300,0,-454959,70556,62116,156300,0,2052425,83444,139910.0,376236.0,152267.0,1003474.0,0.0,0.0,9090663.0,7024823.0,-173200.0,-4734356.0
2024-10-24,2308,45640,19000,0,2805089,112733,-50860,-255400,0,-401848,87044,96500,274400,0,3206937,25689,931.0,292567.0,-220209.0,653974.0,0.0,0.0,6050810.0,5530492.0,504844.0,-4550312.0
2024-10-25,2308,80671,36000,0,5818569,30733,30910,-12000,0,3565303,-956,49761,48000,0,2253266,31689,-32966.0,272018.0,-417800.0,583899.0,0.0,0.0,4253744.0,8377521.0,310266.0,-4327824.0
2024-10-28,2308,136097,266681,0,6061969,52465,-7283,215681,0,2579776,32801,143380,51000,0,3482193,19664,-36396.0,145107.0,-200119.0,458480.0,0.0,0.0,7082036.0,12983123.0,290756.0,-4269608.0
2024-10-29,2308,54888,50068,0,6424152,331197,-47388,-163930,0,674564,309515,102276,213998,0,5749588,21682,-114688.0,-73582.0,-331949.0,-184750.0,0.0,0.0,5962836.0,15737357.0,498960.0,-4345222.0
2024-10-30,2308,35305,105000,0,11183022,107000,-10694,88800,0,357625,-53682,45999,16200,0,10825397,160682,-85315.0,-235261.0,-126849.0,-519714.0,0.0,0.0,6775420.0,15217621.0,374722.0,-4278526.0
2024-11-01,2308,125124,114159,0,8089894,90732,-6266,-5823,0,-2219474,75732,131390,119982,0,10309368,15000,-40721.0,4555.0,122728.0,-313706.0,0.0,0.0,4957794.0,14836352.0,363410.0,-4031416.0
2024-11-04,2308,37101,22000,0,4754735,206161,14347,10000,0,-356075,-504839,22754,12000,0,5110810,711000,-57284.0,34945.0,144728.0,-254793.0,0.0,0.0,1036416.0,13025272.0,-140473.0,-4210565.0
2024-11-05,2308,84410,16000,0,4625060,47000,-13248,-84500,0,2047299,-16000,97658,100500,0,2577761,63000,-63249.0,44079.0,-155453.0,216906.0,0.0,0.0,503939.0,22748357.0,-189274.0,-3964121.0
2024-11-06,2308,75939,32100,0,4951325,41000,8391,13100,0,904114,33000,67548,19000,0,4047211,8000,-7470.0,-92611.0,21577.0,-3033.0,0.0,0.0,733489.0,24581317.0,-465789.0,-1374621.0
2024-11-07,2308,47000,63000,0,2639475,96732,-15217,29000,0,-1852762,-24268,62217,34000,0,4492237,121000,-11993.0,-137195.0,-38223.0,151917.0,0.0,0.0,-1476898.0,20175846.0,-436375.0,-1228366.0
2024-11-08,2308,51111,114006,0,5244536,50000,10385,88000,0,1430130,-40000,40726,26006,0,3814406,90000,4658.0,68946.0,55600.0,438017.0,0.0,0.0,2172706.0,19711150.0,-552107.0,-1080677.0
2024-11-11,2308,44000,103000,0,6942404,33000,-19463,56000,0,2811944,-519000,63463,47000,0,4130460,552000,-29152.0,33908.0,101600.0,501014.0,0.0,0.0,5340725.0,22404427.0,-566268.0,-1262698.0
2024-11-12,2308,96099,229000,0,8656092,76000,8497,47203,0,1962556,-886000,87602,181797,0,6693536,962000,-7407.0,-41270.0,233303.0,546417.0,0.0,0.0,5255982.0,22919980.0,-1436268.0,-2204864.0
2024-11-13,2308,27095,49000,0,2981858,109390,-48672,-101500,0,-1620739,-5297,75767,150500,0,4602597,114687,-64470.0,-300451.0,118703.0,170867.0,0.0,0.0,2731129.0,17970498.0,-1474565.0,-2274283.0
2024-11-14,2308,20189,69013,0,3961809,126000,-49534,-345477,0,468543,-449000,69723,414490,0,3493266,575000,-98787.0,-56185.0,-255774.0,-268579.0,0.0,0.0,5052434.0,19441619.0,-1899297.0,-2134150.0
2024-11-15,2308,20104,71000,0,3145516,20195,1186,-127000,0,659652,-980805,18918,198000,0,2485864,1001000,-107986.0,-143118.0,-470774.0,-512655.0,0.0,0.0,4281956.0,17463266.0,-2840102.0,-2523955.0
2024-11-18,2308,31134,116029,0,2395020,196463,-28641,14441,0,-130100,-591537,59775,101588,0,2525120,788000,-117164.0,-236566.0,-512333.0,-683805.0,0.0,0.0,1339912.0,11970797.0,-2912639.0,-3309114.0
2024-11-19,2308,74000,101000,0,2826699,304367,25665,5900,0,-646395,27266,48335,95100,0,3473094,277101,-99996.0,-207048.0,-553636.0,-675905.0,0.0,0.0,-1269039.0,11572918.0,-1999373.0,-3334159.0
2024-11-20,2308,65123,382000,0,3769123,179388,-8257,290759,0,-911586,-569612,73380,91241,0,4680709,749000,-59581.0,-246209.0,-161377.0,-353046.0,0.0,0.0,-559886.0,8867568.0,-2563688.0,-4005082.0
2024-11-21,2308,43491,31000,0,4306471,113169,5077,-130100,0,-1971779,-1583831,38414,161100,0,6278250,1697000,-4970.0,-201065.0,54000.0,-366846.0,0.0,0.0,-3000208.0,7350748.0,-3698519.0,-5659469.0
2024-11-22,2308,115477,50000,0,7560705,106000,85329,-37000,0,2139013,20000,30148,87000,0,5421692,86000,79173.0,-64876.0,144000.0,-148446.0,0.0,0.0,-1520847.0,9891609.0,-2697714.0,-5726513.0
2024-11-25,2308,28843,68000,0,9604506,98812,-69867,65000,0,770733,-476267,98710,3000,0,8833773,575079,37947.0,-165653.0,194559.0,-71446.0,0.0,0.0,-620014.0,7097039.0,-2582444.0,-6201824.0
2024-11-26,2308,8196,3000,0,1644221,77000,-25930,-53397,0,-1173501,36682,34126,56397,0,2817722,40318,-13648.0,-184300.0,135262.0,-340524.0,0.0,0.0,-1147120.0,3343762.0,-2573028.0,-6197943.0
2024-11-27,2308,29757,4000,0,1736910,61000,-1981,-19000,0,152211,55895,31738,23000,0,1584699,5105,-7372.0,-138893.0,-174497.0,-195594.0,0.0,0.0,-83323.0,2821409.0,-1947521.0,-6451563.0
2024-11-28,2308,51061,27000,0,1467329,206337,-529,-77300,0,-1830049,-77768,51590,104300,0,3297378,284105,-12978.0,-128728.0,-121697.0,-361694.0,0.0,0.0,58407.0,633735.0,-441458.0,-6475649.0
2024-11-29,2308,38221,129000,0,2863538,59000,16879,0,0,-1709885,-481027,21342,129000,0,4573423,540027,-81428.0,-105583.0,-84697.0,-355871.0,0.0,0.0,-3790491.0,1143324.0,-942485.0,-7032408.0
2024-12-02,2308,49660,19000,0,2091087,183000,22802,-2000,0,859415,-152062,26858,21000,0,1231672,335062,11241.0,-97128.0,-151697.0,-367871.0,0.0,0.0,-3701809.0,2358814.0,-618280.0,-6679631.0
2024-12-03,2308,47000,66496,0,3247394,113000,12873,52496,0,-459755,113000,34127,14000,0,3707149,0,50044.0,-71007.0,-45804.0,-230875.0,0.0,0.0,-2988063.0,-148240.0,-541962.0,-6550631.0
2024-12-04,2308,18500,26000,0,2552989,3000,-6593,3000,0,624989,-212524,25093,23000,0,1928000,215524,45432.0,-85991.0,-23804.0,-240975.0,0.0,0.0,-2515285.0,-427365.0,-810381.0,-6796155.0
2024-12-05,2308,10752,10000,0,3581134,0,-3256,6000,0,107141,-460103,14008,4000,0,3473993,460103,42705.0,-74030.0,59496.0,-263975.0,0.0,0.0,-578095.0,1532538.0,-1192716.0,-7231990.0
2024-12-06,2308,101558,140070,0,4508108,609000,73047,118070,0,2461946,576000,28511,22000,0,2046162,33000,98873.0,-11368.0,177566.0,-233905.0,0.0,0.0,3593736.0,2564354.0,-135689.0,-6615990.0
2024-12-09,2308,155805,136221,0,4731782,815000,64357,42221,0,1926422,718000,91448,94000,0,2805360,97000,140428.0,72452.0,221787.0,-247684.0,0.0,0.0,4660743.0,1678832.0,734373.0,-5378990.0
2024-12-10,2308,19877,17279,0,5630724,0,-71553,-5784,0,-354323,-64017,91430,23063,0,5985047,64017,56002.0,-7598.0,163507.0,-300671.0,0.0,0.0,4766175.0,-638047.0,557356.0,-4557007.0
2024-12-11,2308,219076,213133,0,7698297,2003000,83743,40833,0,4252209,1967090,135333,172300,0,3446088,35910,146338.0,124817.0,201340.0,-158338.0,0.0,0.0,8393395.0,5234901.0,2736970.0,-2584620.0
2024-12-12,2308,94389,131000,0,5111726,1142000,-33832,100751,0,-672479,1103897,128221,30249,0,5784205,38103,115762.0,140519.0,296091.0,287890.0,0.0,0.0,7613775.0,4093879.0,4300970.0,-1031723.0
2024-12-13,2308,121283,69977,0,9007151,1439500,-48736,-69023,0,3127913,1414037,170019,139000,0,5879238,25463,-6021.0,90597.0,108998.0,345867.0,0.0,0.0,8279742.0,6562140.0,5139007.0,1363119.0
2024-12-16,2308,70956,62934,0,6147740,104000,-43289,-51066,0,1845382,72226,114245,114000,0,4302358,31774,-113667.0,75949.0,15711.0,280360.0,0.0,0.0,8198702.0,8537622.0,4493233.0,2026882.0
2024-12-17,2308,40376,48907,0,6097796,20753,-38889,-50047,0,1066870,-259620,79265,98954,0,5030926,280373,-81003.0,11395.0,-28552.0,224413.0,0.0,0.0,9619895.0,10250887.0,4297630.0,1739996.0
2024-12-18,2308,96633,50207,0,4999259,104000,45820,-33793,0,1909784,-228142,50813,84000,0,3089475,332142,-118926.0,65472.0,-103178.0,-100139.0,0.0,0.0,7277470.0,13072257.0,2102398.0,2081466.0
2024-12-19,2308,18204,1000,0,4461857,195000,-19676,-50374,0,-283473,105640,37880,51374,0,4745330,89360,-104770.0,40719.0,-254303.0,-20413.0,0.0,0.0,7666476.0,14760563.0,1104141.0,3770937.0
2024-12-20,2308,29452,35000,0,6331556,210000,-43888,-47354,0,401250,-54911,73340,82354,0,5930306,264911,-99922.0,-88498.0,-232634.0,-30767.0,0.0,0.0,4939813.0,13022800.0,-364807.0,3696026.0
2024-12-23,2308,48189,113098,0,4034009,298000,-16616,68933,0,1097321,-214000,64805,44165,0,2936688,512000,-73249.0,-35247.0,-112635.0,-26834.0,0.0,0.0,4191752.0,13349388.0,-651033.0,3958293.0
2024-12-24,2308,105926,101861,0,3360799,10000,66798,75861,0,1011730,-18000,39128,26000,0,2349069,28000,32438.0,57481.0,13273.0,102424.0,0.0,0.0,4136612.0,15534619.0,-409413.0,3903611.0
2024-12-25,2308,7000,97100,0,604489,256000,-56586,45100,0,134771,256000,63586,52000,0,469718,0,-69968.0,2876.0,92166.0,166524.0,0.0,0.0,2361599.0,15517179.0,74729.0,4103716.0
2024-12-26,2308,60555,32000,0,982003,212000,35555,-86000,0,485003,162976,25000,118000,0,497000,49024,-14737.0,38960.0,56540.0,157824.0,0.0,0.0,3130075.0,17832231.0,132065.0,4344460.0
2024-12-27,2308,81565,130042,0,1379141,5000,34565,129042,0,507124,-11680,47000,1000,0,872017,16680,63716.0,56646.0,232936.0,286866.0,0.0,0.0,3235949.0,20049240.0,175296.0,4813807.0
2024-12-30,2308,105047,79170,0,2869388,326000,45552,66170,0,873514,283159,59495,13000,0,1995874,42841,125884.0,79396.0,230173.0,355036.0,0.0,0.0,3012142.0,20063339.0,672455.0,5249028.0
2024-12-31,2308,20376,47000,0,1384356,550467,-61250,-48525,0,-1316304,471223,81626,95525,0,2700660,79244,-2164.0,5273.0,105787.0,254015.0,0.0,0.0,684108.0,19206790.0,1161678.0,5607251.0
2025-01-02,2308,159505,135247,0,6531826,159000,95211,-161924,0,3364003,46585,64294,297171,0,3167823,112415,149633.0,107077.0,-101237.0,89091.0,0.0,0.0,3913340.0,21945804.0,952263.0,5866360.0
2025-01-03,2308,44292,48052,0,7621248,380000,-5813,-45948,0,3815383,380000,50105,94000,0,3805865,0,108265.0,104520.0,-61185.0,37143.0,0.0,0.0,7243720.0,25654046.0,1169287.0,6706463.0
2025-01-06,2308,64489,129200,0,5235708,5000,33666,98942,0,1591842,-1000,30823,30258,0,3643866,6000,107366.0,65139.0,-91285.0,18015.0,0.0,0.0,8328438.0,24783942.0,1179967.0,6129463.0
2025-01-07,2308,78182,171956,0,6242456,81000,21182,114582,0,3532843,47000,57000,57374,0,2709613,34000,82996.0,21964.0,-42873.0,90376.0,0.0,0.0,10987767.0,26390363.0,943808.0,5458463.0
2025-01-08,2308,40461,131514,0,8831517,40000,-100612,-23735,0,1082819,-46274,141073,155249,0,7748698,86274,43634.0,-7095.0,-18083.0,72425.0,0.0,0.0,13386890.0,27827505.0,426311.0,5476206.0
2025-01-09,2308,10108,46108,0,2584746,154000,-54987,-125577,0,-580406,-7233,65095,171685,0,3165152,161233,-106564.0,-145825.0,18264.0,-93985.0,0.0,0.0,9442481.0,22994890.0,372493.0,3501883.0
2025-01-10,2308,14122,33000,0,3214037,11000,-27427,-80990,0,405561,4000,41549,113990,0,2808476,7000,-128178.0,-139420.0,-16778.0,-275726.0,0.0,0.0,6032659.0,24072930.0,-3507.0,2401986.0
2025-01-13,2308,101050,123000,0,4996285,50000,-37947,-67528,0,-2756294,50000,138997,190528,0,7752579,0,-199791.0,-128631.0,-183248.0,-274231.0,0.0,0.0,1684523.0,18188723.0,47493.0,1037949.0
2025-01-14,2308,117650,86800,0,8100970,456000,105831,-58878,0,1198104,452000,11819,145678,0,6902866,4000,-115142.0,20489.0,-356708.0,-282043.0,0.0,0.0,-650216.0,17541445.0,452493.0,1417723.0
2025-01-15,2308,51000,117000,0,6489626,125000,-11987,28742,0,840694,-19000,62987,88258,0,5648932,144000,-26517.0,47391.0,-304231.0,-203254.0,0.0,0.0,-892341.0,17315269.0,479767.0,1658343.0
2025-01-16,2308,111791,254221,0,4521440,3372161,73781,141205,0,408975,3018661,38010,113016,0,4112465,353500,102251.0,75352.0,-37449.0,-28256.0,0.0,0.0,97040.0,15814460.0,3505661.0,4905146.0
2025-01-17,2308,44678,8398,0,4625299,600000,-35852,-58602,0,963506,577370,80530,67000,0,3661793,22630,93826.0,59176.0,-15061.0,-36484.0,0.0,0.0,654985.0,17061439.0,4079031.0,5376876.0
2025-01-20,2308,28667,21018,0,2941324,189000,-15312,3018,0,-46817,186959,43979,18000,0,2988141,2041,116461.0,87752.0,55485.0,13888.0,0.0,0.0,3364462.0,16613372.0,4215990.0,5618746.0
2025-01-21,2308,10405,12000,0,4276589,303800,-30828,2000,0,1319258,-1139833,41233,10000,0,2957331,1443633,-20198.0,73540.0,116363.0,-53045.0,0.0,0.0,3485616.0,16835309.0,2624157.0,4692913.0
2025-01-22,2308,29236,101533,0,5816137,796000,2109,85533,0,1982621,794640,27127,16000,0,3833516,1360,-6102.0,8851.0,173154.0,-43373.0,0.0,0.0,4627543.0,17806200.0,3437797.0,5505553.0
2025-02-03,2308,573355,227000,0,6186381,605657,202450,23591,0,-9169935,253862,370905,203409,0,15356316,351795,122567.0,267887.0,55540.0,-64882.0,0.0,0.0,-4951367.0,8501494.0,672998.0,5503415.0
2025-02-04,2308,54169,22317,0,5214948,89000,-8356,-38339,0,-505105,9000,62525,60656,0,5720053,80000,150063.0,223976.0,75803.0,-17221.0,0.0,0.0,-6419978.0,7511386.0,104628.0,5349439.0
2025-02-05,2308,36024,14000,0,5309814,88000,3110,-13479,0,1886483,65000,32914,27479,0,3423331,23000,168485.0,192521.0,59306.0,-159742.0,0.0,0.0,-4486678.0,8890745.0,-17331.0,5426119.0
2025-02-06,2308,54409,4437,0,7785427,80677,-20591,-16563,0,3704255,68677,75000,21000,0,4081172,12000,178722.0,126378.0,40743.0,-242475.0,0.0,0.0,-2101681.0,11721486.0,1191179.0,5211637.0
2025-02-07,2308,8100,4100,0,2632046,203000,-23403,-17920,0,-285338,-49020,31503,22020,0,2917384,252020,153210.0,164225.0,-62710.0,-211870.0,0.0,0.0,-4369640.0,12752452.0,347519.0,4691394.0
2025-02-10,2308,17208,78000,0,1915935,68354,-12679,18447,0,-1737233,-29989,29887,59553,0,3653168,98343,-61919.0,56335.0,-67854.0,-31499.0,0.0,0.0,3063062.0,7651216.0,63668.0,4614820.0
2025-02-11,2308,52000,34000,0,3739057,18000,21411,-467,0,-1702685,-7630,30589,34467,0,5441742,25630,-32152.0,83559.0,-29982.0,13982.0,0.0,0.0,1865482.0,2133148.0,47038.0,4227190.0
2025-02-12,2308,16734,33000,0,1563269,214000,-6507,2601,0,-1701505,187000,23241,30399,0,3264774,27000,-41769.0,43386.0,-13902.0,-82359.0,0.0,0.0,-1722506.0,-1160199.0,169038.0,4415190.0
2025-02-13,2308,92798,48500,0,5376474,127677,69751,48500,0,-29769,-73323,23047,0,0,5406243,201000,48573.0,91955.0,51161.0,-148441.0,0.0,0.0,-5456530.0,-4722811.0,27038.0,4294867.0
2025-02-14,2308,31000,15000,0,2529957,61677,-2291,-5329,0,-721524,-729323,33291,20329,0,3251481,791000,69685.0,190276.0,63752.0,-130035.0,0.0,0.0,-5892716.0,-6527154.0,-653265.0,3611818.0
2025-02-17,2308,21822,49000,0,2982589,85677,-4259,-99878,0,497019,-276952,26081,148878,0,2485570,362629,78105.0,241004.0,-54573.0,-104336.0,0.0,0.0,-3658464.0,-5449729.0,-900228.0,3342099.0
2025-02-18,2308,535000,169400,0,3773152,15000,19726,78057,0,-9347870,-5361736,515274,91343,0,13121022,5376736,76420.0,288157.0,23951.0,54711.0,0.0,0.0,-11303649.0,-15203160.0,-6254334.0,-2023637.0
2025-02-19,2308,63000,89000,0,2906068,24000,34046,45695,0,-1629197,-764000,28954,43305,0,4535265,788000,116973.0,360150.0,67045.0,167934.0,0.0,0.0,-11231341.0,-14076063.0,-7205334.0,-2837637.0
2025-02-20,2308,31509,70000,0,5248811,8000,-2885,68000,0,-3262226,-158578,34394,2000,0,8511037,166578,44337.0,251434.0,86545.0,294812.0,0.0,0.0,-14463798.0,-18536393.0,-7290589.0,-3448215.0
2025-02-21,2308,47723,29424,0,5406002,20000,25312,-14326,0,-571868,-782000,22411,43750,0,5977870,802000,71940.0,288733.0,77548.0,251744.0,0.0,0.0,-14314142.0,-19948955.0,-7343266.0,-4211215.0
2025-02-24,2308,40892,28000,0,2606255,250000,-13743,-45191,0,-2444098,25371,54635,73191,0,5050353,224629,62456.0,201209.0,132235.0,65348.0,0.0,0.0,-17255259.0,-22802028.0,-7040943.0,-7204505.0
2025-02-25,2308,23000,116000,0,3933130,284626,-39665,11300,0,-1950683,47955,62665,104700,0,5883813,236671,3065.0,197396.0,65478.0,135250.0,0.0,0.0,-9858072.0,-25716217.0,-1631252.0,-7733920.0
2025-02-26,2308,77413,73000,0,6069434,85626,44599,19000,0,-990526,-5045,32814,54000,0,7059960,90671,13618.0,257307.0,38783.0,151232.0,0.0,0.0,-9219401.0,-26659926.0,-872297.0,-7925924.0
2025-02-27,2308,155245,207923,0,14238584,1011672,-7755,19923,0,1856433,942001,163000,188000,0,12382151,69671,8748.0,280380.0,-9294.0,169155.0,0.0,0.0,-4100742.0,-26122751.0,228282.0,-5844090.0
2025-03-03,2308,225243,146000,0,5586595,1085128,97848,-50322,0,-5193949,1041128,127395,196322,0,10780544,44000,81284.0,376119.0,-45290.0,33300.0,0.0,0.0,-8722823.0,-33299321.0,2051410.0,-5597602.0
2025-03-04,2308,278886,218000,0,6496760,207625,74824,-91035,0,-7904185,-2249648,204062,309035,0,14400945,2457273,169851.0,248493.0,-91134.0,-81326.0,0.0,0.0,-14182910.0,-32033571.0,-223609.0,-8101112.0
2025-03-05,2308,42087,63000,0,3996421,47000,38,-26998,0,-3570033,-237629,42049,89998,0,7566454,284629,209554.0,256887.0,-129432.0,-69985.0,0.0,0.0,-15802260.0,-35098499.0,-509193.0,-8347741.0
2025-03-06,2308,52121,34000,0,4095090,59000,28662,11000,0,-1057992,-11258,23459,23000,0,5153082,70258,193617.0,282439.0,-137432.0,-45506.0,0.0,0.0,-15869726.0,-38042974.0,-515406.0,-8423999.0
2025-03-07,2308,26743,12000,0,2825697,53000,-49314,-21286,0,-4641798,2483,76057,33286,0,7467495,50517,152058.0,253716.0,-178641.0,-50229.0,0.0,0.0,-22367957.0,-46389027.0,-1454924.0,-8490193.0
2025-03-10,2308,16833,3000,0,3231441,185625,5838,-97160,0,-1455643,178109,10995,100160,0,4687084,7516,60048.0,282957.0,-225479.0,-129469.0,0.0,0.0,-18629651.0,-47559332.0,-2317943.0,-8263064.0
2025-03-11,2308,100305,52000,0,6070071,142876,56293,-220928,0,-825687,-97124,44012,272928,0,6895758,240000,41517.0,351929.0,-355372.0,-368844.0,0.0,0.0,-11551153.0,-46647786.0,-165419.0,-8330199.0
2025-03-12,2308,36018,57784,0,5182698,3716000,-24370,-61216,0,-2119827,3683627,60388,119000,0,7302525,32373,17109.0,306148.0,-389590.0,-429593.0,0.0,0.0,-10100947.0,-47064928.0,3755837.0,-4638942.0
2025-03-13,2308,99025,27040,0,7220254,945000,-43684,-213960,0,1980440,933742,142709,241000,0,5239814,11258,-55237.0,268971.0,-614550.0,-646154.0,0.0,0.0,-7062515.0,-43382983.0,4700837.0,-3892200.0
2025-03-14,2308,67182,215000,0,4153534,88625,34269,177700,0,-2447627,66625,32913,37300,0,6601161,22000,28346.0,233489.0,-415564.0,-516954.0,0.0,0.0,-4868344.0,-45800841.0,4764979.0,-3752252.0
2025-03-17,2308,146060,38345,0,7924233,1044000,23960,-57655,0,3984681,735371,122100,96000,0,3939552,308629,46468.0,259740.0,-376059.0,-569280.0,0.0,0.0,571980.0,-41094636.0,5322241.0,-2287558.0
2025-03-18,2308,197096,370090,0,4125208,2582000,129860,287062,0,359795,2538133,67236,83028,0,3765413,43867,120035.0,393859.0,131931.0,-182340.0,0.0,0.0,1757462.0,-41231860.0,7957498.0,527527.0
2025-03-19,2308,241573,210795,0,4670037,48000,221679,60789,0,-928210,47374,19894,150006,0,5598247,626,366084.0,595812.0,253936.0,-199608.0,0.0,0.0,2949079.0,-32812200.0,4321245.0,5936637.0
2025-03-20,2308,99324,353319,0,5812317,115000,98664,337308,0,1092023,-623626,660,16011,0,4720294,738626,508432.0,660430.0,805204.0,92005.0,0.0,0.0,2060662.0,-30090980.0,2763877.0,6077011.0
2025-03-21,2308,66189,210436,0,8378014,72173,42470,194340,0,1201629,-1021338,23719,16096,0,7176385,1093511,516633.0,705785.0,821844.0,218345.0,0.0,0.0,5709918.0,-25627125.0,1675914.0,5214251.0
2025-03-24,2308,88170,120073,0,7526196,56000,33302,95925,0,2954651,-325511,54868,24148,0,4571545,381511,525975.0,713775.0,975424.0,328596.0,0.0,0.0,4679888.0,-22100606.0,615032.0,5670740.0
2025-03-25,2308,22538,51861,0,2517068,7000,10157,41861,0,-924831,-10628,12381,10000,0,3441899,17628,406272.0,737675.0,730223.0,415648.0,0.0,0.0,3395262.0,-20581339.0,-1933729.0,5634741.0
2025-03-26,2308,120438,101142,0,8069720,90000,95510,72100,0,6088984,57000,24928,29042,0,1980736,33000,280103.0,872850.0,741534.0,476448.0,0.0,0.0,10412456.0,-12541672.0,-1924103.0,5643786.0
2025-03-27,2308,88337,93064,0,2750850,45057,45925,70762,0,-740596,39057,42412,22302,0,3491446,6000,227364.0,874176.0,474988.0,528210.0,0.0,0.0,8579837.0,-12291742.0,-1261420.0,5687888.0
2025-03-28,2308,51778,14000,0,4464531,89000,-13594,-227128,0,-3778123,-18000,65372,241128,0,8242654,107000,171300.0,868337.0,53520.0,281159.0,0.0,0.0,3600085.0,-17926298.0,-258082.0,4727887.0
2025-03-31,2308,83120,98000,0,4375845,160629,-33218,-425019,0,-2472263,129629,116338,523019,0,6848108,31000,104780.0,737271.0,-467424.0,-93538.0,0.0,0.0,-1826829.0,-15204612.0,197058.0,3816388.0
2025-04-01,2308,67597,35000,0,3368904,113000,39250,-52000,0,-1206857,99000,28347,87000,0,4575761,14000,133873.0,701697.0,-561285.0,-54503.0,0.0,0.0,-2108855.0,-8507284.0,306686.0,6165036.0
2025-04-02,2308,30017,1000,0,2048025,34000,-16928,-28000,0,-146466,-65626,46945,29000,0,2194491,99626,21435.0,684731.0,-661385.0,-55505.0,0.0,0.0,-8344305.0,-5083717.0,184060.0,6337039.0
2025-04-07,2308,461,0,0,1858537,0,-27151,-5000,0,943994,-1044000,27612,5000,0,914543,1044000,-51641.0,628918.0,-737147.0,-71505.0,0.0,0.0,-6659715.0,-3081731.0,-898997.0,5304297.0
2025-04-08,2308,276492,356000,0,18966679,226692,150975,116172,0,183271,170692,125517,239828,0,18783408,56000,112928.0,829207.0,-393847.0,65953.0,0.0,0.0,-2698321.0,1743338.0,-710305.0,5472506.0
2025-04-09,2308,349052,194101,0,10021558,118923,27257,-316877,0,-71072,15294,321795,510978,0,10092630,103629,173403.0,850626.0,-285705.0,-153764.0,0.0,0.0,-297130.0,3127909.0,-824640.0,5309691.0
2025-04-10,2308,198000,1000,0,1721243,0,197842,1000,0,-1032149,0,158,0,0,2753392,0,331995.0,992175.0,-232705.0,68164.0,0.0,0.0,-122422.0,2921447.0,-923640.0,5406815.0
2025-04-11,2308,173337,248000,0,14839455,1013070,-200657,-283740,0,1533063,1005070,373994,531740,0,13306392,8000,148266.0,815888.0,-488445.0,-154360.0,0.0,0.0,1557107.0,6574337.0,147056.0,2728258.0
2025-04-14,2308,153692,141020,0,10690559,134000,16041,-523280,0,-810601,-745689,137651,664300,0,11501160,879689,191458.0,875613.0,-1006725.0,-463680.0,0.0,0.0,-197488.0,3783296.0,445367.0,1048827.0
2025-04-15,2308,46100,50000,0,3892385,160686,-127025,-82926,0,-365546,-293149,173125,132926,0,4257931,453835,-86542.0,714319.0,-1205823.0,-724306.0,0.0,0.0,-746305.0,5865377.0,-18474.0,689053.0
2025-04-16,2308,33503,37000,0,4771051,28000,-589775,-193261,0,8379,-375768,623278,230261,0,4762672,403768,-703574.0,100584.0,-1082207.0,-859912.0,0.0,0.0,-666854.0,1889075.0,-409536.0,-422086.0
2025-04-17,2308,27049,69000,0,8493775,30000,-80338,-145762,0,47708,-1612000,107387,214762,0,8446067,1642000,-981754.0,-109614.0,-1228969.0,-1292736.0,0.0,0.0,413003.0,1576988.0,-2021536.0,-4572219.0
2025-04-18,2308,11644,6000,0,1542500,73000,-63057,-131270,0,393466,-21308,74701,137270,0,1149034,94308,-844154.0,-394350.0,-1076499.0,-1484795.0,0.0,0.0,-726594.0,2898664.0,-3047914.0,-4640901.0
2025-04-21,2308,78088,10000,0,1724829,86000,-9322,-227047,0,-169091,48000,87410,237047,0,1893920,38000,-869517.0,-502336.0,-780266.0,-2049150.0,0.0,0.0,-85084.0,1637550.0,-2254225.0,-3969275.0
2025-04-22,2308,29865,16000,0,3482877,80000,-3488,-125634,0,800165,-559000,33353,141634,0,2682712,639000,-745980.0,-548294.0,-822974.0,-2369124.0,0.0,0.0,1080627.0,1236086.0,-2520076.0,-3506937.0
2025-04-23,2308,53682,43000,0,5096533,316000,-10172,-42000,0,1153179,273237,63854,85000,0,3943354,42763,-166377.0,-591768.0,-671713.0,-2507049.0,0.0,0.0,2225427.0,-565386.0,-1871071.0,-2908189.0
2025-04-24,2308,10675,2000,0,3509438,123000,-22999,-63000,0,-333235,111085,33674,65000,0,3842673,11915,-109038.0,-624924.0,-588951.0,-2611910.0,0.0,0.0,1844484.0,26210.0,-147986.0,-2786476.0
2025-04-25,2308,171925,63200,0,3630251,568000,133596,-36016,0,-1555680,564696,38329,99216,0,5185931,3304,87615.0,-586838.0,-493697.0,-2720026.0,0.0,0.0,-104662.0,-7618454.0,438018.0,-2278780.0
2025-04-28,2308,11754,20000,0,4068013,363000,-41205,-8000,0,824412,355169,52959,28000,0,3243601,7831,55732.0,-673968.0,-274650.0,-2798788.0,0.0,0.0,888841.0,-6053446.0,745187.0,-1962668.0
2025-04-29,2308,129100,38388,0,4758948,82000,93293,31388,0,651026,-700732,35807,7000,0,4107922,782732,152513.0,-567081.0,-117628.0,-2540272.0,0.0,0.0,739702.0,-1624297.0,603455.0,-2645400.0
2025-04-30,2308,14869,11000,0,4986954,71000,-76077,-79939,0,-1516571,-312687,90946,90939,0,6503525,383687,86608.0,-609940.0,-155567.0,-2195192.0,0.0,0.0,-1930048.0,-668605.0,17531.0,-3087716.0
2025-05-02,2308,135150,84600,0,9233445,1040000,26017,67600,0,2249931,1028174,109133,17000,0,6983514,11826,135624.0,-623173.0,-24967.0,-2075592.0,0.0,0.0,653118.0,2788183.0,934620.0,-2158542.0
2025-05-05,2308,48942,24000,0,7074461,79000,-282969,-288600,0,2111613,-60609,331911,312600,0,4962848,139609,-280941.0,-889214.0,-277551.0,-2336192.0,0.0,0.0,4320411.0,5046262.0,309315.0,-2153525.0
2025-05-06,2308,24933,10000,0,5997470,29000,-107363,-178563,0,936354,-19029,132296,188563,0,5061116,48029,-347099.0,-969426.0,-448114.0,-2509755.0,0.0,0.0,4432353.0,5038622.0,-64883.0,-1128554.0
2025-05-07,2308,25351,4400,0,6160655,2000,-361677,-56947,0,1516177,-73926,387028,61347,0,4644478,75926,-802069.0,-1482078.0,-536449.0,-2682874.0,0.0,0.0,5297504.0,6371528.0,561923.0,-1373172.0
2025-05-08,2308,82581,30683,0,7511692,463000,-37560,-48717,0,1648905,452020,120141,79400,0,5862787,10980,-763552.0,-1546895.0,-505227.0,-2414714.0,0.0,0.0,8462980.0,8091505.0,1326630.0,-936446.0
2025-05-09,2308,19065,11000,0,7525838,513000,-28111,-5000,0,1432490,506539,47176,16000,0,6093348,6461,-817680.0,-1772848.0,-577827.0,-2420714.0,0.0,0.0,7645539.0,10556144.0,804995.0,-429907.0
2025-05-12,2308,25034,28000,0,2297782,10000,-3151,19257,0,-139749,-57102,28185,8743,0,2437531,67102,-537862.0,-1575342.0,-269970.0,-2117717.0,0.0,0.0,5394177.0,8883332.0,808502.0,-1492079.0
2025-05-13,2308,20021,30000,0,5049222,85000,10104,-17800,0,-631649,41238,9917,47800,0,5680871,43762,-420395.0,-1581279.0,-109207.0,-1612237.0,0.0,0.0,3826174.0,9062284.0,868769.0,-705152.0
2025-05-14,2308,96926,194100,0,7467786,24000,87103,187489,0,-796124,-531000,9823,6611,0,8263910,555000,28385.0,-1367151.0,135229.0,-1341822.0,0.0,0.0,1513873.0,8631706.0,411695.0,-943003.0
2025-05-15,2308,9605,0,0,4197906,251000,-13451,-500,0,-149041,13202,23056,500,0,4346947,237798,52494.0,-790827.0,183446.0,-1149061.0,0.0,0.0,-284073.0,8474286.0,-27123.0,-554033.0
2025-05-16,2308,57966,3000,0,3208663,19000,49087,-28000,0,147320,-25743,8879,31000,0,3061343,44743,129692.0,-661402.0,160446.0,-1031299.0,0.0,0.0,-1569243.0,8573898.0,-559405.0,1032224.0
2025-05-19,2308,49688,2000,0,2084434,103000,-17017,-3777,0,-358523,-374248,66705,5777,0,2442957,477248,115826.0,-615362.0,137412.0,-903806.0,0.0,0.0,-1788017.0,7821909.0,-876551.0,679284.0
2025-05-20,2308,20394,32000,0,3283108,150000,2871,28000,0,165786,36841,17523,4000,0,3117322,113159,108593.0,-603169.0,183212.0,-648759.0,0.0,0.0,-990582.0,8156786.0,-880948.0,668125.0
2025-05-21,2308,484593,14000,0,4180548,426000,298282,6000,0,1483775,342000,186311,8000,0,2696773,84000,319772.0,-301399.0,1723.0,-517125.0,0.0,0.0,1289317.0,8840396.0,-7948.0,1569125.0
2025-05-22,2308,43314,14100,0,4466356,342000,-142671,-70900,0,1537898,230927,185985,85000,0,2928458,111073,190552.0,-433898.0,-68677.0,-546025.0,0.0,0.0,2976256.0,9225115.0,209777.0,1526815.0
2025-05-23,2308,5636,28000,0,3525294,22000,-100321,-35123,0,1251674,-54000,105957,63123,0,2273620,76000,41144.0,-511220.0,-75800.0,-518148.0,0.0,0.0,4080610.0,10810024.0,181520.0,1361730.0
2025-05-26,2308,4036,7000,0,4305237,42000,-245690,-508240,0,693002,-8178,249726,515240,0,3612235,50178,-187529.0,-890506.0,-580263.0,-990372.0,0.0,0.0,5132135.0,13058706.0,547590.0,788856.0
2025-05-27,2308,5783,7000,0,2994857,0,-24132,-243400,0,-644073,-18093,29915,250400,0,3638930,18093,-214532.0,-873433.0,-851663.0,-1225772.0,0.0,0.0,4322276.0,11590221.0,492656.0,415594.0
2025-05-28,2308,6000,12000,0,3426384,59000,-15786,-2000,0,-47919,24000,21786,14000,0,3474303,35000,-528600.0,-982512.0,-859663.0,-1259160.0,0.0,0.0,2790582.0,10891276.0,174656.0,1140326.0
2025-05-29,2308,91951,98536,0,8660419,457131,35853,-58464,0,-711955,289503,56098,157000,0,9372374,167628,-350076.0,-870582.0,-847227.0,-1237685.0,0.0,0.0,540729.0,11695892.0,233232.0,1742516.0
2025-06-02,2308,21116,24000,0,3316966,87000,-73768,-87000,0,-1267447,37881,94884,111000,0,4584413,49119,-323523.0,-970367.0,-899104.0,-1392285.0,0.0,0.0,-1978392.0,8178514.0,325113.0,752223.0
2025-06-03,2308,119862,63316,0,8822127,1283000,73045,-28684,0,3554520,1150239,46817,92000,0,5267607,132761,-4788.0,-614353.0,-419548.0,-1132369.0,0.0,0.0,883126.0,9621421.0,1483530.0,1963071.0
2025-06-04,2308,237504,63025,0,6511905,434000,209557,18025,0,210971,429134,27947,45000,0,6300934,4866,228901.0,-297433.0,-158123.0,-935781.0,0.0,0.0,1738170.0,8896038.0,1930757.0,2411234.0
2025-06-05,2308,222305,73275,0,8093405,574000,147155,38275,0,2398030,522935,75150,35000,0,5695375,51065,391842.0,211399.0,-117848.0,-840559.0,0.0,0.0,4184119.0,9777891.0,2429692.0,3008095.0
2025-06-06,2308,170368,33745,0,5978710,445000,130243,4745,0,-1028483,435372,40125,29000,0,7007193,9628,486232.0,379202.0,-54639.0,-787097.0,0.0,0.0,3867591.0,7100503.0,2575561.0,2991447.0
2025-06-09,2308,87342,56500,0,3232376,0,73280,40500,0,712070,-11326,14062,16000,0,2520306,11326,633280.0,480593.0,72861.0,-741597.0,0.0,0.0,5847108.0,6380083.0,2526354.0,2473582.0
2025-06-10,2308,451498,246433,0,3926337,191000,423434,200433,0,243879,155841,28064,46000,0,3682458,35159,983669.0,907178.0,301978.0,-560421.0,0.0,0.0,2536467.0,6763711.0,1531956.0,2686525.0
2025-06-11,2308,38151,22600,0,4261761,15000,3966,-17566,0,334359,-279475,34185,40166,0,3927402,294475,778078.0,901040.0,266387.0,-560187.0,0.0,0.0,2659855.0,7729719.0,823347.0,2365812.0
2025-06-12,2308,55040,1999,0,3247003,340000,18040,-31035,0,-185800,222199,37000,33034,0,3432803,117801,648963.0,831977.0,197077.0,-778711.0,0.0,0.0,76025.0,8340043.0,522611.0,3119011.0
2025-06-13,2308,20286,3000,0,5202891,3000,-31825,-236766,0,870669,-91738,52111,239766,0,4332222,94738,486895.0,813603.0,-44434.0,-1014977.0,0.0,0.0,1975177.0,9359753.0,-4499.0,3014071.0
2025-06-16,2308,47529,34000,0,3985445,0,38430,10002,0,1765752,-319015,9099,23998,0,2219693,319015,452045.0,802946.0,-74932.0,-976975.0,0.0,0.0,3028859.0,10978185.0,-312188.0,2720799.0
2025-06-17,2308,36407,17009,0,5209293,185258,-197026,-105168,0,1246028,91743,233433,122177,0,3963265,93515,-168415.0,622937.0,-380533.0,-1078366.0,0.0,0.0,4031008.0,12582736.0,-376286.0,3186790.0
2025-06-18,2308,96244,18000,0,3519177,348000,-103080,-181000,0,1351522,200653,199324,199000,0,2167655,147347,-275461.0,516986.0,-543967.0,-1287366.0,0.0,0.0,5048171.0,13768472.0,103842.0,3350602.0
2025-06-19,2308,92640,33400,0,5957466,276000,-34228,-24600,0,1641717,23374,126868,58000,0,4315749,252626,-327729.0,184476.0,-537532.0,-1317966.0,0.0,0.0,6875688.0,13926414.0,-94983.0,3031976.0
2025-06-20,2308,176699,14000,0,18324331,362000,61052,-13000,0,4933271,-4212123,115647,27000,0,13391060,4574123,-234852.0,388199.0,-313766.0,-1260066.0,0.0,0.0,10938290.0,17321787.0,-4215368.0,-1411074.0
2025-06-23,2308,44139,7000,0,4845082,276000,-43143,-33000,0,1106770,86319,87282,40000,0,3738312,189681,-316425.0,445377.0,-356768.0,-1257943.0,0.0,0.0,10279308.0,17176883.0,-3810034.0,-1270755.0
2025-06-24,2308,226304,58994,0,7310376,1853000,-92840,35994,0,3790251,1761523,319144,23000,0,3520125,91477,-212239.0,598227.0,-215606.0,-713709.0,0.0,0.0,12823531.0,20274132.0,-2140254.0,498946.0
2025-06-25,2308,213104,15259,0,5767438,2171000,79454,8259,0,402073,2128740,133650,7000,0,5365365,42260,-29705.0,701813.0,-26347.0,-462050.0,0.0,0.0,11874082.0,21320278.0,-212167.0,2645779.0
2025-06-26,2308,75730,34000,0,4925051,126000,-344410,-77000,0,494253,87001,420140,111000,0,4430798,38999,-339887.0,373189.0,-78747.0,-537050.0,0.0,0.0,10726618.0,21862450.0,-148540.0,2708780.0
2025-06-27,2308,20652,11654,0,5828111,217000,-529246,-371625,0,1947309,93478,549898,383279,0,3880802,123522,-930185.0,-191910.0,-437372.0,-850211.0,0.0,0.0,7740656.0,24521714.0,4157061.0,2512755.0
2025-06-30,2308,60307,118000,0,3450283,149853,41000,29000,0,-194216,111056,19307,89000,0,3644499,38797,-846042.0,-77142.0,-375372.0,-734211.0,0.0,0.0,6439670.0,25594945.0,4181798.0,2585930.0
2025-07-01,2308,340003,133000,0,7935722,408856,282984,82000,0,4965580,236831,57019,51000,0,2970142,172025,-470218.0,132797.0,-329366.0,-623527.0,0.0,0.0,7614999.0,27006005.0,2657106.0,1672522.0
2025-07-02,2308,77335,89000,0,4546852,417000,17206,44000,0,540112,406000,60129,45000,0,4006740,11000,-532466.0,-59554.0,-293625.0,-597552.0,0.0,0.0,7753038.0,27335146.0,934366.0,1649388.0
2025-07-03,2308,667015,272984,0,10474325,3481000,592296,217984,0,1962951,3405426,74719,55000,0,8511374,75574,404240.0,385587.0,1359.0,-417843.0,0.0,0.0,9221736.0,26900067.0,4252791.0,4531879.0
2025-07-04,2308,57811,85888,0,11935459,166000,-94339,6788,0,6542442,-3295,152150,79100,0,5393017,169295,839147.0,161005.0,379772.0,-415800.0,0.0,0.0,13816869.0,34470992.0,4156018.0,4093212.0
2025-07-07,2308,708786,376371,0,4354931,625000,692706,290095,0,1282019,607523,16080,86276,0,3072912,17477,1490853.0,780431.0,640867.0,-166205.0,0.0,0.0,15293104.0,35040941.0,4652485.0,4712061.0
2025-07-08,2308,93816,58196,0,8027715,142315,71342,36100,0,4502540,127315,22474,22096,0,3525175,15000,1279211.0,428339.0,594967.0,-330538.0,0.0,0.0,14830064.0,39299602.0,4542969.0,4683535.0
2025-07-09,2308,82795,89761,0,8492819,88000,67647,19130,0,1785322,56528,15148,70631,0,6707497,31472,1329652.0,492020.0,570097.0,-293842.0,0.0,0.0,16075274.0,40750565.0,4193497.0,5019538.0
2025-07-10,2308,169360,270566,0,12815847,1835000,-429385,-123483,0,474182,1708719,598745,394049,0,12341665,126281,307971.0,44595.0,228630.0,-386290.0,0.0,0.0,14586505.0,41410547.0,2496790.0,6506058.0
2025-07-11,2308,277254,319150,0,5888984,1128000,187680,-110254,0,-1054899,987718,89574,429404,0,6943883,140282,589990.0,264100.0,111588.0,-259778.0,0.0,0.0,6989164.0,39484979.0,3487803.0,7585514.0
2025-07-14,2308,77387,163032,0,4101037,96000,2512,-313939,0,1481146,30984,74875,476971,0,2619891,65016,-100204.0,228182.0,-492446.0,-583719.0,0.0,0.0,7188291.0,39200373.0,2911264.0,7935513.0
2025-07-15,2308,209417,140578,0,10017718,376000,137247,-142281,0,1198894,315420,72170,282859,0,8818824,60580,-34299.0,562455.0,-670827.0,-620832.0,0.0,0.0,3884645.0,39153239.0,3099369.0,8159190.0
2025-07-16,2308,229227,347043,0,13349156,986719,-153296,-502219,0,-594095,825965,382523,849262,0,13943251,160754,-255242.0,512239.0,-1192176.0,-942051.0,0.0,0.0,1505228.0,37207622.0,3868806.0,8784502.0
2025-07-17,2308,137870,154000,0,6155048,34664,8292,19800,0,-1432161,-44072,129578,134200,0,7587209,78736,182435.0,554759.0,-1048893.0,-897651.0,0.0,0.0,-401115.0,34133744.0,2116015.0,8717056.0
2025-07-18,2308,120721,155198,0,4733635,174000,107907,106198,0,1614242,80772,12814,49000,0,3119393,93228,102662.0,601614.0,-832441.0,-778453.0,0.0,0.0,2268026.0,30814715.0,1209069.0,13009951.0
2025-07-21,2308,34368,82300,0,6813436,170000,-55180,-14700,0,2168379,90720,89548,97000,0,4645057,79280,44970.0,589577.0,-533202.0,-760153.0,0.0,0.0,2955259.0,31876324.0,1268805.0,13014352.0
2025-07-22,2308,181392,143000,0,8310482,251416,55527,-40969,0,2145959,84820,125865,183969,0,6164523,166596,-36750.0,737944.0,-431890.0,-837116.0,0.0,0.0,3902324.0,30232032.0,1038205.0,11337649.0
2025-07-23,2308,129291,273000,0,6964376,892000,79554,170000,0,1516308,803000,49737,103000,0,5448068,89000,196100.0,738044.0,240329.0,-675375.0,0.0,0.0,6012727.0,31346267.0,1015240.0,10011909.0
2025-07-24,2308,112274,124000,0,4979738,22000,66581,57000,0,-850479,-163284,45693,67000,0,5830217,185284,254389.0,1149035.0,277529.0,-541375.0,0.0,0.0,6594409.0,30001535.0,896028.0,9761624.0
2025-07-25,2308,51606,52000,0,6887866,12000,-1294,-109000,0,1412835,-118000,52900,161000,0,5475031,130000,145188.0,1676987.0,62331.0,-278750.0,0.0,0.0,6393002.0,29467061.0,697256.0,9550146.0
2025-07-28,2308,77038,63000,0,4395117,44000,30447,-11000,0,401006,-141284,46591,74000,0,3994111,185284,230815.0,1666434.0,66031.0,-318750.0,0.0,0.0,4625629.0,30062283.0,465252.0,9297806.0
2025-07-29,2308,209437,386305,0,5031132,60000,145070,321305,0,1028783,-179738,64367,65000,0,4002349,239738,320358.0,1528520.0,428305.0,-79445.0,0.0,0.0,3508453.0,26125486.0,200694.0,8881237.0
2025-07-30,2308,27456,123347,0,5641052,54000,-44180,6106,0,389115,4000,71636,117241,0,5251937,50000,196624.0,1467134.0,264411.0,-117339.0,0.0,0.0,2381260.0,25974489.0,-598306.0,8479237.0
2025-07-31,2308,101735,184027,0,9564984,43000,-56652,22029,0,1421459,-80738,158387,161998,0,8143525,123738,73391.0,818186.0,229440.0,-313294.0,0.0,0.0,4653198.0,25432997.0,-515760.0,4993073.0
2025-08-01,2308,208459,671497,0,15215568,509000,152027,254049,0,2096929,409022,56432,417448,0,13118639,99978,226712.0,1064552.0,592489.0,-66033.0,0.0,0.0,5337292.0,20987484.0,11262.0,5405390.0
2025-08-04,2308,72367,99000,0,7508178,174000,27469,27878,0,2064606,125000,44898,71122,0,5443572,49000,223734.0,399315.0,631367.0,-328250.0,0.0,0.0,7000892.0,21770071.0,277546.0,4922867.0
2025-08-05,2308,332484,289495,0,10850727,668000,236866,216837,0,-1042053,628262,95618,72658,0,11892780,39738,315530.0,564839.0,526899.0,-147513.0,0.0,0.0,4930056.0,16225478.0,1085546.0,5423814.0
2025-08-06,2308,172236,306415,0,11345551,1112000,41579,202501,0,-1066470,1018750,130657,103914,0,12412021,93250,401289.0,538771.0,723294.0,35858.0,0.0,0.0,3474471.0,13373686.0,2100296.0,6386036.0
2025-08-07,2308,75304,372000,0,9193779,106222,4180,112847,0,232197,-28778,71124,259153,0,8961582,135000,462121.0,972336.0,814112.0,272188.0,0.0,0.0,2285209.0,13131701.0,2152256.0,4648539.0
2025-08-08,2308,63079,178800,0,8523567,145000,-1136,102637,0,1234655,33583,64215,76163,0,7288912,111417,308958.0,783520.0,662700.0,485079.0,0.0,0.0,1422935.0,15421255.0,1776817.0,3694404.0
2025-08-11,2308,44397,110000,0,4430546,255000,-61790,53751,0,-203771,88995,106187,56249,0,4634317,166005,219699.0,719218.0,688573.0,852769.0,0.0,0.0,-845442.0,13736338.0,1740812.0,3752415.0
2025-08-12,2308,33676,45000,0,5157539,323000,-2123,5261,0,252172,286583,35799,39739,0,4905367,36417,-19290.0,579848.0,476997.0,1000311.0,0.0,0.0,448783.0,12789616.0,1399133.0,3723578.0
2025-08-13,2308,157456,260100,0,16324408,1006000,-2176,-144370,0,2332714,842512,159632,404470,0,13991694,163488,-63045.0,730968.0,130126.0,1358160.0,0.0,0.0,3847967.0,15716425.0,1222895.0,3740125.0
2025-08-14,2308,147041,318283,0,3991411,494418,13546,247286,0,-4548706,440376,133495,70997,0,8540117,54042,-53679.0,736222.0,264565.0,1585646.0,0.0,0.0,-932936.0,12599880.0,1692049.0,4224573.0
2025-08-15,2308,124466,377105,0,7448284,673000,94452,255819,0,-804117,250958,30014,121286,0,8252401,422042,41909.0,722767.0,417747.0,1735267.0,0.0,0.0,-2971708.0,10181521.0,1909424.0,4394759.0
2025-08-18,2308,150181,308000,0,5004974,227836,-58424,254433,0,-4182143,107097,208605,53567,0,9187117,120739,45275.0,719523.0,618429.0,2004400.0,0.0,0.0,-6950080.0,3830999.0,1927526.0,4411136.0
2025-08-19,2308,81314,229417,0,6165945,262418,-39562,64417,0,-473449,-65582,120876,165000,0,6639394,328000,7836.0,624434.0,677585.0,2109786.0,0.0,0.0,-7675701.0,1211591.0,1575361.0,4260734.0
2025-08-20,2308,237720,739767,0,18655048,30836,15174,295602,0,582335,-243164,222546,444165,0,18072713,274000,25186.0,560054.0,1117557.0,2235388.0,0.0,0.0,-9426080.0,277618.0,489685.0,3214570.0
2025-08-21,2308,266899,825600,0,9161030,972418,206562,681719,0,-2255552,775418,60337,143881,0,11416582,197000,218202.0,700035.0,1551990.0,2860107.0,0.0,0.0,-7132926.0,-1127455.0,824727.0,4153272.0
2025-08-22,2308,114837,129000,0,5103571,831000,35181,-8000,0,165431,685256,79656,137000,0,4938140,145744,158931.0,736510.0,1288171.0,2961107.0,0.0,0.0,-6163378.0,-2374859.0,1259025.0,4956528.0
2025-08-25,2308,109324,116827,0,3409150,292928,22296,-77413,0,-1514905,81940,87028,194240,0,4924055,210988,239651.0,728359.0,956325.0,2894694.0,0.0,0.0,-3496140.0,-4290770.0,1233868.0,5179752.0
2025-08-26,2308,66790,131900,0,7264977,5282,46677,39900,0,777117,-875718,20113,92000,0,6487860,881000,325890.0,629966.0,931808.0,2613289.0,0.0,0.0,-2245574.0,-4542436.0,423732.0,4483772.0
2025-08-27,2308,370081,529600,0,5965072,90000,316655,438358,0,-2209246,-114000,53426,91242,0,8174318,204000,627371.0,990801.0,1074564.0,3045541.0,0.0,0.0,-5037155.0,-7140797.0,552896.0,4365772.0
2025-08-28,2308,32435,67196,0,2702839,65000,-52162,-109171,0,-2789785,-248491,84597,176367,0,5492624,313491,368647.0,995291.0,283674.0,2914341.0,0.0,0.0,-5571388.0,-11352041.0,-471013.0,4198019.0
2025-08-29,2308,119333,162600,0,5344765,121000,88708,98487,0,-1480886,-1000,30625,64113,0,6825651,122000,422174.0,931972.0,390161.0,2758779.0,0.0,0.0,-7217705.0,-14929856.0,-1157269.0,3787997.0
2025-09-01,2308,338227,142000,0,5976035,69456,-139651,-224000,0,2094220,-559044,477878,366000,0,3881815,628500,260227.0,764852.0,243574.0,2506901.0,0.0,0.0,-3608580.0,-14900242.0,-1798253.0,3103953.0
2025-09-02,2308,59900,73700,0,5984907,871000,-6354,-49300,0,1529752,503000,66254,123000,0,4455155,368000,207196.0,521632.0,154374.0,2240764.0,0.0,0.0,-2855945.0,-12328437.0,-419535.0,2978691.0
2025-09-03,2308,117439,137198,0,7881471,481000,97671,126198,0,1978844,126000,19768,11000,0,5902627,355000,-11788.0,577724.0,-157786.0,2164461.0,0.0,0.0,1332145.0,-9283123.0,-179535.0,2085941.0
2025-09-04,2308,131230,269992,0,4143947,555000,112697,141992,0,-27467,484255,18533,128000,0,4171414,70745,153071.0,686241.0,93377.0,2193606.0,0.0,0.0,4094463.0,-9542787.0,553211.0,2598974.0
2025-09-05,2308,200614,242211,0,9361037,815000,130155,165211,0,4836494,783255,70459,77000,0,4524543,31745,194518.0,817532.0,160101.0,2256180.0,0.0,0.0,10411843.0,-5940948.0,1337466.0,3348646.0
2025-09-08,2308,132717,99000,0,4243732,526000,-68743,49800,0,-2211603,493532,201460,49200,0,6455335,32468,265426.0,810579.0,433901.0,2252229.0,0.0,0.0,6106020.0,-7948780.0,2390042.0,3753183.0
2025-09-09,2308,210978,405400,0,7580264,1266000,8982,207400,0,-1248805,1133755,201996,198000,0,8829069,132245,280762.0,821684.0,690601.0,2454368.0,0.0,0.0,3327463.0,-9449757.0,3020797.0,4600355.0
2025-09-10,2308,407600,308796,0,8917316,630000,-32076,153964,0,-3268466,588793,439676,154832,0,12185782,41207,151015.0,791784.0,718367.0,2752702.0,0.0,0.0,-1919847.0,-15050937.0,3483590.0,4346636.0
2025-09-11,2308,158481,216498,0,12313675,100000,-163617,-87340,0,-2414510,-153781,322098,303838,0,14728185,253781,-125299.0,614621.0,489035.0,2418076.0,0.0,0.0,-4306890.0,-12916741.0,2845554.0,3752479.0
2025-09-12,2308,77055,169000,0,10180845,285000,-2296,24105,0,-1287776,165209,79351,144895,0,11468621,119791,-257750.0,517873.0,347929.0,2186362.0,0.0,0.0,-10431160.0,-13400400.0,2227508.0,3666730.0
2025-09-15,2308,31093,104996,0,5335615,72000,-85527,-142004,0,-344271,-423253,116620,247000,0,5679886,495253,-274534.0,490770.0,156125.0,1789925.0,0.0,0.0,-8563828.0,-9562528.0,1310723.0,3136380.0
2025-09-16,2308,33959,114872,0,7708664,252015,-66462,-151684,0,-563106,-256485,100421,266556,0,8271770,508500,-349978.0,463870.0,-202959.0,1573824.0,0.0,0.0,-7878129.0,-9652185.0,-79517.0,2945477.0
2025-09-17,2308,87275,229000,0,4771105,35000,17329,124400,0,-1290972,-65736,69946,104600,0,6062077,100736,-300573.0,466025.0,-232523.0,1402622.0,0.0,0.0,-5900635.0,-11525492.0,-734046.0,3122905.0
2025-09-18,2308,385439,437200,0,9956654,27000,312461,379200,0,15259,-174000,72978,58000,0,9941395,201000,175505.0,571924.0,234017.0,1100103.0,0.0,0.0,-3470866.0,-9254681.0,-754265.0,2173487.0
2025-09-19,2308,159783,158303,0,8771714,137920,-87609,75303,0,-4336301,-125426,247392,83000,0,13108015,263346,90192.0,449134.0,285215.0,1183406.0,0.0,0.0,-6519391.0,-13756413.0,-1044900.0,1362805.0
2024-09-23,2344,36000,122000,0,4916522,24000,-52000,-1146117,0,-3053334,24000,88000,1268117,0,7969856,0,-52000.0,-52000.0,-1146117.0,-1146117.0,0.0,0.0,-3053334.0,-3053334.0,24000.0,24000.0
2024-09-24,2344,58000,103001,0,6811000,9000,1917,-244247,0,-6517156,2330,56083,347248,0,13328156,6670,-50083.0,-50083.0,-1390364.0,-1390364.0,0.0,0.0,-9570490.0,-9570490.0,26330.0,26330.0
2024-09-25,2344,192000,357000,0,19794700,0,175000,347000,0,4685389,-7023,17000,10000,0,15109311,7023,124917.0,124917.0,-1043364.0,-1043364.0,0.0,0.0,-4885101.0,-4885101.0,19307.0,19307.0
2024-09-26,2344,121000,711000,0,10835195,19000,17321,305881,0,-10839234,-172784,103679,405119,0,21674429,191784,142238.0,142238.0,-737483.0,-737483.0,0.0,0.0,-15724335.0,-15724335.0,-153477.0,-153477.0
2024-09-27,2344,91912,100000,0,18596670,10000,34912,-137361,0,10890670,7332,57000,237361,0,7706000,2668,177150.0,177150.0,-874844.0,-874844.0,0.0,0.0,-4833665.0,-4833665.0,-146145.0,-146145.0
2024-09-30,2344,59000,44000,0,10860500,14000,-131664,-257881,0,-1738099,-4668,190664,301881,0,12598599,18668,97486.0,45486.0,13392.0,-1132725.0,0.0,0.0,-3518430.0,-6571764.0,-174813.0,-150813.0
2024-10-01,2344,40000,8000,0,5229846,4000,-139503,-480239,0,-4873583,-76330,179503,488239,0,10103429,80330,-43934.0,-94017.0,-222600.0,-1612964.0,0.0,0.0,-1874857.0,-11445347.0,-253473.0,-227143.0
2024-10-04,2344,22000,17000,0,8711700,6000,-127236,-388010,0,-1101383,-670,149236,405010,0,9813083,6670,-346170.0,-221253.0,-957610.0,-2000974.0,0.0,0.0,-7661629.0,-12546730.0,-247120.0,-227813.0
2024-10-07,2344,17000,162000,0,4669400,0,-131789,-4410,0,-3374177,-75000,148789,166410,0,8043577,75000,-495280.0,-353042.0,-1267901.0,-2005384.0,0.0,0.0,-196572.0,-15920907.0,-149336.0,-302813.0
2024-10-08,2344,50000,61000,0,5827038,7000,-9921,-102361,0,-7313211,-118155,59921,163361,0,13140249,125155,-540113.0,-362963.0,-1232901.0,-2107745.0,0.0,0.0,-18400453.0,-23234118.0,-274823.0,-420968.0
2024-10-09,2344,14000,45000,0,2224815,4000,-32552,-113313,0,-8099836,-76334,46552,158313,0,10324651,80334,-441001.0,-395515.0,-1088333.0,-2221058.0,0.0,0.0,-24762190.0,-31333954.0,-346489.0,-497302.0
2024-10-11,2344,23000,88000,0,3260697,0,9418,22502,0,-8078719,-4308,13582,65498,0,11339416,4308,-292080.0,-386097.0,-585592.0,-2198556.0,0.0,0.0,-27967326.0,-39412673.0,-274467.0,-501610.0
2024-10-14,2344,53000,151000,0,3802700,39000,51162,11000,0,-4254073,12179,1838,140000,0,8056773,26821,-113682.0,-334935.0,-186582.0,-2187556.0,0.0,0.0,-31120016.0,-43666746.0,-261618.0,-489431.0
2024-10-15,2344,10000,146540,0,8621873,2000,-70000,142540,0,3120073,-11668,80000,4000,0,5501800,13668,-51893.0,-404935.0,-39632.0,-2045016.0,0.0,0.0,-24625766.0,-40546673.0,-198286.0,-501099.0
2024-10-16,2344,58000,903000,0,2907800,8000,-94457,859518,0,-10496200,-27004,152457,43482,0,13404000,35004,-136429.0,-499392.0,922247.0,-1185498.0,0.0,0.0,-27808755.0,-51042873.0,-107135.0,-528103.0
2024-10-17,2344,175000,258000,0,8556898,0,147347,257497,0,-220265,-175000,27653,503,0,8777163,175000,43470.0,-352045.0,1293057.0,-928001.0,0.0,0.0,-19929184.0,-51263138.0,-205801.0,-703103.0
2024-10-18,2344,66000,240000,0,4367027,0,-40168,147995,0,-2345228,-2439668,106168,92005,0,6712255,2439668,-6116.0,-392213.0,1418550.0,-780006.0,0.0,0.0,-14195693.0,-53608366.0,-2641161.0,-3142771.0
2024-10-21,2344,55000,185000,0,7855100,2100000,7816,-366000,0,-229439,2065666,47184,551000,0,8084539,34334,-49462.0,-384397.0,1041550.0,-1146006.0,0.0,0.0,-10171059.0,-53837805.0,-587674.0,-1077105.0
2024-10-22,2344,12000,112000,0,4598300,9000,-7000,-61104,0,-6101670,-76334,19000,173104,0,10699970,85334,13538.0,-391397.0,837906.0,-1207110.0,0.0,0.0,-19392802.0,-59939475.0,-652340.0,-1153439.0
2024-10-23,2344,43000,16186,0,6847700,0,-44998,-463814,0,630457,-10670,87998,480000,0,6217243,10670,62997.0,-436395.0,-485426.0,-1670924.0,0.0,0.0,-8266145.0,-59309018.0,-636006.0,-1164109.0
2024-10-24,2344,64000,1000,0,2981999,0,7694,-197955,0,-9151752,-32334,56306,198955,0,12133751,32334,-76656.0,-376701.0,-940878.0,-722762.0,0.0,0.0,-17197632.0,-65407436.0,-493340.0,-1220443.0
2024-10-25,2344,47000,19000,0,4276980,0,-80389,-46437,0,-4173888,-5918334,127389,65437,0,8450868,5918334,-116877.0,-459007.0,-1135310.0,-524952.0,0.0,0.0,-19026292.0,-63064168.0,-3972006.0,-7141107.0
2024-10-28,2344,9000,430000,0,10077700,0,-30132,413885,0,5801082,-1001334,39132,16115,0,4276618,1001334,-154825.0,-664139.0,-355425.0,-458067.0,0.0,0.0,-12995771.0,-61948475.0,-7039006.0,-8135418.0
2024-10-29,2344,2000,8000,0,4067097,5000,-38787,-478100,0,-1384903,-3457509,40787,486100,0,5452000,3462509,-186612.0,-720247.0,-772421.0,-1242048.0,0.0,0.0,-8279004.0,-52494144.0,-10420181.0,-11420143.0
2024-10-30,2344,68000,36000,0,10860432,0,59293,29181,0,5623157,-16334,8707,6819,0,5237275,16334,-82321.0,-695866.0,-279426.0,-1075506.0,0.0,0.0,-3286304.0,-57761657.0,-10425845.0,-11443809.0
2024-11-01,2344,20000,7000,0,10144600,0,-82267,-414194,0,1909881,0,102267,421194,0,8234719,0,-172282.0,-646469.0,-495665.0,-1231819.0,0.0,0.0,7775329.0,-54113677.0,-10393511.0,-11439141.0
2024-11-04,2344,2000,6000,0,8547537,2000,-18554,-25053,0,1529987,-6000,20554,31053,0,7017550,8000,-110447.0,-525520.0,-474281.0,-776633.0,0.0,0.0,13479204.0,-47710107.0,-4481177.0,-11368811.0
2024-11-05,2344,21000,8000,0,9754794,0,828,-28451,0,-916016,0,20172,36451,0,10670810,0,-79487.0,-397456.0,-916617.0,-417074.0,0.0,0.0,6762106.0,-47524740.0,-3479843.0,-11368141.0
2024-11-06,2344,18000,55000,0,7340046,31000,-9781,-69992,0,-4173954,31000,27781,124992,0,11514000,0,-50481.0,-275448.0,-508509.0,-482656.0,0.0,0.0,3973055.0,-48324517.0,8666.0,-11262141.0
2024-11-07,2344,340232,99151,0,27396400,0,310232,58151,0,13102256,-7000,30000,41000,0,14294144,7000,200458.0,44705.0,-479539.0,-322144.0,0.0,0.0,11452154.0,-27909050.0,18000.0,-11150986.0
2024-11-08,2344,0,19000,0,14471389,0,-260932,-119441,0,3063150,-9000,260932,138441,0,11408239,9000,21793.0,-183675.0,-184786.0,-328272.0,0.0,0.0,12605423.0,-16746064.0,9000.0,-11083652.0
2024-11-11,2344,27000,109000,0,10976240,0,-123822,92298,0,4602825,0,150822,16702,0,6373415,0,-83475.0,-316915.0,-67435.0,-258476.0,0.0,0.0,15678261.0,-4064520.0,15000.0,-11079344.0
2024-11-12,2344,37000,25000,0,8247958,7000,-23263,-212342,0,-3933698,7000,60263,237342,0,12181656,0,-107566.0,-391340.0,-251326.0,-481818.0,0.0,0.0,12660579.0,-3744145.0,22000.0,-11084523.0
2024-11-13,2344,21000,19000,0,6417757,0,-32686,-266175,0,-2063605,-17073,53686,285175,0,8481362,17073,-130471.0,-354026.0,-447509.0,-890533.0,0.0,0.0,14770928.0,-8927823.0,-26073.0,-11089928.0
2024-11-14,2344,57000,63000,0,7739469,0,34000,-202661,0,-3926859,-2510000,23000,265661,0,11666328,2510000,-406703.0,-225569.0,-708321.0,-1952712.0,0.0,0.0,-2258187.0,-2358482.0,-2529073.0,-13572924.0
2024-11-15,2344,109000,252000,0,20474200,0,99231,227974,0,14622939,0,9769,24026,0,5851261,0,-46540.0,-273685.0,-360906.0,-1982235.0,0.0,0.0,9301602.0,12484722.0,-2520073.0,-13397924.0
2024-11-18,2344,23000,373000,0,15750992,0,-23112,114675,0,7018444,-160000,46112,258325,0,8732548,160000,54170.0,-256629.0,-338529.0,-2015555.0,0.0,0.0,11717221.0,21848394.0,-2680073.0,-11118256.0
2024-11-19,2344,25000,330000,0,11882900,9074,18000,246000,0,2001003,-240926,7000,84000,0,9881897,250000,95433.0,-246445.0,119813.0,-1403555.0,0.0,0.0,17651922.0,24078836.0,-2927999.0,-13424848.0
2024-11-20,2344,90000,174000,0,14541103,13492,6000,44000,0,4851609,-526508,84000,130000,0,9689494,540000,134119.0,-233445.0,429988.0,-1298451.0,0.0,0.0,24567136.0,35032115.0,-3437434.0,-13875022.0
2024-11-21,2344,65000,174000,0,19325000,0,14000,-470000,0,-2687717,-47000,51000,644000,0,22012717,47000,114119.0,-174447.0,162649.0,-1304637.0,0.0,0.0,25806278.0,31713941.0,-974434.0,-13911352.0
2024-11-22,2344,13000,181000,0,12786831,0,-11000,-6000,0,3833685,0,24000,187000,0,8953146,0,3888.0,-193141.0,-71325.0,-1112682.0,0.0,0.0,15017024.0,44699378.0,-974434.0,-13879018.0
2024-11-25,2344,40000,295000,0,290718063,15548,-85000,-68000,0,-13178508,-60996,125000,363000,0,303896571,76544,-58000.0,-197752.0,-254000.0,-1134245.0,0.0,0.0,-5179928.0,35694758.0,-875430.0,-8021680.0
2024-11-26,2344,98000,19000,0,8026474,0,72333,-43907,0,-16300998,-9481,25667,62907,0,24327472,9481,-3667.0,-95287.0,-543907.0,-1592037.0,0.0,0.0,-23481929.0,13592678.0,-643985.0,-7029827.0
2024-11-27,2344,39000,44000,0,10452543,1622000,-48492,-186126,0,-7938707,1225565,87492,230126,0,18391250,396435,-58159.0,-104992.0,-774033.0,-1300063.0,0.0,0.0,-36272245.0,7038874.0,1108088.0,-2346753.0
2024-11-28,2344,136000,6000,0,24260512,11000,84154,-173746,0,7555849,9565,51846,179746,0,16704663,1435,11995.0,-80131.0,-477779.0,-1502990.0,0.0,0.0,-26028679.0,8971566.0,1164653.0,-2320854.0
2024-11-29,2344,87000,38000,0,10124324,0,59347,-115000,0,-1685685,-14426,27653,153000,0,11810009,14426,82342.0,61483.0,-586779.0,-1203796.0,0.0,0.0,-31548049.0,5376000.0,1150227.0,-2335280.0
2024-12-02,2344,114000,64000,0,7858648,0,69390,-38131,0,-3641872,-1380,44610,102131,0,11500520,1380,236732.0,149427.0,-556910.0,-1216874.0,0.0,0.0,-22011413.0,204141.0,1209843.0,-2330660.0
2024-12-03,2344,86000,680000,0,7987928,0,84451,678000,0,241927,0,1549,2000,0,7746001,0,248850.0,233050.0,164997.0,-510423.0,0.0,0.0,-5468488.0,1362084.0,1219324.0,-2330660.0
2024-12-04,2344,37000,47287,0,4046744,0,6000,41287,0,-4750299,-1329,31000,6000,0,8797043,1329,303342.0,248831.0,392410.0,-399144.0,0.0,0.0,-2280080.0,785739.0,-7570.0,-2362989.0
2024-12-05,2344,6000,5000,0,4138381,7000,-145000,-77835,0,-5851253,-272432,151000,82835,0,9989634,279432,74188.0,-206401.0,488321.0,-535130.0,0.0,0.0,-15687182.0,-18167770.0,-289567.0,-2628421.0
2024-12-06,2344,354000,1296306,0,17060009,0,342000,1256306,0,1501212,-13000,12000,40000,0,15558797,13000,356841.0,396531.0,1859627.0,840617.0,0.0,0.0,-12500285.0,-19729708.0,-288141.0,-2632421.0
2024-12-09,2344,16000,12000,0,7567613,0,-235000,-201000,0,-6063209,-9000,251000,213000,0,13630822,9000,52451.0,285353.0,1696758.0,547319.0,0.0,0.0,-14921622.0,-30395742.0,-295761.0,-2641421.0
2024-12-10,2344,112000,104000,0,8437871,0,90000,-92000,0,-374134,-111333,22000,196000,0,8812005,111333,58000.0,398616.0,926758.0,667661.0,0.0,0.0,-15537683.0,-26836178.0,-407094.0,-2759754.0
2024-12-11,2344,11000,202000,0,9094150,1000,-202000,-311888,0,-12823696,-70195,213000,513888,0,21917846,71195,-150000.0,229302.0,573583.0,621948.0,0.0,0.0,-23611080.0,-37596269.0,-475960.0,-2812876.0
2024-12-12,2344,74000,193164,0,13800610,0,56000,163784,0,-1208999,-35432,18000,29380,0,15009609,35432,51000.0,251302.0,815202.0,988393.0,0.0,0.0,-18968826.0,-34878409.0,-238960.0,-338308.0
2024-12-13,2344,76000,97000,0,12796135,0,11000,-410810,0,4644696,-1613092,65000,507810,0,8151439,1613092,-280000.0,163071.0,-851914.0,349609.0,0.0,0.0,-15825342.0,-44856652.0,-1839052.0,-1951400.0
2024-12-16,2344,313000,578843,0,12564797,0,265366,256182,0,1708520,-3223702,47634,322661,0,10856277,3223702,220366.0,451549.0,-394732.0,491116.0,0.0,0.0,-8053613.0,-50166576.0,-5053754.0,-5015102.0
2024-12-17,2344,331000,510350,0,19846358,189623,162000,120350,0,4558112,167963,169000,390000,0,15288246,21660,292366.0,595549.0,-182382.0,365466.0,0.0,0.0,-3121367.0,-47609467.0,-4774458.0,-4606213.0
2024-12-18,2344,324471,1678382,0,20165529,15000,217471,1597876,0,2680527,-37594,107000,80506,0,17485002,52594,711837.0,807020.0,1727382.0,1919342.0,0.0,0.0,12382856.0,-49780549.0,-4741857.0,-4117299.0
2024-12-19,2344,177234,344200,0,17155565,0,-239738,-711183,0,-3349959,-17660,416972,1055383,0,20505524,17660,416099.0,553282.0,852415.0,1678159.0,0.0,0.0,10241896.0,-50442791.0,-4724085.0,-4087959.0
2024-12-20,2344,94999,129000,0,6028398,1889000,-5503,-917651,0,-13295514,1823038,100502,1046651,0,19323912,65962,399596.0,558779.0,345574.0,766508.0,0.0,0.0,-7698314.0,-67571990.0,-1287955.0,-2264921.0
2024-12-23,2344,363107,417456,0,8329562,0,354283,209127,0,111562,-17000,8824,208329,0,8218000,17000,488513.0,998062.0,298519.0,1043635.0,0.0,0.0,-9295272.0,-54281920.0,1918747.0,-2220925.0
2024-12-24,2344,396637,664715,0,17546200,0,284935,292715,0,5521791,-79000,111702,372000,0,12024409,79000,611448.0,1210664.0,470884.0,1380257.0,0.0,0.0,-8331593.0,-32459131.0,1671784.0,-2290444.0
2024-12-25,2344,40389,122000,0,2477429,0,-382611,-112029,0,-2500571,-24000,423000,234029,0,4978000,24000,11366.0,876545.0,-1239021.0,1454354.0,0.0,0.0,-13512691.0,-27020995.0,1685378.0,-3540009.0
2024-12-26,2344,219000,76000,0,1182000,15000,136881,-31242,0,-2824200,-8358,82119,107242,0,4006200,23358,387985.0,929272.0,-559080.0,1596858.0,0.0,0.0,-12986932.0,-37401044.0,1694680.0,-3557932.0
2024-12-27,2344,21000,166000,0,3150631,0,-84272,96489,0,897631,-94330,105272,69511,0,2253000,94330,309216.0,785653.0,455060.0,1808347.0,0.0,0.0,1206213.0,-34817728.0,-222688.0,-3637836.0
2024-12-30,2344,0,12000,0,1604542,0,-67944,286,0,-2152566,-17487,67944,11714,0,3757108,17487,-113011.0,648319.0,246219.0,1846764.0,0.0,0.0,-1057915.0,-33328422.0,-223175.0,-3653943.0
2024-12-31,2344,119000,58000,0,2446768,3000,-13000,-29799,0,-3444232,-181938,132000,87799,0,5891000,184938,-410946.0,550868.0,-76295.0,1138965.0,0.0,0.0,-10023938.0,-37014581.0,-326113.0,-3835881.0
2025-01-02,2344,247000,43300,0,4033749,0,175002,-352390,0,-3221251,-53928,71998,395690,0,7255000,53928,146667.0,719870.0,-316656.0,745288.0,0.0,0.0,-10744618.0,-35485533.0,-356041.0,-3888480.0
2025-01-03,2344,153000,66000,0,3050631,0,78006,11619,0,-3943369,0,74994,54381,0,6994000,0,87792.0,942876.0,-273795.0,834742.0,0.0,0.0,-11863787.0,-33577649.0,-347683.0,-3616048.0
2025-01-06,2344,366149,572000,0,10487316,16000,323501,526158,0,3615467,16000,42648,45842,0,6871849,0,495565.0,924377.0,155874.0,104594.0,0.0,0.0,-9145951.0,-31463394.0,-237353.0,-3587048.0
2025-01-07,2344,45000,121360,0,10269816,0,-373040,-58429,0,-4533651,-8000,418040,179789,0,14803467,8000,190469.0,786337.0,97159.0,247165.0,0.0,0.0,-11527036.0,-29933836.0,-227866.0,-3586048.0
2025-01-08,2344,14000,16000,0,5307630,0,-120639,-60754,0,-2371906,-92297,134639,76754,0,7679536,92297,82830.0,575698.0,66204.0,278411.0,0.0,0.0,-10454710.0,-31931608.0,-138225.0,-3567012.0
2025-01-09,2344,5000,30000,0,6718000,0,-188993,-355528,0,-9626000,-1634,193993,385528,0,16344000,1634,-281165.0,588705.0,63066.0,234771.0,0.0,0.0,-16859459.0,-28733912.0,-85931.0,-3498451.0
2025-01-10,2344,40000,136000,0,9416085,0,-51000,-10955,0,3583085,-107000,91000,146955,0,5833000,107000,-410171.0,481705.0,40492.0,60032.0,0.0,0.0,-9333005.0,-23941828.0,-192931.0,-3570019.0
2025-01-13,2344,51000,215000,0,13426296,7000,-277000,-221576,0,3210716,7000,328000,436576,0,10215580,0,-1010672.0,193705.0,-707242.0,249266.0,0.0,0.0,-9737756.0,-25375808.0,-201931.0,-1949927.0
2025-01-14,2344,46555,87691,0,9180586,24000,-1664,-309,0,689603,24000,48219,88000,0,8490983,0,-639296.0,-73325.0,-649122.0,-7225.0,0.0,0.0,-4514502.0,-26394725.0,-169931.0,1297775.0
2025-01-15,2344,139000,1115000,0,8546724,12000,15446,1088936,0,-6903609,12000,123554,26064,0,15450333,0,-503211.0,-219879.0,500568.0,961361.0,0.0,0.0,-9046205.0,-37856446.0,-65634.0,1141812.0
2025-01-16,2344,381147,493000,0,15197075,20000,208667,274792,0,-1964763,20000,172480,218208,0,17161838,0,-105551.0,-228683.0,1130888.0,-361723.0,0.0,0.0,-1384968.0,-42501736.0,-44000.0,1199406.0
2025-01-17,2344,228750,163532,0,8852974,0,160983,96652,0,681265,-36000,67767,66880,0,8171709,36000,106432.0,172038.0,1238495.0,446112.0,0.0,0.0,-4286788.0,-38470512.0,27000.0,1181066.0
2025-01-20,2344,67000,129000,0,6481899,0,-234155,-43562,0,-5015543,-3990,301155,172562,0,11497442,3990,149277.0,-56614.0,1416509.0,1320201.0,0.0,0.0,-12513047.0,-30190541.0,16010.0,-645962.0
2025-01-21,2344,32080,47000,0,6575195,31000,-114618,-176919,0,998195,29498,146698,223919,0,5577000,1502,36323.0,-525515.0,1239899.0,934155.0,0.0,0.0,-12204455.0,-29303908.0,21508.0,-599464.0
2025-01-22,2344,28000,118000,0,9003311,0,9000,-55441,0,1354311,-24660,19000,173441,0,7649000,24660,29877.0,-801450.0,95522.0,585999.0,0.0,0.0,-3946535.0,-33471388.0,-15152.0,-545124.0
2025-02-03,2344,26000,75000,0,22957599,10000,-111000,-575683,0,-2731407,-174374,137000,650683,0,25689006,184374,-289790.0,-529839.0,-754953.0,122345.0,0.0,0.0,-4713179.0,-33702224.0,-209526.0,-695498.0
2025-02-04,2344,275107,139000,0,10637659,2000,27869,65656,0,-3199641,-10000,247238,73344,0,13837300,12000,-422904.0,-638851.0,-785949.0,219243.0,0.0,0.0,-8594085.0,-34077665.0,-183526.0,-697140.0
2025-02-05,2344,328278,233086,0,13254627,0,256278,211330,0,-137202,0,72000,21756,0,13391829,0,67529.0,-298301.0,-531057.0,334084.0,0.0,0.0,-3715744.0,-35112498.0,-179536.0,-602810.0
2025-02-06,2344,280913,128000,0,14236461,1000,162717,114434,0,5934461,-16000,118196,13566,0,8302000,17000,344864.0,-67640.0,-239704.0,448232.0,0.0,0.0,1220522.0,-27025471.0,-225034.0,-601323.0
2025-02-07,2344,107000,64000,0,2134603,0,-67444,-16327,0,-3230534,-3950,174444,80327,0,5365137,3950,268420.0,-122084.0,-200590.0,461704.0,0.0,0.0,-3364323.0,-26811773.0,-204324.0,-423335.0
2025-02-10,2344,148000,227000,0,6313000,0,-80929,23459,0,1008394,-12626,228929,203541,0,5304606,12626,298491.0,-378015.0,398552.0,837553.0,0.0,0.0,375478.0,-22582128.0,-42576.0,-382033.0
2025-02-11,2344,98000,100117,0,4147939,96000,-57549,-147506,0,-321061,85000,155549,247623,0,4469000,11000,213073.0,-513570.0,185390.0,678428.0,0.0,0.0,3254058.0,-18959820.0,52424.0,-297033.0
2025-02-12,2344,296999,395000,0,11053644,20000,200999,325709,0,6147642,7000,96000,69291,0,4906002,13000,157794.0,-636072.0,299769.0,477979.0,0.0,0.0,9538902.0,-16427645.0,59424.0,-306033.0
2025-02-13,2344,278579,246701,0,12561149,0,171579,236701,0,5012992,-50000,107000,10000,0,7548157,50000,166656.0,-91453.0,422036.0,773109.0,0.0,0.0,8617433.0,-6881002.0,25424.0,-348033.0
2025-02-14,2344,5066550,1657333,0,70361153,219000,3712941,-480640,0,-17500680,203000,1353609,2137973,0,87861833,16000,3947041.0,3742127.0,-42277.0,353223.0,0.0,0.0,-5652713.0,-22009776.0,232374.0,-52736.0
2025-02-17,2344,2265836,7841642,0,58586495,0,1241839,5858452,0,-8122303,-9000,1023997,1983190,0,66708798,9000,5269809.0,5172959.0,5792716.0,6567203.0,0.0,0.0,-14783410.0,-20506079.0,236000.0,-60102.0
2025-02-18,2344,3816483,2630542,0,61442710,2000,2609641,1429656,0,-19206287,-466000,1206842,1200886,0,80648997,468000,7936999.0,7833600.0,7369878.0,8007814.0,0.0,0.0,-33668636.0,-43295451.0,-315000.0,-419102.0
2025-02-19,2344,1712581,1309866,0,50210379,0,153938,-1507653,0,-30623671,-454000,1558643,2817519,0,80834050,454000,7889938.0,8264538.0,5536516.0,6721737.0,0.0,0.0,-70439949.0,-77129838.0,-776000.0,-880102.0
2025-02-20,2344,1247566,3941000,0,58991018,8000,-291150,1710921,0,-6810619,-481264,1538716,2230079,0,65801637,489264,7427209.0,7975052.0,7010736.0,8432967.0,0.0,0.0,-82263560.0,-84630060.0,-1207264.0,-1385366.0
2025-02-21,2344,2658634,2304988,0,57468657,10000,1919757,-3600612,0,3968690,-1000,738877,5905600,0,53499967,11000,5634025.0,9879363.0,3890764.0,3743419.0,0.0,0.0,-60794190.0,-73757761.0,-1411264.0,-1398366.0
2025-02-24,2344,307000,1286423,0,21770111,0,-1324503,-406535,0,1271111,-6000,1631503,1692958,0,20499000,6000,3067683.0,8346193.0,-2374223.0,3062092.0,0.0,0.0,-51400776.0,-70521887.0,-1408264.0,-1424366.0
2025-02-25,2344,3415110,5461000,0,41063760,0,2420981,421177,0,-3922353,-1311,994129,5039823,0,44986113,1311,2879023.0,10606191.0,-3382702.0,3386617.0,0.0,0.0,-36116842.0,-75125505.0,-943575.0,-1389677.0
2025-02-26,2344,933892,3788000,0,22739163,0,-1591636,-493001,0,-11443149,-1311,2525528,4281001,0,34182312,1311,1133449.0,9248710.0,-2368050.0,2937178.0,0.0,0.0,-16936320.0,-81553111.0,-490886.0,-1386998.0
2025-02-27,2344,437000,2698000,0,43012570,1115000,-1183708,-1117000,0,13764657,1066689,1620708,3815000,0,29247913,48311,240891.0,8179620.0,-5195971.0,1997097.0,0.0,0.0,3638956.0,-68786649.0,1057067.0,-349807.0
2025-03-03,2344,1508229,1295000,0,31776745,59000,688077,409928,0,5904716,24000,820152,885072,0,25872029,35000,-990789.0,8858697.0,-1185431.0,2462466.0,0.0,0.0,5574982.0,-64236244.0,1082067.0,-301147.0
2025-03-04,2344,399040,755000,0,20485642,55000,-1170600,-812197,0,-6832417,24313,1569640,1567197,0,27318059,30687,-836886.0,7799097.0,-1591093.0,2225952.0,0.0,0.0,-2528546.0,-68337254.0,1112380.0,-102460.0
2025-03-05,2344,876088,1146000,0,16473500,5000,232749,3000,0,-668653,-18000,643339,1143000,0,17142153,23000,-3025118.0,8003977.0,-2009270.0,2163296.0,0.0,0.0,725154.0,-65806266.0,1095691.0,-110460.0
2025-03-06,2344,244002,828000,0,7555100,12000,-1694886,431788,0,-11556183,12000,1938888,396212,0,19111283,0,-3128368.0,6052813.0,-1084481.0,2383754.0,0.0,0.0,612120.0,-77225247.0,1109002.0,-98460.0
2025-03-07,2344,937086,1641000,0,15757000,12000,644424,522036,0,-7301987,12000,292662,1118964,0,23058987,0,-1300236.0,6534520.0,554555.0,2791356.0,0.0,0.0,-20454524.0,-90461695.0,54313.0,-70460.0
2025-03-10,2344,998625,1297287,0,53677878,235000,18851,-384723,0,9486987,235000,979774,1682010,0,44190891,0,-1969462.0,6620815.0,-240096.0,2422960.0,0.0,0.0,-16872253.0,-77744174.0,265313.0,168490.0
2025-03-11,2344,653418,2674016,0,39193816,48000,-578708,348362,0,5781663,37000,1232126,2325654,0,33412153,11000,-1377570.0,6123036.0,920463.0,2747863.0,0.0,0.0,-4258173.0,-72970905.0,278000.0,218116.0
2025-03-12,2344,3812655,6538007,0,94437830,285000,3170278,3295221,0,42615384,284014,642377,3242786,0,51822446,986,1559959.0,9350863.0,4212684.0,6190590.0,0.0,0.0,39025864.0,-30034460.0,580014.0,417130.0
2025-03-13,2344,2705603,6163095,0,98638471,4177000,-929865,-2583223,0,-2454332,4177000,3635468,8746318,0,101092803,0,2324980.0,8219999.0,1197673.0,3281658.0,0.0,0.0,48127715.0,-38636434.0,4745014.0,4587130.0
2025-03-14,2344,797197,3004360,0,38123809,287000,-1051578,724700,0,-11092698,287000,1848775,2279660,0,49216507,0,628978.0,6996842.0,1400337.0,3769657.0,0.0,0.0,44337004.0,-54742124.0,5020014.0,4924130.0
2025-03-17,2344,323069,3874000,0,27284670,11000,-314828,-312802,0,-18593514,-71000,637897,4186802,0,45878184,82000,295299.0,2969073.0,1472258.0,3937495.0,0.0,0.0,16256503.0,-55834958.0,4714014.0,4650130.0
2025-03-18,2344,713855,2027813,0,24022600,91000,385808,-661123,0,1071614,90000,328047,2688936,0,22950986,1000,1259815.0,2113042.0,462773.0,-2582080.0,0.0,0.0,11546454.0,-46641041.0,4767014.0,4749130.0
2025-03-19,2344,2158692,2134000,0,29916866,154000,1691479,174997,0,-10752120,154000,467213,1959003,0,40668986,0,-218984.0,1194880.0,-2657451.0,-3836739.0,0.0,0.0,-41821050.0,-38186874.0,4637000.0,5369130.0
2025-03-20,2344,1238128,2774251,0,34542169,936000,63718,-218045,0,7102182,936000,1174410,2992296,0,27439987,0,774599.0,1104660.0,-292273.0,-2547131.0,0.0,0.0,-32264536.0,-461021.0,1396000.0,6759130.0
2025-03-21,2344,1603424,3824150,0,40298850,245000,-100517,1463063,0,1367570,-689977,1703941,2361087,0,38931280,934977,1725660.0,1295293.0,446090.0,-2794989.0,0.0,0.0,-19804268.0,7717168.0,419023.0,6550417.0
2025-03-24,2344,488000,477000,0,12688596,13000,-2582360,-2812249,0,-18686675,13000,3070360,3289249,0,31375271,0,-541872.0,-3206824.0,-2053357.0,-2006626.0,0.0,0.0,-19897429.0,-14938197.0,503023.0,6564417.0
2025-03-25,2344,325000,1348000,0,21151151,636000,-29010,-428482,0,4631151,636000,354010,1776482,0,16520000,0,-956690.0,-1911331.0,-1820716.0,-2028573.0,0.0,0.0,-16337892.0,-11578157.0,1049023.0,7206417.0
2025-03-26,2344,561017,1516000,0,16048300,0,368630,284328,0,-1547717,0,192387,1231672,0,17596017,0,-2279539.0,-3963682.0,-1711385.0,-2165422.0,0.0,0.0,-7133489.0,-9203521.0,895023.0,7207728.0
2025-03-27,2344,598626,508000,0,15568000,12000,292330,-130000,0,6068000,12000,306296,638000,0,9500000,0,-2050927.0,-2079716.0,-1623340.0,-1802421.0,0.0,0.0,-8167671.0,8307628.0,-28977.0,7221039.0
2025-03-28,2344,223150,336000,0,21070633,10000,-1992954,-1606910,0,12436133,10000,2216104,1942910,0,8634500,0,-3943364.0,-2888962.0,-4693313.0,-2292331.0,0.0,0.0,2900892.0,6979104.0,671000.0,6164350.0
2025-03-31,2344,402927,122000,0,35109200,24000,-724832,-1107390,0,15147200,24000,1127759,1229390,0,19962000,0,-2085836.0,-4301871.0,-2988454.0,-3809649.0,0.0,0.0,36734767.0,16221588.0,682000.0,6164350.0
2025-04-01,2344,911883,743000,0,16433400,390000,486424,-135063,0,-7386600,390000,425459,878063,0,23820000,0,-1570402.0,-2644847.0,-2695035.0,-3132515.0,0.0,0.0,24717016.0,15667405.0,436000.0,6530037.0
2025-04-02,2344,2253936,588000,0,20229100,297000,1579231,364417,0,6140713,294844,674705,223583,0,14088387,2156,-359801.0,-1298365.0,-2614946.0,-2771098.0,0.0,0.0,32405446.0,22476771.0,730844.0,6842881.0
2025-04-07,2344,0,0,0,1004001,0,-235000,0,0,1003601,0,235000,0,0,400,0,-887131.0,161521.0,-2484946.0,-3202886.0,0.0,0.0,27341047.0,35036555.0,718844.0,6830881.0
2025-04-08,2344,428000,695000,0,20404200,7000,-1481905,597404,0,-4377976,-53000,1909905,97596,0,24782176,60000,-376082.0,-1964808.0,-280632.0,-3127518.0,0.0,0.0,10526938.0,37960566.0,655844.0,6765881.0
2025-04-09,2344,557000,454958,0,30503374,0,-955797,-772042,0,-13398969,-2871000,1512797,1227000,0,43902343,2871000,-607047.0,-2939456.0,54716.0,-3514837.0,0.0,0.0,-18019231.0,15074610.0,-2239156.0,3659881.0
2025-04-10,2344,223222,0,0,4258000,331000,-168778,0,0,-16539000,331000,392000,0,0,20797000,0,-1262249.0,-2529526.0,189779.0,-3863199.0,0.0,0.0,-27171631.0,-7246053.0,-2298156.0,3953881.0
2025-04-11,2344,871405,677381,0,59870723,37147,-303008,155423,0,16706723,-1967853,1174413,521958,0,43164000,2005000,-3144488.0,-6002812.0,-19215.0,-7002997.0,0.0,0.0,-16605621.0,-33154714.0,-4560853.0,1702014.0
2025-04-14,2344,558010,1397000,0,34544135,10000,202885,-163346,0,6244412,-25723,355125,1560346,0,28299723,35723,-2706603.0,-4870062.0,-182561.0,-4583120.0,0.0,0.0,-11364810.0,-24455970.0,-4586576.0,-2500709.0
2025-04-15,2344,192572,359000,0,16904400,0,-115708,-246233,0,5592520,0,308280,605233,0,11311880,0,-1340406.0,-3934192.0,-1026198.0,-5554053.0,0.0,0.0,-1394314.0,-7770752.0,-4533576.0,-2787709.0
2025-04-16,2344,278542,37000,0,12984200,0,-709373,-141312,0,-7548800,-13000,987915,178312,0,20533000,13000,-1093982.0,-4328737.0,-395468.0,-5382563.0,0.0,0.0,4455855.0,3273962.0,-1675576.0,-2729709.0
2025-04-17,2344,214874,290000,0,14056028,0,-761,-147964,0,-3969372,-307000,215635,437964,0,18025400,307000,-925965.0,-4715306.0,-543432.0,-4869404.0,0.0,0.0,17025483.0,-1767024.0,-2313576.0,-3126709.0
2025-04-18,2344,1639227,2133000,0,18287100,5000,1066484,-44848,0,-13612928,-45000,572743,2177848,0,31900028,50000,443527.0,-5340301.0,-743703.0,-5089249.0,0.0,0.0,-13294168.0,-4627832.0,-390723.0,-3325709.0
2025-04-21,2344,698776,467732,0,26002357,263000,-441867,-273200,0,-6427643,62000,1140643,740932,0,32430000,201000,-201225.0,-5845886.0,-853557.0,-5144404.0,0.0,0.0,-25966223.0,-18157657.0,-303000.0,-4199709.0
2025-04-22,2344,1431430,1032226,0,37544946,613000,936175,129396,0,5002827,383000,495255,902830,0,32542119,230000,850658.0,-4809194.0,-477928.0,-6478071.0,0.0,0.0,-26555916.0,-14522400.0,80000.0,-3126732.0
2025-04-23,2344,398477,690000,0,22726500,6000,-179933,-630000,0,-1400445,6000,578410,1320000,0,24126945,0,1380098.0,-2406767.0,-966616.0,-4295822.0,0.0,0.0,-20407561.0,2763830.0,99000.0,-3133732.0
2025-04-24,2344,171795,177000,0,14231200,19000,-238710,-761977,0,-4448899,19000,410505,938977,0,18680099,0,1142149.0,-2616467.0,-1580629.0,-4629317.0,0.0,0.0,-20887088.0,-6316220.0,425000.0,-3750732.0
2025-04-25,2344,888259,965407,0,25007700,4000,503470,553407,0,16256087,4000,384789,412000,0,8751613,0,579135.0,-2481627.0,-982374.0,-4360238.0,0.0,0.0,8981927.0,11487584.0,474000.0,-3746732.0
2025-04-28,2344,51733,127000,0,7579999,18000,-436355,-23108,0,-4130733,18000,488088,150108,0,11710732,0,584647.0,-3210312.0,-732282.0,-4253346.0,0.0,0.0,11278837.0,1288851.0,430000.0,-3740732.0
2025-04-29,2344,574227,386424,0,17429000,0,485855,331424,0,11863998,-185000,88372,55000,0,5565002,185000,134327.0,-731503.0,-530254.0,-2315012.0,0.0,0.0,18140008.0,716716.0,-138000.0,-3935732.0
2025-04-30,2344,60251,36296,0,16908000,0,-842788,-702703,0,2350930,0,903039,738999,0,14557070,0,-528528.0,-849459.0,-602957.0,-1910325.0,0.0,0.0,21891383.0,-12079554.0,-144000.0,-3959732.0
2025-05-02,2344,175522,53000,0,13428417,0,51458,-170002,0,6015417,0,124064,223002,0,7413000,0,-238360.0,-1284425.0,-10982.0,-1945264.0,0.0,0.0,32355699.0,1322463.0,-163000.0,-4349732.0
2025-05-05,2344,82000,86291,0,11719000,14000,-739544,-654247,0,-2266417,-1572000,821544,740538,0,13985417,1586000,-1481374.0,-3603200.0,-1218636.0,-2963928.0,0.0,0.0,13833195.0,-7084667.0,-1739000.0,-6216576.0
2025-05-06,2344,250081,131959,0,13124238,44000,-240922,-700504,0,7026238,36354,491003,832463,0,6098000,7646,-1285941.0,-3609122.0,-1896032.0,-3664432.0,0.0,0.0,24990166.0,-1062030.0,-1720646.0,-6180222.0
2025-05-07,2344,29001,1555,0,7783855,6000,-423323,-209596,0,1784487,3354,452324,211151,0,5999368,2646,-2195119.0,-2550540.0,-2437052.0,-4471432.0,0.0,0.0,14910655.0,5100433.0,-1532292.0,-6123868.0
2025-05-08,2344,260999,292000,0,10838650,0,-171312,169679,0,-6814329,-13000,432311,122321,0,17652979,13000,-1523643.0,-1766055.0,-1564670.0,-3529711.0,0.0,0.0,5745396.0,11685073.0,-1545292.0,-3265868.0
2025-05-09,2344,99000,255082,0,4973100,0,-7534,247423,0,-1888900,0,106534,7659,0,6862000,0,-1582635.0,-1604811.0,-1147245.0,-3282288.0,0.0,0.0,-2158921.0,26335173.0,-1545292.0,-3596868.0
2025-05-12,2344,3631799,441000,0,34698500,0,3047363,408977,0,25215500,0,584436,32023,0,9483000,0,2204272.0,1745560.0,-84021.0,-3028734.0,0.0,0.0,25322996.0,34843950.0,26708.0,-1629015.0
2025-05-13,2344,9786067,1199808,0,41857917,0,7759779,65180,0,-13833233,0,2026288,1134628,0,55691150,0,10204973.0,9302454.0,681663.0,-2800208.0,0.0,0.0,4463525.0,14766305.0,-9646.0,-1603292.0
2025-05-14,2344,2642641,1304000,0,33184107,0,-951999,812743,0,-2196807,-5000,3594640,491257,0,35380914,5000,9676297.0,8466163.0,1704002.0,-1741232.0,0.0,0.0,482231.0,6976978.0,-18000.0,-1608292.0
2025-05-15,2344,1088994,1152000,0,41720538,0,-5016166,889970,0,12829647,-17571,6105160,262030,0,28890891,17571,4831443.0,4159370.0,2424293.0,-709950.0,0.0,0.0,20126207.0,27355425.0,-22571.0,-1612863.0
2025-05-16,2344,330793,66000,0,10936400,2000,-1263435,-796470,0,-2679536,-18000,1594228,862470,0,13615936,20000,3575542.0,2896696.0,1380400.0,-1358456.0,0.0,0.0,19335571.0,28645261.0,-40571.0,-1323863.0
2025-05-19,2344,283750,8000,0,11268370,1550000,-1434813,-299114,0,736370,1550000,1718563,307114,0,10532000,0,-906634.0,395399.0,672309.0,-1612722.0,0.0,0.0,-5143559.0,42994559.0,1509429.0,271137.0
2025-05-20,2344,4314964,772000,0,33646826,1600000,3882040,631948,0,3081883,1596000,432924,140052,0,30564943,4000,-4784373.0,4719306.0,1239077.0,-707574.0,0.0,0.0,11771557.0,52504085.0,3105429.0,1805137.0
2025-05-21,2344,89000,115000,0,15944070,1461000,-3571483,85000,0,-13493250,1431000,3660483,30000,0,29437320,30000,-7403857.0,211648.0,511334.0,-751970.0,0.0,0.0,475114.0,34008008.0,4541429.0,2853137.0
2025-05-22,2344,59000,93000,0,9844406,120000,-698150,-792492,0,-6361861,102000,757150,885492,0,16206267,18000,-3085841.0,-306569.0,-1171128.0,-914462.0,0.0,0.0,-18716394.0,29046592.0,4661000.0,2949137.0
2025-05-23,2344,289000,1000,0,6412000,0,-503848,-417000,0,-2777202,-16000,792848,418000,0,9189202,16000,-2326254.0,-571707.0,-791658.0,-569485.0,0.0,0.0,-18814060.0,30718289.0,4663000.0,2914137.0
2025-05-26,2344,42021,1000,0,15191050,0,-704097,-1060191,0,3723050,-11647,746118,1061191,0,11468000,11647,-1595538.0,-1779274.0,-1552735.0,-2183083.0,0.0,0.0,-15827380.0,18185252.0,3101353.0,2898490.0
2025-05-27,2344,483384,3000,0,10496000,0,-243637,-644304,0,2706650,-1151796,727021,647304,0,7789350,1151796,-5721215.0,-1586556.0,-2828987.0,-2804279.0,0.0,0.0,-16202613.0,25022635.0,353557.0,1728694.0
2025-05-28,2344,627257,10000,0,13859069,0,-241236,-94123,0,-3628931,-5000,868493,104123,0,17488000,5000,-2390968.0,-2313647.0,-3008110.0,-3229826.0,0.0,0.0,-6338294.0,9529706.0,-1082443.0,1908694.0
2025-05-29,2344,1956978,587000,0,18395386,0,1188212,171000,0,22386,0,768766,416000,0,18373000,0,-504606.0,-282647.0,-2044618.0,-2356123.0,0.0,0.0,45953.0,7201162.0,-1184443.0,1908694.0
2025-06-02,2344,271021,142000,0,7871692,1000,-2150834,-447360,0,-7345108,-307000,2421855,589360,0,15216800,308000,-2151592.0,-2484939.0,-2074978.0,-2633481.0,0.0,0.0,-4521953.0,-6159363.0,-1475443.0,1601694.0
2025-06-03,2344,537000,95000,0,7072101,0,168687,-83781,0,122419,0,368313,178781,0,6949682,0,-1278808.0,-1576708.0,-1098568.0,-2063015.0,0.0,0.0,-8122584.0,-3770527.0,-1463796.0,3173694.0
2025-06-04,2344,3475051,180000,0,26425838,0,3119983,-129000,0,11531920,0,355068,309000,0,14893918,0,2084812.0,1784197.0,-583264.0,-1491511.0,0.0,0.0,702686.0,735155.0,-312000.0,3137340.0
2025-06-05,2344,1361900,1538970,0,37740037,60000,-352460,1278970,0,14959037,60000,1714360,260000,0,22781000,0,1973588.0,1855060.0,789829.0,-2945.0,0.0,0.0,19290654.0,13909705.0,-247000.0,3193986.0
2025-06-06,2344,1041964,1476000,0,22456701,0,33200,1356000,0,12092674,0,1008764,120000,0,10364027,0,818576.0,2059572.0,1974829.0,1183376.0,0.0,0.0,31360942.0,32816708.0,-247000.0,3206986.0
2025-06-09,2344,679127,571000,0,24571000,0,-518149,-1362000,0,3705709,0,1197276,1933000,0,20865291,0,2451261.0,1548957.0,1060189.0,-426047.0,0.0,0.0,42411759.0,38411317.0,60000.0,3206986.0
2025-06-10,2344,4403658,1751000,0,47586676,3000,3963317,1182000,0,26318576,3000,440341,569000,0,21268100,0,6245891.0,2464911.0,2325970.0,346976.0,0.0,0.0,68607916.0,39514393.0,63000.0,3209986.0
2025-06-11,2344,450999,75000,0,23553623,0,-3650541,-855000,0,6521327,0,4101540,930000,0,17032296,0,-524633.0,-8945409.0,1599970.0,-573204.0,0.0,0.0,63597323.0,59868953.0,63000.0,3209986.0
2025-06-12,2344,206376,53000,0,13746000,0,-118689,-659000,0,6415277,-30086,325065,712000,0,7330723,30086,-290862.0,-8112099.0,-338000.0,-2044947.0,0.0,0.0,55053563.0,68481037.0,-27086.0,3184900.0
2025-06-13,2344,399561,128000,0,11176113,0,-265175,-246054,0,-5395487,-14000,664736,374054,0,16571600,14000,-589237.0,-3361108.0,-1940054.0,-3180971.0,0.0,0.0,37565402.0,50255903.0,-41086.0,3188471.0
2025-06-16,2344,75346,191000,0,12088000,0,-612733,-408040,0,-4706000,-9693,688079,599040,0,16794000,9693,-683821.0,-2710406.0,-986094.0,-2792541.0,0.0,0.0,29153693.0,48229439.0,-50779.0,3196778.0
2025-06-17,2344,1079248,25000,0,27556290,0,374105,-436000,0,17825290,-1287624,705143,461000,0,9731000,1287624,-4273033.0,-901488.0,-2604094.0,-2929427.0,0.0,0.0,20660407.0,65318359.0,-1341403.0,359154.0
2025-06-18,2344,5616860,1066000,0,43300067,744000,4872833,681611,0,-6000962,741000,744027,384389,0,49301029,3000,4250341.0,89305.0,-1067483.0,-2879764.0,0.0,0.0,8138118.0,56235514.0,-600403.0,-495846.0
2025-06-19,2344,458533,1172000,0,47358056,1744000,-3304516,168000,0,947651,1735000,3763049,1004000,0,46410405,9000,1064514.0,356272.0,-240483.0,-2796764.0,0.0,0.0,2670492.0,70676415.0,1164683.0,-191846.0
2025-06-20,2344,39791,568000,0,25773010,4037000,-1564908,-918000,0,469927,3362000,1604699,1486000,0,25303083,675000,-235219.0,-510486.0,-912429.0,-2922272.0,0.0,0.0,8535906.0,77508203.0,4540683.0,3068154.0
2025-06-23,2344,1817798,398000,0,37452905,1422000,1665142,-14000,0,23169905,159000,152656,412000,0,14283000,1263000,2042656.0,1658504.0,-518389.0,-2519272.0,0.0,0.0,36411811.0,103455310.0,4709376.0,3243154.0
2025-06-24,2344,4626440,2536872,0,82815646,2561000,1004888,-356364,0,26444646,2561000,3621552,2893236,0,56371000,0,2673439.0,3367489.0,-438753.0,-1815445.0,0.0,0.0,45031167.0,126176906.0,8558000.0,5815801.0
2025-06-25,2344,1428868,300000,0,46614897,0,-636111,-484020,0,2538897,-12000,2064979,784020,0,44076000,12000,-2835505.0,2975015.0,-1604384.0,-1655161.0,0.0,0.0,53571026.0,126009153.0,7805000.0,6955597.0
2025-06-26,2344,2041067,1514161,0,89944569,1787000,512079,594161,0,41374569,1771000,1528988,920000,0,48570000,16000,981090.0,3728330.0,-1178223.0,-966877.0,0.0,0.0,93997944.0,171012653.0,7841000.0,8731597.0
2025-06-27,2344,922809,388024,0,47082560,1366000,-830089,-1906976,0,-8074257,1193000,1752898,2295000,0,55156817,173000,1715909.0,1710029.0,-2167199.0,-3044853.0,0.0,0.0,85453760.0,162916010.0,5672000.0,9924597.0
2025-06-30,2344,113004,37000,0,26442070,111000,-1565115,-535656,0,-11102331,103000,1678119,572656,0,37544401,8000,-1514348.0,2295748.0,-2688855.0,-3133149.0,0.0,0.0,51181524.0,159158787.0,5616000.0,10334597.0
2025-07-01,2344,441702,256157,0,23716462,1710000,-87940,-629876,0,238993,788000,529642,886033,0,23477469,922000,-2607176.0,2039121.0,-2962367.0,-3679244.0,0.0,0.0,24975871.0,159275361.0,3843000.0,11122597.0
2025-07-02,2344,363334,845000,0,18465622,0,74687,68000,0,-14596378,0,288647,777000,0,33062000,0,-1896378.0,-1006175.0,-2410347.0,-3482244.0,0.0,0.0,7840596.0,133147063.0,3855000.0,11122597.0
2025-07-03,2344,457869,389000,0,13586000,1000,90376,86000,0,3772964,-425000,367493,303000,0,9813036,426000,-2318081.0,-563339.0,-2918508.0,-4675214.0,0.0,0.0,-29761009.0,121960990.0,1659000.0,10637597.0
2025-07-04,2344,39000,31000,0,15963020,2039000,-1252994,-594258,0,-7225980,1903000,1291994,625258,0,23189000,136000,-2740986.0,-1849533.0,-1605790.0,-6625472.0,0.0,0.0,-28912732.0,102642336.0,2369000.0,12540597.0
2025-07-07,2344,351700,304000,0,15405271,12000,172456,304000,0,7538271,-35000,179244,0,0,7867000,47000,-1003415.0,-1158928.0,-766134.0,-4959472.0,0.0,0.0,-10272130.0,106474898.0,2231000.0,12505597.0
2025-07-08,2344,289099,310000,0,17709000,38000,17035,286929,0,-2262096,-3000,272064,23071,0,19971096,41000,-898440.0,-5105210.0,150671.0,-5854543.0,0.0,0.0,-12773219.0,77894226.0,1440000.0,12499597.0
2025-07-09,2344,212200,2000,0,6479000,13000,-21010,-24000,0,-1739339,13000,233210,26000,0,8218339,0,-994137.0,-1475679.0,58671.0,-5023543.0,0.0,0.0,83820.0,69633560.0,1453000.0,12512597.0
2025-07-10,2344,180609,154000,0,8237118,7000,-343046,-406939,0,-553882,-11000,523655,560939,0,8791000,18000,-1427559.0,-1700036.0,-434268.0,-4771482.0,0.0,0.0,-4243026.0,62664401.0,1867000.0,12531683.0
2025-07-11,2344,401753,234000,0,19326163,15000,-119014,-453999,0,7013471,-545000,520767,687999,0,12312692,560000,-293579.0,-1553875.0,-294009.0,-4979427.0,0.0,0.0,9996425.0,75073359.0,-581000.0,12000683.0
2025-07-14,2344,126175,408000,0,9882000,8000,-169400,317000,0,-2517000,-892000,295575,91000,0,12399000,900000,-635435.0,-1110542.0,-281009.0,-4254387.0,0.0,0.0,-58846.0,77262359.0,-1438000.0,11118376.0
2025-07-15,2344,126177,302000,0,18837316,0,-58524,109974,0,-1769973,-808000,184701,192026,0,20607289,808000,-710994.0,-1543171.0,-457964.0,-3708413.0,0.0,0.0,433277.0,57667096.0,-2243000.0,11598000.0
2025-07-16,2344,327000,1154000,0,10877000,27000,203683,956812,0,-7878904,-976000,123317,197188,0,18755904,1003000,-486301.0,-6212321.0,522848.0,-3433212.0,0.0,0.0,-5706288.0,55789154.0,-3232000.0,9881000.0
2025-07-17,2344,942841,209000,0,15437355,74000,906702,72437,0,-6184061,45000,36139,136563,0,21621416,29000,763447.0,-2001103.0,1002224.0,-3528775.0,0.0,0.0,-11336467.0,48657442.0,-3176000.0,8191000.0
2025-07-18,2344,95000,159000,0,4356001,0,-354238,-101021,0,-9346641,-76000,449238,260021,0,13702642,76000,528223.0,-790433.0,1355202.0,-2711796.0,0.0,0.0,-27696579.0,38840874.0,-2707000.0,4753000.0
2025-07-21,2344,466659,72000,0,5945000,0,355189,-8456,0,-8468057,0,111470,80456,0,14413057,0,1052812.0,-2100386.0,1029746.0,-2706252.0,0.0,0.0,-33647636.0,7202912.0,-1815000.0,4594000.0
2025-07-22,2344,402321,93000,0,9368526,0,25610,47000,0,-1055474,-40000,376711,46000,0,10424000,40000,1136946.0,-3079664.0,966772.0,-2302888.0,0.0,0.0,-32933137.0,-20297208.0,-1047000.0,1993000.0
2025-07-23,2344,780450,419000,0,10709165,0,680452,275481,0,-3098835,-19000,99998,143519,0,13808000,19000,1613715.0,-1763101.0,285441.0,-1543387.0,0.0,0.0,-28153068.0,-25934940.0,-90000.0,1986000.0
2025-07-24,2344,165644,74000,0,9997612,0,-589505,-215179,0,-5612710,-15000,755149,289179,0,15610322,15000,117508.0,-2864685.0,-2175.0,-2352727.0,0.0,0.0,-27581717.0,-72922219.0,-150000.0,200000.0
2025-07-25,2344,208043,2000,0,5579318,0,44497,-57000,0,-237682,-63000,163546,59000,0,5817000,63000,516243.0,-1990099.0,41846.0,-502751.0,0.0,0.0,-18472758.0,-65085644.0,-137000.0,-1056000.0
2025-07-28,2344,499487,8000,0,7821199,0,297487,716,0,-996801,-1515000,202000,7284,0,8818000,1515000,458541.0,-127497.0,51018.0,33621.0,0.0,0.0,-11001502.0,-54980114.0,-1652000.0,-2674000.0
2025-07-29,2344,652970,192000,0,9727616,0,113517,47168,0,-10534384,-50000,539453,144832,0,20262000,50000,546448.0,73960.0,51186.0,710665.0,0.0,0.0,-20480412.0,-65753491.0,-1662000.0,-3512000.0
2025-07-30,2344,2075047,392000,0,12305561,0,1697919,362994,0,4355561,-1000,377128,29006,0,7950000,1000,1563915.0,1697192.0,138699.0,1005659.0,0.0,0.0,-13026016.0,-46801552.0,-1644000.0,-3513000.0
2025-07-31,2344,201058,114000,0,7056100,3000,-718432,-270063,0,-8684900,-36000,919490,384063,0,15741000,39000,1434988.0,888384.0,83815.0,649596.0,0.0,0.0,-16098206.0,-59259416.0,-1665000.0,-3124000.0
2025-08-01,2344,1433237,184000,0,10903011,0,1096048,52196,0,-229989,-60000,337189,131804,0,11133000,60000,2486539.0,3237426.0,193011.0,1296050.0,0.0,0.0,-16090513.0,-52263425.0,-1662000.0,-5087000.0
2025-08-04,2344,370015,139000,0,5264748,0,-853061,-101420,0,-7919252,0,1223076,240420,0,13184000,0,1335991.0,2211909.0,90875.0,890630.0,0.0,0.0,-23012964.0,-67720948.0,-147000.0,-5052000.0
2025-08-05,2344,632285,155000,0,8053126,55000,297555,-47000,0,2814896,3000,334730,202000,0,5238230,52000,1520029.0,2492429.0,-3293.0,556701.0,0.0,0.0,-9663684.0,-62643956.0,-94000.0,-5046000.0
2025-08-06,2344,507926,56000,0,4803000,35000,-121206,-114000,0,-26624581,20000,629132,170000,0,31427581,15000,-299096.0,2392233.0,-480287.0,466701.0,0.0,0.0,-40643826.0,-87529198.0,-73000.0,-5039000.0
2025-08-07,2344,471000,324161,0,7060000,0,-97365,32089,0,-15587754,-2000,568365,292072,0,22647754,2000,321971.0,2637914.0,-178135.0,905729.0,0.0,0.0,-47546680.0,-102563070.0,-39000.0,-5030000.0
2025-08-08,2344,2134356,700304,0,36116419,0,1553909,406286,0,6942389,-13000,580447,294018,0,29174030,13000,779832.0,4310837.0,175955.0,1766014.0,0.0,0.0,-40374302.0,-102634152.0,8000.0,-4498000.0
2025-08-11,2344,382816,189000,0,7217905,0,-218125,172732,0,-6221095,-27000,600941,16268,0,13439000,27000,1414768.0,4262112.0,450107.0,1621746.0,0.0,0.0,-38676145.0,-106338247.0,-19000.0,-3633000.0
2025-08-12,2344,2317383,520188,0,32846000,0,2128570,161192,0,7353300,-17000,188813,358996,0,25492700,17000,3245783.0,6449206.0,658299.0,1672964.0,0.0,0.0,-34137741.0,-97214974.0,-39000.0,-2842000.0
2025-08-13,2344,140439,103000,0,17236584,250000,-1446166,-309100,0,-2005416,220000,1586605,412100,0,19242000,30000,1920823.0,4799357.0,463199.0,407052.0,0.0,0.0,-9518576.0,-91341486.0,161000.0,-1646000.0
2025-08-14,2344,262376,155000,0,7946189,0,143143,154000,0,-11292811,-40000,119233,1000,0,19239000,40000,2161331.0,4035798.0,585110.0,488615.0,0.0,0.0,-5223633.0,-96450236.0,123000.0,-1731000.0
2025-08-15,2344,1471272,705000,0,11250400,0,1288799,575873,0,1172274,-12000,182473,129127,0,10078126,12000,1896221.0,5678835.0,754697.0,1165509.0,0.0,0.0,-10993748.0,-85931321.0,124000.0,-1667000.0
2025-08-18,2344,5711390,1729000,0,32805200,0,3049366,1527000,0,3246830,-357000,2662024,202000,0,29558370,357000,5163712.0,8373012.0,2108965.0,2700965.0,0.0,0.0,-1525823.0,-74216434.0,-206000.0,-2024000.0
2025-08-19,2344,252000,410000,0,10074488,0,-4132078,237000,0,-3838328,-350000,4384078,173000,0,13912816,350000,-1096936.0,4215324.0,2184773.0,2890965.0,0.0,0.0,-12717451.0,-76999288.0,-539000.0,-2334000.0
2025-08-20,2344,308005,91000,0,12696100,0,-2161002,56126,0,-4241589,-653000,2469007,34874,0,16937689,653000,-1811772.0,1373870.0,2549999.0,2671610.0,0.0,0.0,-14953624.0,-78142042.0,-1412000.0,-2968000.0
2025-08-21,2344,1528400,84000,0,16995344,0,662508,-4000,0,4693344,0,865892,88000,0,12302000,0,-1292407.0,2625883.0,2391999.0,2882789.0,0.0,0.0,1032531.0,-67835988.0,-1372000.0,-2953000.0
2025-08-22,2344,224223,15000,0,6739300,0,-1017011,-31000,0,-24700,0,1241234,46000,0,6764000,0,-3598217.0,1564375.0,1785126.0,2908789.0,0.0,0.0,-164443.0,-67623006.0,-1360000.0,-2890000.0
2025-08-25,2344,762369,207000,0,16420800,0,632119,56000,0,9583800,-13000,130250,151000,0,6837000,13000,-6015464.0,1899007.0,314126.0,2964073.0,0.0,0.0,6172527.0,-57042405.0,-1016000.0,-1388000.0
2025-08-26,2344,1404639,799000,0,15530286,0,962028,725000,0,9798286,-5000,442611,74000,0,5732000,5000,-921358.0,2747518.0,802126.0,3641905.0,0.0,0.0,19809141.0,-36709735.0,-671000.0,-1343000.0
2025-08-27,2344,1890007,1829885,0,37411188,215000,839792,1601885,0,21560716,210000,1050215,228000,0,15850472,5000,2079436.0,1889391.0,2347885.0,4880796.0,0.0,0.0,45611446.0,-19504580.0,192000.0,-1132000.0
2025-08-28,2344,373646,2131159,0,14673000,0,-1323074,1168159,0,-3767877,-39000,1696720,963000,0,18440877,39000,93854.0,1284749.0,3520044.0,6319018.0,0.0,0.0,37150225.0,-14587557.0,153000.0,-1135000.0
2025-08-29,2344,630039,1324000,0,21144196,35000,101422,468000,0,-3700062,0,528617,856000,0,24844258,35000,1212287.0,290123.0,4019044.0,6734822.0,0.0,0.0,33474863.0,-18057630.0,153000.0,-1075000.0
2025-09-01,2344,2819903,511355,0,38052000,0,2381428,-614300,0,25594537,-17000,438475,1125655,0,12457463,17000,2961596.0,3524612.0,3348744.0,6221942.0,0.0,0.0,49485600.0,15456159.0,149000.0,-1092000.0
2025-09-02,2344,300609,309038,0,21602800,0,-1065834,-424869,0,-20629868,-39000,1366443,733907,0,42232668,39000,933734.0,2161223.0,2198875.0,5844073.0,0.0,0.0,19057446.0,-7988605.0,115000.0,-1134000.0
2025-09-03,2344,1468883,336000,0,25274781,40000,908663,-373000,0,6445761,-128000,560220,709000,0,18829020,168000,1002605.0,3191092.0,223990.0,5585073.0,0.0,0.0,3942491.0,25081737.0,-223000.0,-1282000.0
2025-09-04,2344,1323115,625000,0,27943000,80000,81132,229000,0,15223764,69000,1241983,396000,0,12719236,11000,2406811.0,3369589.0,-715169.0,5781984.0,0.0,0.0,22934132.0,55893255.0,-115000.0,-1211000.0
2025-09-05,2344,4905235,4641325,0,82017000,245000,3965339,3888325,0,59513010,228000,939896,753000,0,22503990,17000,6270728.0,5781019.0,2705156.0,9264023.0,0.0,0.0,86147204.0,108463876.0,113000.0,-970000.0
2025-09-08,2344,8238162,7076099,0,108801450,470000,3786361,-750832,0,38792337,22000,4451801,7826931,0,70009113,448000,7675661.0,9785505.0,2568624.0,8340459.0,0.0,0.0,99345004.0,153477308.0,152000.0,-921000.0
2025-09-09,2344,1638703,2321000,0,57542150,0,-823164,-1499421,0,-4091970,-36000,2461867,3820421,0,61634120,36000,7918331.0,6833771.0,1494072.0,6679846.0,0.0,0.0,115882902.0,142032038.0,155000.0,-940000.0
2025-09-10,2344,4217246,2165833,0,82963582,600000,1193603,-240042,0,21888365,-1608000,3023643,2405875,0,61075217,2208000,8203271.0,9473540.0,1627030.0,6748904.0,0.0,0.0,131325506.0,165925819.0,-1325000.0,-2768000.0
2025-09-11,2344,3180228,2256203,0,70031398,10750000,-2392696,-290306,0,-9216759,10700000,5572924,2546509,0,79248157,50000,5729443.0,6937701.0,1107724.0,6304598.0,0.0,0.0,106884983.0,168001871.0,9306000.0,7972000.0
2025-09-12,2344,3551703,3094362,0,102004300,8640000,2079013,-292757,0,44686135,8629000,1472690,3387119,0,57318165,11000,3843117.0,7727915.0,-3073358.0,5435968.0,0.0,0.0,92058108.0,211515732.0,17707000.0,16613000.0
2025-09-15,2344,14257174,5541000,0,95479155,6190000,13403159,3067831,0,-54014270,6140000,854015,2473169,0,149493425,50000,13459915.0,18081708.0,745305.0,6976799.0,0.0,0.0,-748499.0,154254632.0,23825000.0,23110000.0
2025-09-16,2344,9589762,3183290,0,168792630,37541000,3004508,-114755,0,39601511,37495000,6585254,3298045,0,129191119,46000,17287587.0,25218294.0,2129971.0,6625044.0,0.0,0.0,42944982.0,197694471.0,61356000.0,60955000.0
2025-09-17,2344,12739983,5710373,0,146015012,10354000,4849539,3146363,0,55339193,10264000,7890444,2564010,0,90675819,90000,20943523.0,32228835.0,5516376.0,9715281.0,0.0,0.0,76395810.0,257275253.0,73228000.0,71872000.0
2025-09-18,2344,5116361,4448090,0,99451130,36780000,3745498,1210090,0,12739212,36569000,1370863,3238000,0,86711918,211000,27081717.0,35311825.0,7016772.0,10929371.0,0.0,0.0,98351781.0,265321121.0,99097000.0,108441000.0
2025-09-19,2344,7098352,5376446,0,168517771,5182000,-5069486,-1356022,0,39989438,4919000,12167838,6732468,0,128528333,263000,19933218.0,31259350.0,5953507.0,9604349.0,0.0,0.0,93655084.0,305335259.0,95387000.0,113360000.0
2024-09-23,2379,23211,28569,0,977271,306000,17178,13569,0,-435225,291000,6033,15000,0,1412496,15000,17178.0,17178.0,13569.0,13569.0,0.0,0.0,-435225.0,-435225.0,291000.0,291000.0
2024-09-24,2379,24000,55011,0,739970,316892,12112,49967,0,-543957,316547,11888,5044,0,1283927,345,29290.0,29290.0,63536.0,63536.0,0.0,0.0,-979182.0,-979182.0,607547.0,607547.0
2024-09-25,2379,29849,48545,0,1508705,307000,11062,39562,0,-1128270,306292,18787,8983,0,2636975,708,40352.0,40352.0,103098.0,103098.0,0.0,0.0,-2107452.0,-2107452.0,913839.0,913839.0
2024-09-26,2379,22660,38075,0,1444466,306000,16360,29075,0,-1063481,304540,6300,9000,0,2507947,1460,56712.0,56712.0,132173.0,132173.0,0.0,0.0,-3170933.0,-3170933.0,1218379.0,1218379.0
2024-09-27,2379,6300,23266,0,1725372,9488,-6593,7081,0,-305944,-650,12893,16185,0,2031316,10138,50119.0,50119.0,139254.0,139254.0,0.0,0.0,-3476877.0,-3476877.0,1217729.0,1217729.0
2024-09-30,2379,65000,27000,0,1789816,27595,50044,13257,0,-654355,-6027,14956,13743,0,2444171,33622,82985.0,100163.0,138942.0,152511.0,0.0,0.0,-3696007.0,-4131232.0,920702.0,1211702.0
2024-10-01,2379,122530,8000,0,1259013,20372,101691,3619,0,-474195,-10628,20839,4381,0,1733208,31000,172564.0,201854.0,92594.0,156130.0,0.0,0.0,-3626245.0,-4605427.0,593527.0,1201074.0
2024-10-04,2379,157686,21000,0,2027782,612726,153616,-7819,0,-124321,611381,4070,28819,0,2152103,1345,315118.0,355470.0,45213.0,148311.0,0.0,0.0,-2622296.0,-4729748.0,898616.0,1812455.0
2024-10-07,2379,77000,37000,0,1244944,117744,62691,21586,0,-516407,109744,14309,15414,0,1761351,8000,361449.0,418161.0,37724.0,169897.0,0.0,0.0,-2075222.0,-5246155.0,703820.0,1922199.0
2024-10-08,2379,98000,24000,0,1715780,72479,90159,6471,0,-781220,16098,7841,17529,0,2497000,56381,458201.0,508320.0,37114.0,176368.0,0.0,0.0,-2550498.0,-6027375.0,720568.0,1938297.0
2024-10-09,2379,60708,10388,0,1561580,4298,38937,-14003,0,158705,-8771,21771,24391,0,1402875,13069,447094.0,547257.0,9854.0,162365.0,0.0,0.0,-1737438.0,-5868670.0,717824.0,1929526.0
2024-10-11,2379,47000,4200,0,785899,25603,36216,1200,0,-15101,24047,10784,3000,0,801000,1556,381619.0,583473.0,7435.0,163565.0,0.0,0.0,-1278344.0,-5883771.0,752499.0,1953573.0
2024-10-14,2379,75201,1000,0,512685,40355,73247,-190,0,-81415,-1957,1954,1190,0,594100,42312,301250.0,656720.0,15064.0,163375.0,0.0,0.0,-1235438.0,-5965186.0,139161.0,1951616.0
2024-10-15,2379,29201,28000,0,912948,32892,24216,6000,0,235703,29754,4985,22000,0,677245,3138,262775.0,680936.0,-522.0,169375.0,0.0,0.0,-483328.0,-5729483.0,59171.0,1981370.0
2024-10-16,2379,231000,56000,0,1690454,36966,203914,38742,0,-932061,-45448,27086,17258,0,2622515,82414,376530.0,884850.0,31749.0,208117.0,0.0,0.0,-634169.0,-6661544.0,-2375.0,1935922.0
2024-10-17,2379,194000,64000,0,2578887,34000,124866,51313,0,-1760450,-29000,69134,12687,0,4339337,63000,462459.0,1009716.0,97065.0,259430.0,0.0,0.0,-2553324.0,-8421994.0,-22604.0,1906922.0
2024-10-18,2379,33000,59000,0,2021467,183595,4789,16077,0,-241981,18457,28211,42923,0,2263448,165138,431032.0,1014505.0,111942.0,275507.0,0.0,0.0,-2780204.0,-8663975.0,-28194.0,1925379.0
2024-10-21,2379,14000,19000,0,1976466,303595,7600,1900,0,234281,300526,6400,17100,0,1742185,3069,365385.0,1022105.0,114032.0,277407.0,0.0,0.0,-2464508.0,-8429694.0,274289.0,2225905.0
2024-10-22,2379,10498,6356,0,2782711,277073,-3982,3356,0,-10189,242004,14480,3000,0,2792900,35069,337187.0,1018123.0,111388.0,280763.0,0.0,0.0,-2710400.0,-8439883.0,486539.0,2467909.0
2024-10-23,2379,54000,10000,0,1742807,239595,32214,-27924,0,-315344,28250,21786,37924,0,2058151,211345,165487.0,1050337.0,44722.0,252839.0,0.0,0.0,-2093683.0,-8755227.0,560237.0,2496159.0
2024-10-24,2379,124198,7300,0,3430673,193520,110198,-15077,0,404739,176451,14000,22377,0,3025934,17069,150819.0,1143357.0,-21668.0,224193.0,0.0,0.0,71506.0,-7915263.0,765688.0,2381610.0
2024-10-25,2379,21000,4000,0,1277159,469651,18000,4000,0,73109,428582,3000,0,0,1204050,41069,164030.0,1149245.0,-33745.0,178226.0,0.0,0.0,386596.0,-7298197.0,1175813.0,2493645.0
2024-10-28,2379,36000,19000,0,783165,39992,23463,14999,0,-209835,11923,12537,4001,0,993000,28069,179893.0,1161646.0,-20646.0,153663.0,0.0,0.0,-57520.0,-6379762.0,887210.0,2199276.0
2024-10-29,2379,133512,27005,0,1429882,166386,119922,-15109,0,-117015,89317,13590,42114,0,1546897,77069,303797.0,1265208.0,-39111.0,109479.0,0.0,0.0,-164346.0,-5433296.0,734523.0,1984053.0
2024-10-30,2379,64000,5000,0,946511,63086,51910,3964,0,-293937,41017,12090,1036,0,1240448,22069,323493.0,1323711.0,-7223.0,106362.0,0.0,0.0,-142939.0,-5421289.0,747290.0,2025720.0
2024-11-01,2379,129182,64372,0,3200320,141176,83013,4367,0,-417569,122176,46169,60005,0,3617889,19000,296308.0,1356680.0,12221.0,97472.0,0.0,0.0,-965247.0,-5184503.0,693015.0,2153923.0
2024-11-04,2379,36189,26000,0,945335,127128,16866,22886,0,-542110,102128,19323,3114,0,1487445,25000,295174.0,1271855.0,31107.0,116739.0,0.0,0.0,-1580466.0,-5252418.0,366561.0,2266679.0
2024-11-05,2379,27776,7000,0,812643,115005,16776,-5619,0,-301860,112005,11000,12619,0,1114503,3000,288487.0,1135015.0,10489.0,118939.0,0.0,0.0,-1672491.0,-5429957.0,466643.0,1767303.0
2024-11-06,2379,42358,56372,0,1926127,33861,5148,53372,0,512925,32861,37210,3000,0,1413202,1000,173713.0,1077472.0,78970.0,150725.0,0.0,0.0,-1042551.0,-4400625.0,410187.0,1690420.0
2024-11-07,2379,32581,13000,0,892450,90513,23581,9523,0,-371010,88513,9000,3477,0,1263460,2000,145384.0,1010894.0,84529.0,153777.0,0.0,0.0,-1119624.0,-3990415.0,457683.0,1762835.0
2024-11-08,2379,33847,4000,0,1001580,87364,-5210,-2100,0,-292703,83364,39057,6100,0,1294283,4000,57161.0,966747.0,78062.0,165680.0,0.0,0.0,-994758.0,-4441823.0,418871.0,1854970.0
2024-11-11,2379,44095,9000,0,798500,107293,31095,-1025,0,-70564,85375,13000,10025,0,869064,21918,71390.0,961626.0,54151.0,163455.0,0.0,0.0,-523212.0,-4497286.0,402118.0,1916298.0
2024-11-12,2379,181243,98300,0,1262372,252061,149893,18200,0,-257735,246061,31350,80100,0,1520107,6000,204507.0,1038272.0,77970.0,181845.0,0.0,0.0,-479087.0,-4673606.0,536174.0,2164316.0
2024-11-13,2379,106251,53000,0,839685,328199,66129,-20000,0,-305616,326522,40122,73000,0,1145301,1677,265488.0,1080185.0,4598.0,155845.0,0.0,0.0,-1297628.0,-5214925.0,829835.0,2461084.0
2024-11-14,2379,160771,106000,0,1342061,388034,114383,-186000,0,-490933,386034,46388,292000,0,1832994,2000,356290.0,990654.0,-190925.0,-68897.0,0.0,0.0,-1417551.0,-4773797.0,1127356.0,2892566.0
2024-11-15,2379,66741,73000,0,1127823,12273,29146,-25000,0,-70587,-5727,37595,98000,0,1198410,18000,390646.0,894934.0,-213825.0,-145210.0,0.0,0.0,-1195435.0,-3083934.0,1038265.0,2915839.0
2024-11-18,2379,146706,84100,0,1191164,1337877,103303,-69900,0,-1065995,1237877,43403,154000,0,2257159,100000,462854.0,993448.0,-282700.0,-231187.0,0.0,0.0,-2190866.0,-3907948.0,2190767.0,4135259.0
2024-11-19,2379,70444,70407,0,1449853,2801056,20444,50407,0,-1972524,2682272,50000,20000,0,3422377,118784,333405.0,1006292.0,-250493.0,-182680.0,0.0,0.0,-3905655.0,-6114753.0,4626978.0,6517005.0
2024-11-20,2379,75000,39000,0,784150,2205207,41569,21000,0,-2920238,2183509,33431,18000,0,3704388,21698,308845.0,1051843.0,-209493.0,-165036.0,0.0,0.0,-6520277.0,-9024802.0,6483965.0,8458510.0
2024-11-21,2379,55186,23499,0,827204,2057598,35979,11499,0,-1809572,2043598,19207,12000,0,2636776,14000,230441.0,1055608.0,-11994.0,-125613.0,0.0,0.0,-7838916.0,-10519030.0,8141529.0,10473858.0
2024-11-22,2379,88000,31000,0,438909,1662334,21512,27383,0,-2750051,1662334,66488,3617,0,3188960,0,222807.0,966922.0,40389.0,-83153.0,0.0,0.0,-10518380.0,-13673820.0,9809590.0,11959741.0
2024-11-25,2379,26000,33000,0,1530616,259235,16045,12702,0,-623587,253214,9955,20298,0,2154203,6021,135549.0,964967.0,122991.0,-74451.0,0.0,0.0,-10075972.0,-14370516.0,8824927.0,11784373.0
2024-11-26,2379,44000,28000,0,955802,226000,24799,12164,0,-583591,217291,19201,15836,0,1539393,8709,139904.0,966303.0,84748.0,-77286.0,0.0,0.0,-8687039.0,-14744272.0,6359946.0,11989741.0
2024-11-27,2379,207000,9153,0,569278,221668,185887,-30067,0,-577211,217716,21113,39220,0,1146489,3952,284222.0,1032268.0,33681.0,-92244.0,0.0,0.0,-6344012.0,-15204468.0,4394153.0,12118140.0
2024-11-28,2379,170000,48089,0,817816,288794,118949,7004,0,-841684,276559,51051,41085,0,1659500,12235,367192.0,1099307.0,29186.0,-89204.0,0.0,0.0,-5376124.0,-15752215.0,2627114.0,12353682.0
2024-11-29,2379,56000,18203,0,1447868,302334,51381,-12090,0,-316828,298629,4619,30293,0,1764696,3705,397061.0,1067675.0,-10287.0,-105661.0,0.0,0.0,-2942901.0,-15651474.0,1263409.0,12530135.0
2024-12-02,2379,41756,8335,0,974277,13283,27029,-29225,0,377885,13057,14727,37560,0,596392,226,408045.0,1077838.0,-52214.0,-157772.0,0.0,0.0,-1941429.0,-14731479.0,1023252.0,12441064.0
2024-12-03,2379,55653,49967,0,806363,96000,29721,32769,0,-363177,92321,25932,17198,0,1169540,3679,412967.0,1090783.0,-31609.0,-119384.0,0.0,0.0,-1721015.0,-14792796.0,898282.0,12421380.0
2024-12-04,2379,91335,17400,0,2240804,41000,30195,5400,0,1187297,18222,61140,12000,0,1053507,22778,257275.0,1115830.0,3858.0,-167356.0,0.0,0.0,43493.0,-14118424.0,698788.0,12406741.0
2024-12-05,2379,17798,21000,0,968043,46000,-24012,20000,0,294547,19310,41810,1000,0,673496,26690,114314.0,1068237.0,16854.0,-156879.0,0.0,0.0,1179724.0,-13452867.0,441539.0,12337538.0
2024-12-06,2379,143169,175198,0,2616523,914000,91169,104898,0,1229824,896862,52000,70300,0,1386699,17138,154102.0,1164616.0,133842.0,-49881.0,0.0,0.0,2726376.0,-11930340.0,1039772.0,13151036.0
2024-12-09,2379,82109,18000,0,2229584,282000,-8333,9496,0,600438,272058,90442,8504,0,1629146,9942,118740.0,1125188.0,172563.0,-39360.0,0.0,0.0,2948929.0,-11259338.0,1298773.0,13337719.0
2024-12-10,2379,82465,22400,0,2655791,53000,37888,-33600,0,1263840,-64169,44577,56000,0,1391951,117169,126907.0,1013183.0,106194.0,-91160.0,0.0,0.0,4575946.0,-9737763.0,1142283.0,13027489.0
2024-12-11,2379,138362,18200,0,2211394,263000,94639,8200,0,766024,259245,43723,10000,0,1445370,3755,191351.0,1041693.0,108994.0,-62960.0,0.0,0.0,4154673.0,-8666123.0,1383306.0,12960212.0
2024-12-12,2379,75965,15000,0,1914560,132000,-335,-22000,0,-69844,103633,76300,37000,0,1984404,28367,215028.0,926975.0,66994.0,101040.0,0.0,0.0,3790282.0,-8245034.0,1467629.0,12677811.0
2024-12-13,2379,94542,23000,0,1392704,57002,80059,-26000,0,564399,50781,14483,49000,0,828305,6221,203918.0,977888.0,-63904.0,100040.0,0.0,0.0,3124857.0,-7610048.0,621548.0,12734319.0
2024-12-16,2379,114218,25428,0,1842658,17000,92852,-51572,0,204013,-15139,21366,77000,0,1638645,32139,305103.0,967437.0,-124972.0,118368.0,0.0,0.0,2728432.0,-6340040.0,334351.0,11481303.0
2024-12-17,2379,119986,167693,0,2737421,256983,91950,80693,0,1134086,226765,28036,87000,0,1603335,30218,359165.0,1038943.0,-10679.0,148654.0,0.0,0.0,2598678.0,-3233430.0,625285.0,9025796.0
2024-12-18,2379,57064,18047,0,1439138,83000,19102,-23955,0,357080,76136,37962,42002,0,1082058,6864,283628.0,1016476.0,-42834.0,103699.0,0.0,0.0,2189734.0,43888.0,442176.0,6918423.0
2024-12-19,2379,87107,23000,0,1592100,115668,62589,-63315,0,-159822,100399,24518,86315,0,1751922,15269,346552.0,1043086.0,-84149.0,28885.0,0.0,0.0,2099756.0,1693638.0,438942.0,4975224.0
2024-12-20,2379,79212,30400,0,1819703,162001,64765,-19113,0,351322,-124452,14447,49513,0,1468381,286453,331258.0,1086339.0,-77262.0,-17611.0,0.0,0.0,1886679.0,4795011.0,263709.0,3188438.0
2024-12-23,2379,8146,32292,0,1293033,6001,-4854,13297,0,680033,-287999,13000,18995,0,613000,294000,233552.0,1065440.0,-12393.0,-17016.0,0.0,0.0,2362699.0,6098631.0,-9151.0,2647225.0
2024-12-24,2379,3179,6000,0,733145,0,-17173,-7000,0,498301,-267000,20352,13000,0,234844,267000,124429.0,1023468.0,-100086.0,-36180.0,0.0,0.0,1726914.0,7180523.0,-502916.0,2162934.0
2024-12-25,2379,24423,34000,0,351746,43000,5323,2000,0,162412,12000,19100,32000,0,189334,31000,110650.0,842904.0,-74131.0,-4113.0,0.0,0.0,1532246.0,7920146.0,-567052.0,1957218.0
2024-12-26,2379,55982,69712,0,960000,274000,41782,57712,0,502000,255377,14200,12000,0,458000,18623,89843.0,765737.0,46896.0,46595.0,0.0,0.0,2194068.0,9263830.0,-412074.0,1936036.0
2024-12-27,2379,43683,22100,0,938900,153063,16610,17100,0,18514,114994,27073,5000,0,920386,38069,41688.0,730966.0,83109.0,75785.0,0.0,0.0,1861260.0,9599172.0,-172628.0,1752401.0
2024-12-30,2379,80104,9164,0,915848,1242000,29928,-30836,0,-1170535,1200609,50176,40000,0,2086383,41391,76470.0,733865.0,38976.0,74174.0,0.0,0.0,10692.0,8050752.0,1315980.0,2939953.0
2024-12-31,2379,97987,20240,0,1251330,3431791,62088,-34760,0,-2968827,3287552,35899,55000,0,4220157,144239,155731.0,766232.0,11216.0,6645.0,0.0,0.0,-3456436.0,5445102.0,4870532.0,6135184.0
2025-01-02,2379,173029,16000,0,1418099,947000,148512,-113707,0,-349571,594509,24517,129707,0,1767670,352491,298920.0,884549.0,-104491.0,-112462.0,0.0,0.0,-3968419.0,3908234.0,5453041.0,6711471.0
2025-01-03,2379,103615,11000,0,1822011,114000,85894,2025,0,1214011,-385000,17721,8975,0,608000,499000,343032.0,994455.0,-160178.0,-130437.0,0.0,0.0,-3256408.0,4827698.0,4812664.0,6307161.0
2025-01-06,2379,111056,27000,0,1491679,2000,108913,18926,0,818317,-203850,2143,8074,0,673362,205850,435335.0,1012199.0,-158352.0,-216409.0,0.0,0.0,-2456605.0,4416191.0,4493820.0,5206449.0
2025-01-07,2379,64019,7000,0,1798160,0,43073,-2433,0,538265,-346133,20946,9433,0,1259895,346133,448480.0,1063605.0,-129949.0,-228338.0,0.0,0.0,-747805.0,4354018.0,2947078.0,4588258.0
2025-01-08,2379,54820,10000,0,1855115,4000,27153,898,0,822168,-226128,27667,9102,0,1032947,230128,413545.0,1052870.0,-94291.0,-193840.0,0.0,0.0,3043190.0,3912346.0,-566602.0,4426299.0
2025-01-09,2379,187129,8000,0,2482000,1000,144864,4000,0,677522,-19944,42265,4000,0,1804478,20944,409897.0,1103095.0,23416.0,-198040.0,0.0,0.0,4070283.0,3823844.0,-1181055.0,4147110.0
2025-01-10,2379,191412,25021,0,1310257,75000,156405,19624,0,-65627,57404,35007,5397,0,1375884,17596,480408.0,1259835.0,41015.0,-156416.0,0.0,0.0,2790645.0,3828061.0,-738651.0,4100881.0
2025-01-13,2379,311370,64141,0,1684789,369334,274671,-28047,0,-7705,369334,36699,92188,0,1692494,0,646166.0,1454447.0,-5958.0,-158463.0,0.0,0.0,1964623.0,3255957.0,-165467.0,4419434.0
2025-01-14,2379,90000,5026,0,638786,193000,79897,-8324,0,-181276,187902,10103,13350,0,820062,5098,682990.0,1441492.0,-11849.0,-115215.0,0.0,0.0,1245082.0,2870668.0,368568.0,4622475.0
2025-01-15,2379,201143,30000,0,328316,247000,181378,-5000,0,-751390,233717,19765,35000,0,1079706,13283,837215.0,1530920.0,-17747.0,-200908.0,0.0,0.0,-328476.0,985192.0,828413.0,4629427.0
2025-01-16,2379,115154,39000,0,766956,356000,82117,25000,0,-177249,71434,33037,14000,0,944205,284566,774468.0,1593935.0,3253.0,-151953.0,0.0,0.0,-1183247.0,450863.0,919791.0,4624725.0
2025-01-17,2379,222617,16200,0,1831192,262000,196577,13200,0,420396,186434,26040,3000,0,1410796,75566,814640.0,1727923.0,-3171.0,-75438.0,0.0,0.0,-697224.0,1031081.0,1048821.0,4710760.0
2025-01-20,2379,46638,7000,0,861100,849000,22868,5944,0,-809531,839434,23770,1056,0,1670631,9566,562837.0,1686026.0,30820.0,-50381.0,0.0,0.0,-1499050.0,-129772.0,1518921.0,5674646.0
2025-01-21,2379,27198,18000,0,727206,530000,16908,18000,0,-262021,514981,10290,0,0,989227,15019,499848.0,1707788.0,57144.0,-45678.0,0.0,0.0,-1579795.0,-1071826.0,1846000.0,6477626.0
2025-01-22,2379,34130,23026,0,1498506,248000,20104,12926,0,379484,154579,14026,10100,0,1119022,93421,338574.0,1745065.0,75070.0,-25752.0,0.0,0.0,-448921.0,-1190643.0,1766862.0,6899205.0
2025-02-03,2379,249963,123000,0,1770344,515205,234487,13284,0,-1108668,514718,15476,109716,0,2879012,487,490944.0,1974229.0,63354.0,-14468.0,0.0,0.0,-1380340.0,-2461723.0,2210146.0,7401923.0
2025-02-04,2379,183415,43079,0,3893949,890000,137135,-13921,0,298001,852717,46280,57000,0,3595948,37283,431502.0,2069582.0,36233.0,-86101.0,0.0,0.0,-1502735.0,-2665722.0,2876429.0,7999263.0
2025-02-05,2379,71397,69621,0,2987885,1256000,2333,36578,0,151617,1234553,69064,33043,0,2836268,21447,410967.0,2055305.0,66867.0,-66623.0,0.0,0.0,-541587.0,-2532619.0,3271548.0,9118822.0
2025-02-06,2379,73000,252000,0,2064660,450600,-140,198650,0,-3515594,414408,73140,53350,0,5580254,36192,393919.0,2025237.0,247517.0,162863.0,0.0,0.0,-3795160.0,-4877678.0,3170975.0,8332621.0
2025-02-07,2379,52398,5000,0,2955467,237000,36384,-30100,0,599859,196087,16014,35100,0,2355608,40913,410199.0,1999533.0,204491.0,167523.0,0.0,0.0,-3574785.0,-1308992.0,3212483.0,5241156.0
2025-02-10,2379,63668,23000,0,2317767,232701,28971,-26349,0,445520,176838,34697,49349,0,1872247,55863,204683.0,1879992.0,164858.0,254881.0,0.0,0.0,-2020597.0,-513901.0,2874603.0,4823485.0
2025-02-11,2379,26090,9000,0,1334479,215000,-2305,-3878,0,299636,138836,28395,12878,0,1034843,76164,65243.0,1791793.0,174901.0,248978.0,0.0,0.0,-2018962.0,-1428276.0,2160722.0,5347321.0
2025-02-12,2379,11249,28000,0,1385597,51000,7715,18560,0,260532,-43234,3534,9440,0,1125065,94234,70625.0,1690595.0,156883.0,248612.0,0.0,0.0,-1910047.0,-1986061.0,882935.0,5507937.0
2025-02-13,2379,19572,30051,0,1692614,32600,-3096,9019,0,-321200,-121969,22668,21032,0,2013814,154569,67669.0,1644426.0,-32748.0,260064.0,0.0,0.0,1284347.0,-2845526.0,346558.0,5732101.0
2025-02-14,2379,34200,8134,0,1566475,116600,16032,-12883,0,-404081,91131,18168,21017,0,1970556,25469,47317.0,1633305.0,-15531.0,246283.0,0.0,0.0,280407.0,-4071775.0,241602.0,6049360.0
2025-02-17,2379,18000,24450,0,867444,126600,7444,11870,0,148235,30184,10556,12580,0,719209,96416,25790.0,1495885.0,22688.0,254153.0,0.0,0.0,-16878.0,-4601062.0,94948.0,6099488.0
2025-02-18,2379,5000,2108,0,536907,101000,-8610,-10767,0,-91977,3812,13610,12875,0,628884,97188,19485.0,1330870.0,15799.0,223762.0,0.0,0.0,-408491.0,-4627412.0,-40076.0,6045896.0
2025-02-19,2379,96077,67343,0,1449179,86000,83069,-44789,0,685179,-277114,13008,112132,0,764000,363114,94839.0,1139268.0,-47550.0,207020.0,0.0,0.0,16156.0,-3934528.0,-273956.0,5399448.0
2025-02-20,2379,73941,160745,0,819464,24000,43697,159645,0,-178420,1509,30244,1100,0,997884,22491,141632.0,1103068.0,103076.0,374989.0,0.0,0.0,158936.0,-3931672.0,-150478.0,5213055.0
2025-02-21,2379,23053,53988,0,1335522,19000,11520,53988,0,436992,1489,11533,0,0,898530,17511,137120.0,933210.0,169947.0,433977.0,0.0,0.0,1000009.0,-2743290.0,-240120.0,4980827.0
2025-02-24,2379,14597,49214,0,1330172,21000,-2394,39914,0,367670,-17956,16991,9300,0,962502,38956,127282.0,848699.0,197991.0,448891.0,0.0,0.0,1219444.0,-2198371.0,-288260.0,4891437.0
2025-02-25,2379,47830,23696,0,1466991,66589,26343,-23404,0,210235,58788,21487,47100,0,1256756,7801,162235.0,678465.0,185354.0,412287.0,0.0,0.0,1521656.0,-2408532.0,-233284.0,4763791.0
2025-02-26,2379,26200,23100,0,2041289,50589,9848,18033,0,748876,10011,16352,5067,0,1292413,40578,89014.0,665445.0,248176.0,424376.0,0.0,0.0,1585353.0,-850125.0,53841.0,3934368.0
2025-02-27,2379,95000,7001,0,1356716,119599,75157,2468,0,34593,99522,19843,4533,0,1322123,20077,120474.0,723694.0,90999.0,408844.0,0.0,0.0,1798366.0,-553511.0,151854.0,3518909.0
2025-03-03,2379,148350,38245,0,1161874,364944,145045,20728,0,-99041,363999,3305,17517,0,1260915,945,253999.0,848635.0,57739.0,416646.0,0.0,0.0,1262333.0,-1032036.0,514364.0,3728329.0
2025-03-04,2379,100126,64071,0,2821413,374589,71051,2442,0,1121715,367428,29075,61629,0,1699698,7161,327444.0,685199.0,20267.0,405804.0,0.0,0.0,2016378.0,1198347.0,899748.0,3581039.0
2025-03-05,2379,20719,5007,0,1754768,34000,-12674,-65300,0,675938,24344,33393,70307,0,1078830,9656,288427.0,535390.0,-21629.0,354425.0,0.0,0.0,2482081.0,1576284.0,865304.0,2752666.0
2025-03-06,2379,31907,10238,0,1135644,60000,22585,-21300,0,1425,-24559,9322,31538,0,1134219,84559,301164.0,555642.0,-60962.0,296547.0,0.0,0.0,1734630.0,1426092.0,830734.0,1493554.0
2025-03-07,2379,48374,3101,0,1249836,53000,5173,-45000,0,365405,-21884,43201,48101,0,884431,74884,231180.0,560955.0,-108430.0,52897.0,0.0,0.0,2065442.0,5307091.0,709328.0,1057262.0
2025-03-10,2379,85588,586,0,742438,542589,74706,-32719,0,-102551,474748,10882,33305,0,844989,67841,160841.0,599277.0,-161877.0,50278.0,0.0,0.0,2061932.0,4604681.0,820077.0,1335923.0
2025-03-11,2379,190444,163159,0,2382215,476766,123750,-80287,0,635591,473497,66694,243446,0,1746624,3269,213540.0,694056.0,-244606.0,-3660.0,0.0,0.0,1575808.0,4794752.0,926146.0,1632582.0
2025-03-12,2379,66547,44166,0,1083810,238000,50266,-18407,0,-249028,233537,16281,62573,0,1332838,4463,276480.0,746627.0,-197713.0,-18189.0,0.0,0.0,650842.0,4246088.0,1135339.0,1727283.0
2025-03-13,2379,99000,11039,0,810347,64000,84975,-2899,0,-493096,57105,14025,13938,0,1303443,6895,338870.0,823887.0,-179312.0,-39648.0,0.0,0.0,156321.0,3492460.0,1217003.0,1827622.0
2025-03-14,2379,98898,8088,0,1385187,370589,49508,-56611,0,-281505,279308,49390,64699,0,1666692,91281,383205.0,876491.0,-190923.0,-105278.0,0.0,0.0,-490589.0,3532155.0,1518195.0,2228899.0
2025-03-17,2379,43666,31000,0,682021,158000,39507,29558,0,-420685,127337,4159,1442,0,1102706,30663,348006.0,899966.0,-128646.0,-62837.0,0.0,0.0,-808723.0,3515551.0,1170784.0,2265105.0
2025-03-18,2379,31291,5611,0,1135969,87000,12856,-19421,0,520108,45723,18435,25032,0,615861,41277,237112.0,905378.0,-67780.0,-94128.0,0.0,0.0,-924206.0,3887424.0,743010.0,2280644.0
2025-03-19,2379,56519,10069,0,680583,267000,-5066,-35051,0,-184657,233446,61585,45120,0,865240,33554,181780.0,908922.0,-84424.0,-118412.0,0.0,0.0,-859835.0,3794744.0,742919.0,2510278.0
2025-03-20,2379,28115,24730,0,1138065,209000,15912,22730,0,840851,20876,12203,2000,0,297214,188124,112717.0,841765.0,-58795.0,-50893.0,0.0,0.0,474112.0,3950416.0,706690.0,2808268.0
2025-03-21,2379,85763,138322,0,1306871,381000,71908,136305,0,248288,64329,13855,2017,0,1058583,316671,135117.0,869976.0,134121.0,-74233.0,0.0,0.0,1003905.0,4377124.0,491711.0,2871088.0
2025-03-24,2379,96872,26604,0,693857,444000,78537,14604,0,-367443,420671,18335,12000,0,1061300,23329,174147.0,936993.0,119167.0,-113617.0,0.0,0.0,1057147.0,3572689.0,785045.0,3290270.0
2025-03-25,2379,80272,1000,0,1216559,438000,63434,-24000,0,-36791,379000,16838,25000,0,1253350,59000,224725.0,1002821.0,114588.0,-177531.0,0.0,0.0,500248.0,3168228.0,1118322.0,3687226.0
2025-03-26,2379,26010,12000,0,766503,413000,17151,7000,0,91492,-101614,8859,5000,0,675011,514614,246942.0,993629.0,156639.0,-147127.0,0.0,0.0,776397.0,3049485.0,783262.0,3526824.0
2025-03-27,2379,139775,2000,0,792162,462000,134361,-5000,0,-942339,461054,5414,7000,0,1734501,946,365391.0,1118142.0,128909.0,-170160.0,0.0,0.0,-1006793.0,1358270.0,1223440.0,3977867.0
2025-03-28,2379,341427,13000,0,1010746,256000,299348,-35000,0,-510033,256000,42079,48000,0,1520779,0,592831.0,1342333.0,-42396.0,-207628.0,0.0,0.0,-1765114.0,813644.0,1415111.0,4134345.0
2025-03-31,2379,559029,83000,0,1222012,577590,506192,-57200,0,-1134166,577258,52837,140200,0,2356178,332,1020486.0,1703480.0,-114200.0,-285556.0,0.0,0.0,-2531837.0,-221481.0,1571698.0,4347604.0
2025-04-01,2379,162452,27000,0,2144555,265000,130000,7684,0,324579,-25000,32452,19316,0,1819976,290000,1087052.0,1762429.0,-82516.0,-280314.0,0.0,0.0,-2170467.0,-1018617.0,1167698.0,3955176.0
2025-04-02,2379,156886,0,0,1796684,49000,134974,-22586,0,768607,-58938,21912,22586,0,1028077,107938,1204875.0,1910077.0,-112102.0,-237600.0,0.0,0.0,-1493352.0,-925948.0,1210374.0,3871894.0
2025-04-07,2379,0,0,0,539245,0,-13898,0,0,458772,0,13898,0,0,80473,0,1056616.0,1873594.0,-107102.0,-216300.0,0.0,0.0,-92241.0,-468601.0,749320.0,3896453.0
2025-04-08,2379,609091,101409,0,2678871,347033,530648,2645,0,-82218,297033,78443,98764,0,2761089,50000,1287916.0,2399069.0,-69457.0,-168655.0,0.0,0.0,335574.0,-916224.0,790353.0,4215370.0
2025-04-09,2379,815646,64000,0,3231057,213938,733206,-33475,0,-313465,209381,82440,97475,0,3544522,4557,1514930.0,3057569.0,-45732.0,-169411.0,0.0,0.0,1156275.0,-1127138.0,422476.0,3950003.0
2025-04-10,2379,14144,0,0,223675,0,14144,0,0,19385,-71000,0,0,0,204290,71000,1399074.0,2947963.0,-53416.0,-89124.0,0.0,0.0,851081.0,-1743344.0,376476.0,3405506.0
2025-04-11,2379,161598,17100,0,1949780,761842,114369,-35669,0,-497048,760842,47229,52769,0,2446828,1000,1378469.0,3012066.0,-66499.0,-106386.0,0.0,0.0,-414574.0,-1991364.0,1196256.0,3932811.0
2025-04-14,2379,56166,36000,0,2561487,82000,27458,3572,0,-190518,56774,28708,32428,0,2752005,25226,1419825.0,2954549.0,-62927.0,-99915.0,0.0,0.0,-1063864.0,-1688786.0,1253030.0,3932480.0
2025-04-15,2379,86737,1000,0,1666421,83800,83986,-20159,0,6724,-190056,2751,21159,0,1659697,273856,973163.0,2989027.0,-85731.0,-63463.0,0.0,0.0,-974922.0,-1400557.0,765941.0,3463116.0
2025-04-16,2379,141000,1000,0,1248717,114000,67117,-48042,0,-152652,-300891,73883,49042,0,1401369,414891,307074.0,3016637.0,-100298.0,-141063.0,0.0,0.0,-814109.0,-1132524.0,255669.0,3034888.0
2025-04-17,2379,101956,4000,0,1668304,42000,91868,-52000,0,310908,23000,10088,56000,0,1357396,19000,384798.0,3095649.0,-152298.0,-173642.0,0.0,0.0,-522586.0,-1341724.0,349669.0,3012165.0
2025-04-18,2379,107414,5000,0,721070,373000,89592,-10255,0,-81,-452790,17822,15255,0,721151,825790,360021.0,3190307.0,-126884.0,-148846.0,0.0,0.0,-25619.0,-1157148.0,-863963.0,2325929.0
2025-04-21,2379,190885,2000,0,454699,353000,144885,-33000,0,-264404,351000,46000,35000,0,719103,2000,477448.0,3319280.0,-163456.0,-204576.0,0.0,0.0,-99505.0,-2262403.0,-569737.0,2656053.0
2025-04-22,2379,268665,20000,0,526577,352000,243195,1100,0,-566721,348000,25470,18900,0,1093298,4000,636657.0,3490567.0,-142197.0,-339781.0,0.0,0.0,-672950.0,-3077412.0,-31681.0,2939724.0
2025-04-23,2379,69914,9500,0,1429261,175000,45914,-13500,0,225388,174392,24000,23000,0,1203873,608,615454.0,3457944.0,-107655.0,-367885.0,0.0,0.0,-294910.0,-2484581.0,443602.0,2693445.0
2025-04-24,2379,54739,1595,0,771969,5000,45698,-4829,0,-312099,-30334,9041,6424,0,1084068,35334,569284.0,3440208.0,-60484.0,-348714.0,0.0,0.0,-917917.0,-2759889.0,390268.0,2284111.0
2025-04-25,2379,43544,3578,0,1343453,15000,9238,-17622,0,-177609,-254840,34306,21200,0,1521062,269840,488930.0,3432295.0,-67851.0,-373336.0,0.0,0.0,-1095445.0,-3028990.0,588218.0,2130885.0
2025-04-28,2379,19405,7600,0,424582,7000,14396,2527,0,-51969,-278724,5009,5073,0,476551,285724,358441.0,3312330.0,-32324.0,-365809.0,0.0,0.0,-883010.0,-2138620.0,-41506.0,1391107.0
2025-04-29,2379,19709,2285,0,946248,4000,-8297,2285,0,-334124,-166243,28006,0,0,1280372,170243,106949.0,3004685.0,-31139.0,-328524.0,0.0,0.0,-650413.0,-1962711.0,-555749.0,968864.0
2025-04-30,2379,3993,0,0,869783,30000,-20563,-34350,0,61300,-187944,24556,34350,0,808483,217944,40472.0,2477930.0,-51989.0,-305674.0,0.0,0.0,-814501.0,-767245.0,-918085.0,203662.0
2025-05-02,2379,99000,4999,0,829312,0,78187,-4330,0,-1415754,-374723,20813,9329,0,2245066,374723,72961.0,2426117.0,-51490.0,-317688.0,0.0,0.0,-1918156.0,-2507578.0,-1262474.0,-146061.0
2025-05-05,2379,21068,4000,0,1468826,9109,-76317,-12562,0,-582438,-286462,97385,16562,0,2051264,295571,-12594.0,2214826.0,-46430.0,-307664.0,0.0,0.0,-2322985.0,-3858623.0,-1294096.0,-373585.0
2025-05-06,2379,7936,1000,0,1074889,16000,-145931,-52081,0,-467039,-276220,153867,53081,0,1541928,292220,-172921.0,2082793.0,-101038.0,-359745.0,0.0,0.0,-2738055.0,-4784434.0,-1291592.0,-649805.0
2025-05-07,2379,1160,0,0,1327761,15000,-43755,-13107,0,-289209,-113599,44915,13107,0,1616970,128599,-208379.0,1508390.0,-116430.0,-375497.0,0.0,0.0,-2693140.0,-4991425.0,-1238948.0,-1060437.0
2025-05-08,2379,6333,5000,0,971936,46000,-8009,2690,0,186341,-92275,14342,2310,0,785595,138275,-195825.0,767175.0,-79390.0,-339332.0,0.0,0.0,-2568099.0,-4491619.0,-1143279.0,-1362093.0
2025-05-09,2379,9462,0,0,1613185,3000,-34508,-6000,0,432807,-191701,43970,6000,0,1180378,194701,-308520.0,718523.0,-81060.0,-345332.0,0.0,0.0,-719538.0,-4078197.0,-960257.0,-1482794.0
2025-05-12,2379,16033,8220,0,627060,0,12290,8220,0,-245861,-142039,3743,0,0,872921,142039,-219913.0,616444.0,-60278.0,-301443.0,0.0,0.0,-382961.0,-3827010.0,-815834.0,-2385675.0
2025-05-13,2379,23060,6000,0,2055874,3000,-6003,-26000,0,433356,-263381,29063,32000,0,1622518,266381,-79985.0,582983.0,-34197.0,-331015.0,0.0,0.0,517434.0,-3203136.0,-802995.0,-2705830.0
2025-05-14,2379,4659,32000,0,1656591,4000,-20479,27931,0,82305,-224000,25138,4069,0,1574286,228000,-56709.0,478518.0,6841.0,-282925.0,0.0,0.0,888948.0,-3127555.0,-913396.0,-2739774.0
2025-05-15,2379,9397,33000,0,1592505,39000,-1644,5000,0,-450841,-525244,11041,28000,0,2043346,564244,-50344.0,409757.0,9151.0,-229883.0,0.0,0.0,251766.0,-3425744.0,-1346365.0,-2964127.0
2025-05-16,2379,25431,11000,0,1164426,9000,17906,8934,0,283656,-904584,7525,2066,0,880770,913584,2070.0,335795.0,24085.0,-168949.0,0.0,0.0,102615.0,-3452996.0,-2059248.0,-3891711.0
2025-05-19,2379,23000,18000,0,816881,33001,-10455,-5732,0,-94295,-114571,33455,23732,0,911176,147572,-20675.0,235748.0,10133.0,-164426.0,0.0,0.0,254181.0,-3547210.0,-2031780.0,-3553492.0
2025-05-20,2379,11612,6000,0,1749071,190000,-7388,-400,0,364417,-83830,19000,6400,0,1384654,273830,-22060.0,83475.0,35733.0,-131826.0,0.0,0.0,185242.0,-2918389.0,-1852229.0,-3988322.0
2025-05-21,2379,46200,2300,0,915655,33000,519,2300,0,465084,-154000,45681,0,0,450571,187000,-1062.0,-159201.0,10102.0,-130626.0,0.0,0.0,568021.0,-1886584.0,-1782229.0,-4490322.0
2025-05-22,2379,23185,2000,0,992704,5000,-27123,-35571,0,151898,-115003,50308,37571,0,840806,120003,-26541.0,-232238.0,-30469.0,-152697.0,0.0,0.0,1170760.0,-1960074.0,-1371988.0,-4779717.0
2025-05-23,2379,29050,2011,0,1348902,0,-14097,-11228,0,-130334,-721282,43147,13239,0,1479236,721282,-58544.0,-292033.0,-50631.0,-159096.0,0.0,0.0,756770.0,-1778309.0,-1188686.0,-5470665.0
2025-05-26,2379,19617,217,0,2032046,24000,-53572,-180065,0,1104758,-965978,73189,180282,0,927288,989978,-101661.0,-354843.0,-224964.0,-321539.0,0.0,0.0,1955823.0,-495942.0,-2040093.0,-6181803.0
2025-05-27,2379,30011,1000,0,1474493,0,-15466,-110030,0,4039,-1053871,45477,111030,0,1470454,1053871,-109739.0,-384705.0,-334594.0,-434096.0,0.0,0.0,1595445.0,-439934.0,-3010134.0,-6956950.0
2025-05-28,2379,35829,1200,0,2813723,28000,13525,-24800,0,1194816,-999000,22304,26000,0,1618907,1027000,-96733.0,-362883.0,-361694.0,-461181.0,0.0,0.0,2325177.0,1089006.0,-3855134.0,-7789707.0
2025-05-29,2379,29248,18200,0,3705883,88033,7175,12200,0,1331132,-1430967,22073,6000,0,2374751,1519000,-62435.0,-335145.0,-313923.0,-414631.0,0.0,0.0,3504411.0,2358838.0,-5171098.0,-9032730.0
2025-06-02,2379,74557,16000,0,1707088,78000,42288,-5175,0,-309237,59421,32269,21175,0,2016325,18579,-6050.0,-371044.0,-307870.0,-415476.0,0.0,0.0,3325508.0,3465355.0,-4390395.0,-8598586.0
2025-06-03,2379,9017,500,0,932074,1733000,-19,-7500,0,-1778262,1730392,9036,8000,0,2710336,2608,47503.0,-294746.0,-135305.0,-410414.0,0.0,0.0,442488.0,2269531.0,-1694025.0,-6581732.0
2025-06-04,2379,14361,11700,0,1110101,773000,-2069,-413,0,-1046598,679173,16430,12113,0,2156699,93827,60900.0,-150884.0,-25688.0,-358746.0,0.0,0.0,-608149.0,1689972.0,39019.0,-5626339.0
2025-06-05,2379,20143,2023,0,1682738,99000,11434,-4477,0,344682,-743752,8709,6500,0,1338056,842752,58809.0,-95695.0,-5365.0,-350116.0,0.0,0.0,-1458283.0,2323863.0,294267.0,-6256492.0
2025-06-06,2379,34925,0,0,944154,208000,24934,0,0,248485,204717,9991,0,0,695669,3283,76568.0,-62752.0,-17565.0,-352806.0,0.0,0.0,-2540930.0,2386007.0,1929951.0,-5959500.0
2025-06-09,2379,19200,4500,0,620143,150000,16200,4500,0,85404,-129728,3000,0,0,534739,279728,50480.0,-12044.0,-7890.0,-342306.0,0.0,0.0,-2146289.0,2038604.0,1740802.0,-5897527.0
2025-06-10,2379,16505,24906,0,937711,0,-9797,14906,0,362156,-229830,26302,10000,0,575555,229830,40702.0,-34131.0,14516.0,-335620.0,0.0,0.0,-5871.0,2646621.0,-219420.0,-5985318.0
2025-06-11,2379,26192,3576,0,840308,35000,12192,-1424,0,332581,-136254,14000,5000,0,507727,171254,54963.0,-15936.0,13505.0,-311044.0,0.0,0.0,1373308.0,2545846.0,-1034847.0,-5858191.0
2025-06-12,2379,15357,910,0,921745,16000,5639,-24090,0,315437,-220759,9718,25000,0,606308,236759,49168.0,10182.0,-6108.0,-363065.0,0.0,0.0,1344063.0,2778978.0,-511854.0,-5854950.0
2025-06-13,2379,12030,1000,0,1222755,0,2635,-43500,0,649010,-283024,9395,44500,0,573745,283024,26869.0,14461.0,-49608.0,-411565.0,0.0,0.0,1744588.0,3878829.0,-999595.0,-5612730.0
2025-06-16,2379,36625,13200,0,1022300,66000,20621,5198,0,362117,-16290,16004,8002,0,660183,82290,31290.0,17176.0,-48910.0,-415301.0,0.0,0.0,2021301.0,3957290.0,-886157.0,-4724436.0
2025-06-17,2379,55684,5225,0,1353572,50000,31684,-21217,0,496602,-113592,24000,26442,0,856970,163592,72771.0,59315.0,-85033.0,-430786.0,0.0,0.0,2155747.0,4548187.0,-769919.0,-4723457.0
2025-06-18,2379,31451,2000,0,1092010,130000,23326,-62222,0,3679,-22676,8125,64222,0,1088331,152676,83905.0,90029.0,-145831.0,-492608.0,0.0,0.0,1826845.0,4187449.0,-656341.0,-4662303.0
2025-06-19,2379,145530,32624,0,3678472,0,102341,17624,0,1311432,-437000,43189,15000,0,2367040,437000,180607.0,191851.0,-104117.0,-477284.0,0.0,0.0,2822840.0,5033797.0,-872582.0,-4945303.0
2025-06-20,2379,97000,17000,0,1635937,201340,41090,-6629,0,-95490,-598324,55910,23629,0,1731427,799664,219062.0,260064.0,-67246.0,-448342.0,0.0,0.0,2078340.0,4786409.0,-1187882.0,-5428624.0
2025-06-23,2379,135313,15000,0,1718809,153000,119323,7688,0,794931,-756312,15990,7312,0,923878,909312,317764.0,393484.0,-64756.0,-429426.0,0.0,0.0,2511154.0,5711674.0,-1927904.0,-5463654.0
2025-06-24,2379,21020,23000,0,1619573,42000,-16980,-357,0,508985,-742908,38000,23357,0,1110588,784908,269100.0,430076.0,-43896.0,-249718.0,0.0,0.0,2523537.0,5115901.0,-2557220.0,-5240584.0
2025-06-25,2379,48166,6000,0,1550420,63000,41470,900,0,960314,-669291,6696,5100,0,590106,732291,287244.0,487012.0,19226.0,-138788.0,0.0,0.0,3480172.0,6072176.0,-3203835.0,-4856004.0
2025-06-26,2379,201917,12000,0,1282260,11000,180503,-16100,0,-69516,-409157,21414,28100,0,1351776,420157,365406.0,653990.0,-14498.0,-130088.0,0.0,0.0,2099224.0,4807844.0,-3175992.0,-4266161.0
2025-06-27,2379,80492,0,0,1051832,27000,52746,-63100,0,504522,-81742,27746,63100,0,547310,108742,377062.0,699561.0,-70969.0,-205388.0,0.0,0.0,2699236.0,3981234.0,-2659410.0,-2916936.0
2025-06-30,2379,40000,5000,0,920870,215,36344,-23000,0,88852,-22677,3656,28000,0,832018,22892,294083.0,693617.0,-101657.0,-223213.0,0.0,0.0,1993157.0,4379323.0,-1925775.0,-2999034.0
2025-07-01,2379,46327,23000,0,814340,431215,29153,19372,0,-170772,286832,17174,3628,0,985112,144383,340216.0,722789.0,-81928.0,-196341.0,0.0,0.0,1313400.0,5986813.0,-896035.0,-4442594.0
2025-07-02,2379,18816,11200,0,1862304,344000,-23194,-5800,0,516260,274000,42010,17000,0,1346044,70000,275552.0,701664.0,-88628.0,-201728.0,0.0,0.0,869346.0,7549671.0,47256.0,-4847767.0
2025-07-03,2379,27214,74300,0,848448,300000,-25911,57883,0,-287415,294527,53125,16417,0,1135863,5473,69138.0,664319.0,-14645.0,-139368.0,0.0,0.0,651447.0,6917574.0,750940.0,-3809488.0
2025-07-04,2379,71055,11828,0,526650,2321000,62413,-43172,0,-1520116,2309090,8642,55000,0,2046766,11910,78805.0,701798.0,5283.0,-182540.0,0.0,0.0,-1373191.0,5148973.0,3141772.0,-1705115.0
2025-07-07,2379,105400,18000,0,387904,449000,90263,-1008,0,-850436,444953,15137,19008,0,1238340,4047,132724.0,775861.0,27275.0,-188048.0,0.0,0.0,-2312479.0,4213133.0,3609402.0,-1130434.0
2025-07-08,2379,81855,7000,0,946065,90086,62761,-11781,0,-213443,39586,19094,18781,0,1159508,50500,166332.0,848419.0,-3878.0,-214735.0,0.0,0.0,-2355150.0,3637534.0,3362156.0,-861018.0
2025-07-09,2379,25408,1185,0,896382,383000,13408,-6815,0,100433,370953,12000,8000,0,795949,12047,202934.0,849635.0,-4893.0,-220126.0,0.0,0.0,-2770977.0,3405386.0,3459109.0,-353811.0
2025-07-10,2379,29142,5999,0,1268878,89000,22142,999,0,211810,-639,7000,5000,0,1057068,89639,250987.0,866138.0,-61777.0,-195037.0,0.0,0.0,-2271752.0,3301759.0,3163943.0,-133691.0
2025-07-11,2379,5056,8000,0,1097267,54000,-1244,-18000,0,-21023,-48639,6300,26000,0,1118290,102639,187330.0,862259.0,-36605.0,-169537.0,0.0,0.0,-772659.0,2631726.0,806214.0,100694.0
2025-07-14,2379,109946,2620,0,929996,58000,107946,-2380,0,-172091,39729,2000,5000,0,1102087,18271,205013.0,949584.0,-37977.0,-177115.0,0.0,0.0,-94314.0,2097518.0,400990.0,156713.0
2025-07-15,2379,53000,6000,0,489737,49000,51669,1855,0,-219246,-35217,1331,4145,0,708983,84217,193921.0,969569.0,-24341.0,-154043.0,0.0,0.0,-100117.0,1381670.0,326187.0,235088.0
2025-07-16,2379,194428,27000,0,588085,808433,171128,23000,0,-685314,648747,23300,4000,0,1273399,159686,351641.0,1117371.0,5474.0,-68821.0,0.0,0.0,-885864.0,692677.0,603981.0,906511.0
2025-07-17,2379,59732,8000,0,422072,473419,43732,8000,0,-460346,408396,16000,0,0,882418,65023,373231.0,1058762.0,12475.0,-78445.0,0.0,0.0,-1558020.0,-1079101.0,1013016.0,1751907.0
2025-07-18,2379,106972,9000,0,796057,442000,99223,8000,0,-269779,409266,7749,1000,0,1065836,32734,473698.0,1116895.0,38475.0,-63816.0,0.0,0.0,-1806776.0,-1253390.0,1470921.0,2759497.0
2025-07-21,2379,75605,4000,0,484584,468000,72119,3639,0,-611137,455752,3486,361,0,1095721,12248,437871.0,1069691.0,44494.0,-67865.0,0.0,0.0,-2245822.0,-2659458.0,1886944.0,3971561.0
2025-07-22,2379,94200,4057,0,1278521,740105,74200,-2943,0,-184579,697035,20000,7000,0,1463100,43070,460402.0,1160871.0,39696.0,-70451.0,0.0,0.0,-2211155.0,-3353022.0,2619196.0,5411504.0
2025-07-23,2379,49000,44000,0,1051014,161000,14382,41691,0,-350258,149000,34618,2309,0,1401272,12000,303656.0,1133783.0,58387.0,-29660.0,0.0,0.0,-1876099.0,-4663594.0,2119449.0,6229795.0
2025-07-24,2379,3000,1000,0,459166,15000,-2251,800,0,-184423,-28140,5251,200,0,643589,43140,257673.0,951029.0,51187.0,-12760.0,0.0,0.0,-1600176.0,-4778501.0,1682913.0,6610812.0
2025-07-25,2379,9246,20000,0,819968,61000,7018,13538,0,489434,-85000,2228,6462,0,330534,146000,165468.0,905301.0,56725.0,63878.0,0.0,0.0,-840963.0,-4793589.0,1188647.0,6607554.0
2025-07-28,2379,2380,1000,0,488204,185000,-4320,1000,0,188554,153360,6700,0,0,299650,31640,89029.0,864637.0,54086.0,87878.0,0.0,0.0,-41272.0,-4693887.0,886255.0,6783591.0
2025-07-29,2379,47289,8000,0,877576,222000,45289,8000,0,131770,165976,2000,0,0,745806,56024,60118.0,880773.0,65029.0,76506.0,0.0,0.0,275077.0,-4391345.0,355196.0,6662735.0
2025-07-30,2379,23062,4000,0,583092,159000,17718,4000,0,-29954,149000,5344,0,0,613046,10000,63454.0,921685.0,27338.0,86306.0,0.0,0.0,595381.0,-4937559.0,355196.0,6537735.0
2025-07-31,2379,5900,14000,0,813973,144000,1709,11000,0,-97028,82976,4191,3000,0,911001,61024,67414.0,949305.0,37538.0,39423.0,0.0,0.0,682776.0,-4747172.0,466312.0,6326184.0
2025-08-01,2379,143624,19000,0,1155279,184000,54428,12355,0,-2031572,47241,89196,6645,0,3186851,136759,114824.0,941320.0,36355.0,94950.0,0.0,0.0,-1838230.0,-5258628.0,598553.0,4064335.0
2025-08-04,2379,42049,6000,0,1610447,195000,-14127,-7151,0,-669546,183000,56176,13151,0,2279993,12000,105017.0,836930.0,28204.0,88807.0,0.0,0.0,-2696330.0,-5077738.0,628193.0,3802382.0
2025-08-05,2379,79863,5000,0,1619720,150000,44980,-10002,0,-738266,-37024,34883,15002,0,2357986,187024,104708.0,819149.0,10202.0,90586.0,0.0,0.0,-3566366.0,-5602561.0,425193.0,3725772.0
2025-08-06,2379,34000,8000,0,1487021,181000,-1685,6758,0,-1503789,-79063,35685,1242,0,2990810,260063,85305.0,804056.0,12960.0,104159.0,0.0,0.0,-5040201.0,-7206783.0,197130.0,3275756.0
2025-08-07,2379,58000,5000,0,1505465,20623,27601,3083,0,-609627,-210777,30399,1917,0,2115092,231400,111197.0,809515.0,5043.0,106243.0,0.0,0.0,-5552800.0,-8028220.0,-96623.0,3065618.0
2025-08-08,2379,36289,4100,0,1169052,0,7772,-2814,0,-786214,-282105,28517,6914,0,1955266,282105,64541.0,818531.0,-10126.0,121429.0,0.0,0.0,-4307442.0,-8793411.0,-425969.0,2832152.0
2025-08-11,2379,25000,24000,0,556490,38000,11534,23887,0,-603661,-69697,13466,113,0,1160151,107697,90202.0,722119.0,20912.0,147696.0,0.0,0.0,-4241557.0,-9224981.0,-678666.0,2722726.0
2025-08-12,2379,78446,12000,0,1883673,43653,54718,7219,0,-1262906,30948,23728,4781,0,3146579,12705,99940.0,725168.0,38133.0,153060.0,0.0,0.0,-4766197.0,-10268641.0,-610694.0,2788891.0
2025-08-13,2379,19376,21100,0,913328,3000,13374,18486,0,-1543407,-5047,6002,2614,0,2456735,8047,114999.0,567414.0,49861.0,148546.0,0.0,0.0,-4805815.0,-11126734.0,-536678.0,2135097.0
2025-08-14,2379,41328,11413,0,2206606,14757,34379,9559,0,-207674,-49519,6949,1854,0,2414280,64276,121777.0,558061.0,56337.0,150105.0,0.0,0.0,-4403862.0,-10874062.0,-375420.0,1677182.0
2025-08-15,2379,22101,8000,0,1005179,77000,-3249,6108,0,-442449,-37276,25350,1892,0,1447628,114276,110756.0,455589.0,65259.0,148213.0,0.0,0.0,-4060097.0,-11046732.0,-130591.0,1230640.0
2025-08-18,2379,41933,36331,0,958628,293210,8011,35526,0,-870274,235826,33922,805,0,1828902,57384,107233.0,391481.0,76898.0,180100.0,0.0,0.0,-4326710.0,-11305869.0,174932.0,1010714.0
2025-08-19,2379,38000,37000,0,1061357,11105,27699,34998,0,-999141,-86895,10301,2002,0,2060498,98000,80214.0,344980.0,104677.0,218041.0,0.0,0.0,-4062945.0,-12120431.0,57089.0,226784.0
2025-08-20,2379,430586,206300,0,1268272,246210,411559,205055,0,-1565485,49710,19027,1245,0,2833757,196500,478399.0,742157.0,291246.0,381405.0,0.0,0.0,-4085023.0,-13335658.0,111846.0,127494.0
2025-08-21,2379,31000,40400,0,776628,196105,29867,40101,0,-964417,129605,1133,299,0,1741045,66500,473887.0,774275.0,321788.0,420706.0,0.0,0.0,-4841766.0,-14115652.0,290970.0,285239.0
2025-08-22,2379,29000,46900,0,682958,61000,27347,45898,0,-737823,-32024,1653,1002,0,1420781,93024,504483.0,794604.0,361578.0,453066.0,0.0,0.0,-5137140.0,-15342909.0,296222.0,338215.0
2025-08-25,2379,13088,2605,0,391693,145234,7880,2305,0,-330059,136187,5208,300,0,721752,9047,504352.0,806804.0,328357.0,454371.0,0.0,0.0,-4596925.0,-15861522.0,196583.0,321042.0
2025-08-26,2379,50474,39660,0,2666129,73021,49473,36560,0,81866,-979,1001,3100,0,2584263,74000,526126.0,810988.0,329919.0,482931.0,0.0,0.0,-3515918.0,-15911426.0,282499.0,154087.0
2025-08-27,2379,6675,118500,0,445160,0,-12407,118400,0,-847098,-118000,19082,100,0,1292258,118000,102160.0,780863.0,243264.0,597331.0,0.0,0.0,-2797531.0,-16728570.0,114789.0,-112913.0
2025-08-28,2379,25200,360100,0,500552,2000,23390,353600,0,-1131972,-118047,1810,6500,0,1632524,120047,95683.0,802544.0,556763.0,939931.0,0.0,0.0,-2965086.0,-17763514.0,-132863.0,-313936.0
2025-08-29,2379,25000,193174,0,840177,7000,12159,189763,0,-907773,-39000,12841,3411,0,1747950,46000,80495.0,760275.0,700628.0,1117339.0,0.0,0.0,-3135036.0,-16639715.0,-139839.0,-400177.0
2025-09-01,2379,29703,34300,0,563813,509115,19389,29200,0,-991171,423815,10314,5100,0,1554984,85300,92004.0,793791.0,727523.0,1153690.0,0.0,0.0,-3796148.0,-16961340.0,147789.0,-159362.0
2025-09-02,2379,27772,58400,0,450445,69000,24772,56400,0,-835483,10000,3000,2000,0,1285928,59000,67303.0,773583.0,747363.0,1220092.0,0.0,0.0,-4713497.0,-17058557.0,158768.0,-112338.0
2025-09-03,2379,14000,49000,0,565872,39000,8034,48000,0,-233974,14000,5966,1000,0,799846,25000,87744.0,783302.0,676963.0,1261334.0,0.0,0.0,-4100373.0,-15788742.0,290768.0,-19275.0
2025-09-04,2379,19000,54000,0,1111116,0,2178,51000,0,-1205158,-181024,16822,3000,0,2316274,181024,66532.0,757879.0,374363.0,1309251.0,0.0,0.0,-4173559.0,-16384273.0,227791.0,10478.0
2025-09-05,2379,8300,11200,0,584290,0,-2454,10800,0,-1262575,-63024,10754,400,0,1846865,63024,51919.0,747653.0,195400.0,1322865.0,0.0,0.0,-4528361.0,-16860634.0,203767.0,229559.0
2025-09-08,2379,203585,5000,0,745695,0,141366,-48323,0,-1512305,-99696,62219,53323,0,2258000,99696,173896.0,877485.0,117877.0,1250655.0,0.0,0.0,-5049495.0,-17769278.0,-319744.0,199560.0
2025-09-09,2379,13807,35000,0,1183898,8000,-109475,9481,0,-891926,-18947,123282,25519,0,2075824,26947,39649.0,713292.0,70958.0,1252917.0,0.0,0.0,-5105938.0,-17398298.0,-348691.0,149665.0
2025-09-10,2379,87000,14000,0,5031781,0,-157516,-370027,0,3294549,-770618,244516,384027,0,1737232,770618,-125901.0,542402.0,-347069.0,864404.0,0.0,0.0,-1577415.0,-12560342.0,-1133309.0,-615906.0
2025-09-11,2379,40760,12000,0,2966514,0,-63799,-122000,0,1363693,-337949,104559,134000,0,1602821,337949,-191878.0,444224.0,-520069.0,732845.0,0.0,0.0,991436.0,-10988975.0,-1290234.0,-904336.0
2025-09-12,2379,61001,10000,0,889587,0,-17463,-28000,0,-631132,-97547,78464,38000,0,1520719,97547,-206887.0,430010.0,-558869.0,698737.0,0.0,0.0,1622879.0,-11177658.0,-1324757.0,-964607.0
2025-09-15,2379,6000,9000,0,659309,3000,-24731,5001,0,-342751,-53631,30731,3999,0,1002060,56631,-372984.0,397268.0,-505545.0,668212.0,0.0,0.0,2792433.0,-10650135.0,-1278692.0,-1254064.0
2025-09-16,2379,52752,13223,0,2430591,79004,5752,3223,0,997626,18504,47000,10000,0,1432965,60500,-257757.0,375321.0,-511803.0,636437.0,0.0,0.0,4681985.0,-8653368.0,-1241241.0,-1148665.0
2025-09-17,2379,4481,5000,0,1102351,91000,-22702,-39200,0,36701,-15826,27183,44200,0,1065650,106826,-122943.0,-58940.0,-180976.0,392182.0,0.0,0.0,1424137.0,-7051182.0,-486449.0,-1214201.0
2025-09-18,2379,2274,9000,0,1201191,71000,-46879,9000,0,496946,-337000,49153,0,0,704245,408000,-106023.0,-135686.0,-49976.0,361081.0,0.0,0.0,557390.0,-5589819.0,-485500.0,-1680806.0
2025-09-19,2379,11136,6500,0,1897910,1320,-22864,6500,0,606877,-463145,34000,0,0,1291033,464465,-111424.0,-185897.0,-15476.0,321683.0,0.0,0.0,1795399.0,-4245119.0,-851098.0,-2111927.0
2024-09-23,2383,36000,57491,0,603120,7000,-5511,45982,0,-136970,-158000,41511,11509,0,740090,165000,-5511.0,-5511.0,45982.0,45982.0,0.0,0.0,-136970.0,-136970.0,-158000.0,-158000.0
2024-09-24,2383,84000,158001,0,1538101,202000,9997,89128,0,-307905,-218000,74003,68873,0,1846006,420000,4486.0,4486.0,135110.0,135110.0,0.0,0.0,-444875.0,-444875.0,-376000.0,-376000.0
2024-09-25,2383,139728,171863,0,2679258,1000,116628,50779,0,1294225,-470625,23100,121084,0,1385033,471625,121114.0,121114.0,185889.0,185889.0,0.0,0.0,849350.0,849350.0,-846625.0,-846625.0
2024-09-26,2383,67245,152855,0,2066585,4000,-3875,22060,0,-858615,-378892,71120,130795,0,2925200,382892,117239.0,117239.0,207949.0,207949.0,0.0,0.0,-9265.0,-9265.0,-1225517.0,-1225517.0
2024-09-27,2383,12955,87411,0,1046504,22000,-50756,-15605,0,-447908,-9502,63711,103016,0,1494412,31502,66483.0,66483.0,192344.0,192344.0,0.0,0.0,-457173.0,-457173.0,-1235019.0,-1235019.0
2024-09-30,2383,117500,49000,0,945138,0,-58872,-251127,0,-892053,-624000,176372,300127,0,1837191,624000,13122.0,7611.0,-104765.0,-58783.0,0.0,0.0,-1212256.0,-1349226.0,-1701019.0,-1859019.0
2024-10-01,2383,107223,171204,0,2939611,210000,66163,-129626,0,1327608,-716625,41060,300830,0,1612003,926625,69288.0,73774.0,-323519.0,-188409.0,0.0,0.0,423257.0,-21618.0,-2199644.0,-2575644.0
2024-10-04,2383,366782,417744,0,3208358,16000,124566,189433,0,-2690798,-1849625,242216,228311,0,5899156,1865625,77226.0,198340.0,-184865.0,1024.0,0.0,0.0,-3561766.0,-2712416.0,-3578644.0,-4425269.0
2024-10-07,2383,173297,72898,0,3072115,471000,149576,-36102,0,901715,382000,23721,109000,0,2170400,89000,230677.0,347916.0,-243027.0,-35078.0,0.0,0.0,-1801436.0,-1810701.0,-2817752.0,-4043269.0
2024-10-08,2383,150292,20000,0,1707000,1000,83116,-57813,0,-304082,-353000,67176,77813,0,2011082,354000,364549.0,431032.0,-285235.0,-92891.0,0.0,0.0,-1657610.0,-2114783.0,-3161250.0,-4396269.0
2024-10-09,2383,183380,94000,0,1613168,2000,-6124,-92941,0,-485892,-1390000,189504,186941,0,2099060,1392000,417297.0,424908.0,-127049.0,-185832.0,0.0,0.0,-1251449.0,-2600675.0,-3927250.0,-5786269.0
2024-10-11,2383,178182,134000,0,2005545,625,117366,98050,0,-16257,-736375,60816,35950,0,2021802,737000,468500.0,542274.0,100627.0,-87782.0,0.0,0.0,-2595314.0,-2616932.0,-3947000.0,-6522644.0
2024-10-14,2383,101674,76000,0,1519656,6000,80227,4389,0,-824244,-423000,21447,71611,0,2343900,429000,424161.0,622501.0,-84417.0,-83393.0,0.0,0.0,-728760.0,-3441176.0,-2520375.0,-6945644.0
2024-10-15,2383,102330,195000,0,1518406,0,40758,170923,0,-298287,-1508000,61572,24077,0,1816693,1508000,315343.0,663259.0,122608.0,87530.0,0.0,0.0,-1928762.0,-3739463.0,-4410375.0,-8453644.0
2024-10-16,2383,233073,195000,0,1802945,28000,61261,-37005,0,127245,-416000,171812,232005,0,1675700,444000,293488.0,724520.0,143416.0,50525.0,0.0,0.0,-1497435.0,-3612218.0,-4473375.0,-8869644.0
2024-10-17,2383,151446,35000,0,3831015,0,140306,-671,0,1112515,-248000,11140,35671,0,2718500,248000,439918.0,864826.0,235686.0,49854.0,0.0,0.0,100972.0,-2499703.0,-3331375.0,-9117644.0
2024-10-18,2383,113200,84000,0,2133251,8000,-12142,7749,0,-1902349,-8000,125342,76251,0,4035600,16000,310410.0,852684.0,145385.0,57603.0,0.0,0.0,-1785120.0,-4402052.0,-2603000.0,-9125644.0
2024-10-21,2383,51104,49000,0,2646000,499000,22518,-24844,0,753300,199000,28586,73844,0,1892700,300000,252701.0,875202.0,116152.0,32759.0,0.0,0.0,-207576.0,-3648752.0,-1981000.0,-8926644.0
2024-10-22,2383,68572,82000,0,2348515,663000,46082,74500,0,433515,636000,22490,7500,0,1915000,27000,258025.0,921284.0,19729.0,107259.0,0.0,0.0,524226.0,-3215237.0,163000.0,-8290644.0
2024-10-23,2383,120949,120181,0,3506485,280000,48574,-21853,0,1215079,244000,72375,142034,0,2291406,36000,245338.0,969858.0,34881.0,85406.0,0.0,0.0,1612060.0,-2000158.0,823000.0,-8046644.0
2024-10-24,2383,97000,24000,0,1089129,580406,-55866,-144147,0,-3831871,380406,152866,168147,0,4921000,200000,49166.0,919503.0,-108595.0,-104723.0,0.0,0.0,-3332326.0,-5695059.0,1451406.0,-7508238.0
2024-10-25,2383,26000,55000,0,781129,406,-19029,10000,0,118002,-146594,45029,45000,0,663127,147000,42279.0,890477.0,-106344.0,-183851.0,0.0,0.0,-1311975.0,-5269152.0,1312812.0,-7436832.0
2024-10-28,2383,40000,63000,0,797948,120811,28173,-26508,0,-705562,69811,11827,89508,0,1503510,51000,47934.0,802022.0,-108008.0,-261138.0,0.0,0.0,-2770837.0,-7268939.0,1183623.0,-6896396.0
2024-10-29,2383,158000,80000,0,652190,19842,41271,-61832,0,-1514375,-40158,116729,141832,0,2166565,60000,43123.0,847168.0,-244340.0,-345030.0,0.0,0.0,-4718727.0,-7924699.0,507465.0,-6557662.0
2024-10-30,2383,62642,32000,0,918225,22000,27696,14153,0,-901279,17000,34946,17847,0,1819504,5000,22245.0,925620.0,-208334.0,-315272.0,0.0,0.0,-6835085.0,-8378070.0,280465.0,-6531160.0
2024-11-01,2383,181890,88000,0,3011907,31657,107070,-66651,0,-619000,-343,74820,154651,0,3630907,32000,185181.0,1091562.0,-130838.0,-130796.0,0.0,0.0,-3622214.0,-8105017.0,-100284.0,-5907503.0
2024-11-04,2383,40414,9000,0,988000,40653,-55961,-4000,0,-367032,4353,96375,13000,0,1355032,36300,148249.0,969438.0,-144838.0,-5170.0,0.0,0.0,-4107248.0,-9799657.0,50663.0,-5186525.0
2024-11-05,2383,26494,13064,0,745509,0,-68498,-37936,0,-814491,-4000,94992,51000,0,1560000,4000,51578.0,776374.0,-156266.0,-232539.0,0.0,0.0,-4216177.0,-7923350.0,-23148.0,-3340900.0
2024-11-06,2383,88438,87133,0,1429698,15000,36915,37133,0,-186302,15000,51523,50000,0,1616000,0,47222.0,663713.0,-57301.0,-159304.0,0.0,0.0,-2888104.0,-9011367.0,32010.0,-3707900.0
2024-11-07,2383,34710,19178,0,1179857,2282,-69300,-105022,0,-125801,-114718,104010,124200,0,1305658,117000,-49774.0,511297.0,-176476.0,-206513.0,0.0,0.0,-2112626.0,-8833086.0,-99708.0,-3469618.0
2024-11-08,2383,9917,14000,0,821918,0,-47685,-606000,0,-203528,-30000,57602,620000,0,1025446,30000,-204529.0,469736.0,-715825.0,-719572.0,0.0,0.0,-1697154.0,-8550722.0,-129365.0,-2109618.0
2024-11-11,2383,56556,11567,0,1019000,0,34556,-6433,0,-178172,0,22000,18000,0,1197172,0,-114012.0,386926.0,-718258.0,-824055.0,0.0,0.0,-1508294.0,-8712637.0,-133718.0,-1373243.0
2024-11-12,2383,156416,14274,0,872510,52251,68416,-24726,0,-809668,48251,88000,39000,0,1682178,4000,22902.0,375115.0,-705048.0,-853170.0,0.0,0.0,-1503471.0,-8698061.0,-81467.0,-901992.0
2024-11-13,2383,160684,113695,0,1798600,35684,85684,69695,0,1279600,35684,75000,44000,0,519000,0,71671.0,420041.0,-672486.0,-954398.0,0.0,0.0,-37569.0,-7120174.0,-60783.0,641692.0
2024-11-14,2383,136843,63667,0,1457041,14251,43843,-43849,0,302033,-33749,93000,107516,0,1155008,48000,184814.0,402623.0,-611313.0,-961242.0,0.0,0.0,390265.0,-6945386.0,20186.0,1023943.0
2024-11-15,2383,182248,270889,0,2127000,80716,132346,213889,0,-58177,80716,49902,57000,0,2185177,0,364845.0,394663.0,208576.0,-746682.0,0.0,0.0,535616.0,-8116078.0,130902.0,1352659.0
2024-11-18,2383,118991,59269,0,1293398,42436,44195,-26893,0,-1968615,-23564,74796,86162,0,3262013,66000,374484.0,451000.0,188116.0,-781324.0,0.0,0.0,-1254827.0,-8182344.0,107338.0,1337095.0
2024-11-19,2383,82804,65407,0,1831000,215750,80520,43407,0,-464651,117993,2284,22000,0,2295651,97757,386588.0,509002.0,256249.0,-713073.0,0.0,0.0,-909810.0,-9400295.0,177080.0,1256088.0
2024-11-20,2383,187160,148062,0,3583136,31000,134603,14062,0,1998570,-12000,52557,134000,0,1584566,43000,435507.0,597523.0,200616.0,-773511.0,0.0,0.0,-190840.0,-7835240.0,129396.0,608088.0
2024-11-21,2383,406628,342333,0,6071100,1177396,159628,193333,0,3135880,1134396,247000,149000,0,2935220,43000,551292.0,708577.0,437798.0,-558325.0,0.0,0.0,2643007.0,-5914439.0,1297541.0,1498484.0
2024-11-22,2383,148769,293319,0,4523099,1289000,-422723,174319,0,1304384,1289000,571492,119000,0,3218715,0,-3777.0,341720.0,398228.0,-239859.0,0.0,0.0,4005568.0,-778184.0,2505825.0,2407078.0
2024-11-25,2383,40071,164523,0,2696572,681625,-48091,110523,0,-1429601,452625,88162,54000,0,4126173,229000,-96063.0,312658.0,535644.0,-139336.0,0.0,0.0,4544582.0,-2325787.0,2982014.0,3006297.0
2024-11-26,2383,76104,22271,0,2824215,35000,19542,-82378,0,-122091,-394000,56562,104649,0,2946306,429000,-157041.0,304027.0,409859.0,-195206.0,0.0,0.0,4887142.0,-1742316.0,2470021.0,2542486.0
2024-11-27,2383,180555,45975,0,3156432,44000,96554,-21025,0,1150138,-49000,84001,67000,0,2006294,93000,-195090.0,359310.0,374772.0,-154399.0,0.0,0.0,4038710.0,922197.0,2433021.0,2533644.0
2024-11-28,2383,143866,56352,0,2739005,23667,76446,-72648,0,926905,-446333,67420,129000,0,1812100,470000,-278272.0,408060.0,108791.0,-241200.0,0.0,0.0,1829735.0,2750381.0,852292.0,2070311.0
2024-11-29,2383,104859,113121,0,1865125,20000,44854,47821,0,-105802,17000,60005,65300,0,1970927,3000,189305.0,345844.0,-17707.0,-126728.0,0.0,0.0,419549.0,3263579.0,-419708.0,2087654.0
2024-12-02,2383,266690,220334,0,7035650,411625,67490,134334,0,4718007,322625,199200,86000,0,2317643,89000,304886.0,469295.0,6104.0,11606.0,0.0,0.0,6567157.0,8348618.0,-549708.0,2405926.0
2024-12-03,2383,171544,135300,0,3431824,70000,35344,19170,0,1179707,-499000,136200,116130,0,2252117,569000,320688.0,573137.0,107652.0,68712.0,0.0,0.0,7868955.0,10342816.0,-654708.0,1910926.0
2024-12-04,2383,249973,149948,0,5975800,665000,82473,35948,0,3352555,536000,167500,114000,0,2623245,129000,306607.0,618695.0,164625.0,67527.0,0.0,0.0,10071372.0,13881673.0,-69708.0,2431926.0
2024-12-05,2383,68697,97730,0,2602423,786000,-76854,32243,0,32413,450375,145551,65487,0,2570010,335625,153307.0,611141.0,269516.0,204792.0,0.0,0.0,9176880.0,14039887.0,827000.0,2997019.0
2024-12-06,2383,68705,192363,0,3419065,1318000,39336,68966,0,869353,1268375,29369,123397,0,2549712,49625,147789.0,698162.0,290661.0,879758.0,0.0,0.0,10152035.0,15112768.0,2078375.0,4295394.0
2024-12-09,2383,152611,279040,0,2467986,138000,35024,194924,0,288769,93000,117587,84116,0,2179217,45000,115323.0,698630.0,351251.0,1081115.0,0.0,0.0,5722797.0,15579709.0,1848750.0,4388394.0
2024-12-10,2383,72216,37400,0,2442460,834000,-7737,-29742,0,886460,685958,79953,67142,0,1556000,148042,72242.0,622477.0,302339.0,1076099.0,0.0,0.0,5429550.0,17275837.0,3033708.0,5026101.0
2024-12-11,2383,170111,288042,0,4119809,908000,92974,101016,0,1013589,716375,77137,187026,0,3106220,191625,82743.0,629767.0,367407.0,1107420.0,0.0,0.0,3090584.0,17009826.0,3214083.0,5706792.0
2024-12-12,2383,46439,120380,0,2514178,757000,-70598,15988,0,777868,596000,117037,104392,0,1736310,161000,88999.0,515326.0,351152.0,1167257.0,0.0,0.0,3836039.0,17485661.0,3359708.0,6336541.0
2024-12-13,2383,184982,135573,0,5051473,509500,116758,-116318,0,2428162,462500,68224,251891,0,2623311,47000,166421.0,499738.0,165868.0,837050.0,0.0,0.0,5394848.0,19972000.0,2553833.0,6718325.0
2024-12-16,2383,158897,167014,0,3960401,367000,16805,-58310,0,1101089,325006,142092,225324,0,2859312,41994,148202.0,472348.0,-87366.0,805633.0,0.0,0.0,6207168.0,23041704.0,2785839.0,7066895.0
2024-12-17,2383,169030,437645,0,4186397,182181,-6195,357232,0,1330473,-531008,175225,80413,0,2855924,713189,149744.0,385633.0,299608.0,1119458.0,0.0,0.0,6651181.0,24836828.0,1568873.0,6417894.0
2024-12-18,2383,142154,173692,0,3533398,191425,82491,-120904,0,1539398,-28905,59663,294596,0,1994000,220330,139261.0,333521.0,77688.0,984492.0,0.0,0.0,7176990.0,24377656.0,823593.0,6400989.0
2024-12-19,2383,156735,38218,0,2237563,219000,121786,-64922,0,633438,78000,34949,103140,0,1604125,141000,331645.0,295679.0,-3222.0,726237.0,0.0,0.0,7032560.0,21875214.0,305593.0,5344593.0
2024-12-20,2383,85009,136589,0,4206681,182000,-16189,-72566,0,2222201,-1067165,101198,209155,0,1984480,1249165,198698.0,702213.0,40530.0,479352.0,0.0,0.0,6826599.0,22793031.0,-1224072.0,2988428.0
2024-12-23,2383,70560,122825,0,3477345,82000,5605,4138,0,2082245,-1031000,64955,118687,0,1395100,1113000,187498.0,755909.0,102978.0,372967.0,0.0,0.0,7807755.0,26304877.0,-2580078.0,1504803.0
2024-12-24,2383,37824,64987,0,2126314,38000,-35541,9590,0,1223648,-1179000,73365,55397,0,902666,1217000,158152.0,700826.0,-244664.0,464935.0,0.0,0.0,7700930.0,27650616.0,-3228070.0,719803.0
2024-12-25,2383,77460,206531,0,3097293,23000,68784,116253,0,2040553,-1127000,8676,90278,0,1056740,1150000,144445.0,673056.0,-7507.0,602213.0,0.0,0.0,8202085.0,28541031.0,-4326165.0,-358197.0
2024-12-26,2383,64352,61432,0,2688732,123000,37433,-136072,0,1554732,-894137,26919,197504,0,1134000,1017137,60092.0,634043.0,-78657.0,538789.0,0.0,0.0,9123379.0,29168858.0,-5298302.0,-806001.0
2024-12-27,2383,140485,146601,0,2006474,942000,88377,43501,0,84581,919000,52108,103100,0,1921893,23000,164658.0,677566.0,37410.0,534469.0,0.0,0.0,6985759.0,29359241.0,-3312137.0,95999.0
2024-12-30,2383,63335,54155,0,1290464,298000,-50245,-28810,0,-156183,273442,113580,82965,0,1446647,24558,108808.0,559831.0,4462.0,371325.0,0.0,0.0,4747331.0,24485051.0,-2007695.0,46816.0
2024-12-31,2383,61050,70448,0,1101196,130000,13380,-7953,0,-66820,-121742,47670,78401,0,1168016,251742,157729.0,537867.0,-13081.0,344202.0,0.0,0.0,3456863.0,23238524.0,-950437.0,424074.0
2025-01-02,2383,153301,286104,0,2575964,0,105239,170189,0,1098242,-1112331,48062,115915,0,1477722,1112331,194184.0,560633.0,40855.0,478443.0,0.0,0.0,2514552.0,20984211.0,-935768.0,-1224257.0
2025-01-03,2383,116691,259700,0,3144182,73000,110185,183250,0,2363999,-692000,6506,76450,0,780183,765000,266936.0,747672.0,360177.0,629450.0,0.0,0.0,3323819.0,23315797.0,-733631.0,-2366632.0
2025-01-06,2383,158804,356850,0,2320940,79000,142803,322850,0,549745,-88000,16001,34000,0,1771195,167000,321362.0,851139.0,639526.0,883334.0,0.0,0.0,3788983.0,22996189.0,-1740631.0,-3723007.0
2025-01-07,2383,59490,175774,0,1560105,115000,-21509,85113,0,-524895,-238000,80999,90661,0,2085000,353000,350098.0,794606.0,753449.0,773523.0,0.0,0.0,3420271.0,22182525.0,-2252073.0,-4054007.0
2025-01-08,2383,94146,101200,0,3065954,14000,34167,-26027,0,720770,6437,59979,127227,0,2345184,7563,370885.0,836510.0,735375.0,777238.0,0.0,0.0,4207861.0,22016835.0,-2123894.0,-4733528.0
2025-01-09,2383,127422,68465,0,1973020,93,47630,-177815,0,1023514,-111072,79792,246280,0,949506,111165,313276.0,791166.0,387371.0,498407.0,0.0,0.0,4133133.0,22026760.0,-1122635.0,-5560975.0
2025-01-10,2383,138001,160405,0,2516992,151000,101632,-12539,0,1434806,64000,36369,172944,0,1082186,87000,304723.0,963396.0,191582.0,469880.0,0.0,0.0,3203940.0,22683698.0,-366635.0,-6092975.0
2025-01-13,2383,223470,243342,0,3011030,0,172659,23095,0,1463445,-243000,50811,220247,0,1547585,243000,334579.0,1019297.0,-108173.0,609293.0,0.0,0.0,4117640.0,21718981.0,-521635.0,-6798475.0
2025-01-14,2383,91332,125781,0,2170740,431000,55678,88634,0,262738,-75000,35654,37147,0,1908002,506000,411766.0,1058170.0,-104652.0,756237.0,0.0,0.0,4905273.0,20880630.0,-358635.0,-7198481.0
2025-01-15,2383,195401,219050,0,3297062,773000,87715,-116295,0,282245,773000,107686,335345,0,3014817,0,465314.0,1152080.0,-194920.0,282710.0,0.0,0.0,4466748.0,19832402.0,407928.0,-5894473.0
2025-01-16,2383,84919,195353,0,4507081,651000,65132,147235,0,615811,493000,19787,48118,0,3891270,158000,482816.0,1134721.0,130130.0,550849.0,0.0,0.0,4059045.0,18908815.0,1012000.0,-5372568.0
2025-01-17,2383,197982,122200,0,2548843,509000,182645,23896,0,460181,215000,15337,98304,0,2088662,294000,563829.0,1195580.0,166565.0,639667.0,0.0,0.0,3084420.0,18735558.0,1163000.0,-5235568.0
2025-01-20,2383,35245,63001,0,1299715,315000,-2750,-36670,0,108640,315000,37995,99671,0,1191075,0,388420.0,1209019.0,106800.0,675563.0,0.0,0.0,1729615.0,16621997.0,1721000.0,-3853403.0
2025-01-21,2383,51041,91066,0,2573172,758000,32229,49900,0,284778,749848,18812,41166,0,2288394,8152,364971.0,1235643.0,68066.0,721325.0,0.0,0.0,1751655.0,14824530.0,2545848.0,-2072555.0
2025-01-22,2383,24699,130569,0,3533849,354000,-3599,108069,0,1976556,315000,28298,22500,0,1557293,39000,273657.0,1267585.0,292430.0,819804.0,0.0,0.0,3445966.0,15577438.0,2087848.0,-578555.0
2025-02-03,2383,80583,324000,0,1622802,313795,43292,193723,0,-2290173,-205205,37291,130277,0,3912975,519000,251817.0,1242093.0,338918.0,897274.0,0.0,0.0,539982.0,11246712.0,1389643.0,343240.0
2025-02-04,2383,232716,315041,0,3478475,14000,178855,2415,0,-442059,-1245500,53861,312626,0,3920534,1259500,248027.0,1383515.0,317437.0,1035761.0,0.0,0.0,-362258.0,9249921.0,-70857.0,-8123.0
2025-02-05,2383,105847,178408,0,2984489,436000,88168,-49095,0,261414,436000,17679,227503,0,2723075,0,338945.0,1383306.0,305012.0,943165.0,0.0,0.0,-209484.0,9426754.0,50143.0,-491123.0
2025-02-06,2383,84070,213251,0,4642606,259397,-19494,-15724,0,951449,152397,103564,228975,0,3691157,107000,287222.0,1414057.0,239388.0,956251.0,0.0,0.0,457187.0,10534386.0,-547308.0,-612168.0
2025-02-07,2383,71456,326251,0,2008517,372000,-10514,165399,0,-70095,182000,81970,160852,0,2078612,190000,280307.0,1390163.0,296718.0,1129603.0,0.0,0.0,-1589464.0,10531111.0,-680308.0,-308426.0
2025-02-10,2383,21800,66277,0,1112000,237795,-26563,11701,0,130124,90795,48363,54576,0,981876,147000,210452.0,1258361.0,114696.0,971115.0,0.0,0.0,830833.0,9562993.0,-384308.0,894700.0
2025-02-11,2383,36413,131189,0,1267612,42000,-2000,80148,0,75729,31000,38413,51041,0,1191883,11000,29597.0,1146176.0,192429.0,868013.0,0.0,0.0,1348621.0,7274723.0,892192.0,1617700.0
2025-02-12,2383,20152,146100,0,1520307,5000,-37701,-29211,0,-765480,-56000,57853,175311,0,2285787,61000,-96272.0,965672.0,212313.0,515952.0,0.0,0.0,321727.0,5959498.0,400192.0,1649700.0
2025-02-13,2383,17481,31177,0,1165770,34397,11720,-13072,0,57427,3397,5761,44249,0,1108343,31000,-65058.0,998901.0,214965.0,417767.0,0.0,0.0,-572295.0,6541820.0,251192.0,1891097.0
2025-02-14,2383,4104,42200,0,1023942,4397,-15637,-101052,0,-266783,4397,19741,143252,0,1290725,0,-70181.0,949097.0,-51486.0,342742.0,0.0,0.0,-768983.0,5554267.0,73589.0,1889057.0
2025-02-17,2383,23162,92334,0,1087188,60397,2957,-65513,0,-319812,48397,20205,157847,0,1407000,12000,-40661.0,904424.0,-128700.0,455044.0,0.0,0.0,-1218919.0,4210941.0,31191.0,2048526.0
2025-02-18,2383,96670,82526,0,3048219,11000,75420,25426,0,1338709,-8109,21250,57100,0,1709510,19109,36759.0,878212.0,-183422.0,493009.0,0.0,0.0,44061.0,4114844.0,-7918.0,1976417.0
2025-02-19,2383,30298,183974,0,1541027,37000,-43244,-256026,0,217741,-6000,73542,440000,0,1323286,43000,31216.0,662309.0,-410237.0,213888.0,0.0,0.0,1027282.0,2869140.0,42082.0,2213417.0
2025-02-20,2383,18000,91999,0,1591993,41000,-20634,41784,0,-604002,-57165,38634,50215,0,2195995,98165,-1138.0,585997.0,-355381.0,167038.0,0.0,0.0,365853.0,2002400.0,-18480.0,2231252.0
2025-02-21,2383,11318,42000,0,790935,2000,-4526,-151897,0,-199736,-65000,15844,193897,0,990671,67000,9973.0,493756.0,-406226.0,131436.0,0.0,0.0,432900.0,1520419.0,-87877.0,1393252.0
2025-02-24,2383,62807,95130,0,2392627,6000,21273,-140270,0,-1147343,-96000,41534,235400,0,3539970,102000,28289.0,449897.0,-480983.0,-156069.0,0.0,0.0,-394631.0,-242735.0,-232274.0,804252.0
2025-02-25,2383,60388,125150,0,1852525,8390,2651,-280696,0,-1361786,-762610,57737,405846,0,3214311,771000,-44480.0,269903.0,-787105.0,-460661.0,0.0,0.0,-3095126.0,-2064702.0,-986775.0,-173358.0
2025-02-26,2383,269021,276456,0,8130158,1143390,124304,-50544,0,3654968,737390,144717,327000,0,4475190,406000,123068.0,396957.0,-581623.0,-474535.0,0.0,0.0,342101.0,1481626.0,-243385.0,249032.0
2025-02-27,2383,129654,446279,0,28112572,965662,19207,349425,0,-627568,957662,110447,96854,0,28740140,8000,162909.0,383935.0,-273982.0,-175010.0,0.0,0.0,318535.0,569280.0,771442.0,456846.0
2025-03-03,2383,64186,51200,0,4482090,455949,37945,-69782,0,-335215,455949,26241,120982,0,4817305,0,205380.0,425479.0,-191867.0,-352861.0,0.0,0.0,183056.0,-1742491.0,1292391.0,597795.0
2025-03-04,2383,113414,256620,0,2297271,225390,43461,146450,0,-1818175,206219,69953,110170,0,4115446,19171,227568.0,425648.0,94853.0,-400134.0,0.0,0.0,-487776.0,-1270493.0,1594610.0,1009219.0
2025-03-05,2383,44448,125300,0,1167854,42000,29336,32769,0,-123033,-310000,15112,92531,0,1290887,352000,254253.0,276129.0,408318.0,-369780.0,0.0,0.0,750977.0,-951467.0,2047220.0,1944719.0
2025-03-06,2383,27589,96200,0,1470276,9000,-58476,53864,0,-952203,-145000,86065,42336,0,2422479,154000,71473.0,129485.0,512726.0,-266821.0,0.0,0.0,-3856194.0,-2165084.0,1164830.0,1363719.0
2025-03-07,2383,73000,115300,0,1791437,176000,-71013,-227602,0,-1757653,-503639,144013,342902,0,3549090,679639,-18747.0,77966.0,-64301.0,-478699.0,0.0,0.0,-4986279.0,-4874186.0,-296471.0,707683.0
2025-03-10,2383,79000,53300,0,1532425,37390,21723,-183033,0,-46129,-266610,57277,236333,0,1578554,304000,-34969.0,110203.0,-177552.0,-827131.0,0.0,0.0,-4697193.0,-4850220.0,-1019030.0,259073.0
2025-03-11,2383,110729,99000,0,2342958,178169,85836,-337259,0,-387970,9169,24893,436259,0,2730928,169000,7406.0,222602.0,-661261.0,-1176091.0,0.0,0.0,-3266988.0,-5368314.0,-1216080.0,177447.0
2025-03-12,2383,59490,176000,0,1185181,828000,-28566,-113395,0,-901774,766900,88056,289395,0,2086955,61100,-50496.0,196036.0,-807425.0,-1369634.0,0.0,0.0,-4045729.0,-6345817.0,-139180.0,913347.0
2025-03-13,2383,48824,27134,0,1198538,89000,-4349,-136665,0,121041,-69000,53173,163799,0,1077497,158000,3631.0,229388.0,-997954.0,-1477088.0,0.0,0.0,-2972485.0,-5459296.0,-63180.0,900347.0
2025-03-14,2383,71091,66600,0,962429,12390,32726,-13088,0,-43875,12390,38365,79688,0,1006304,0,107370.0,250394.0,-783440.0,-1477104.0,0.0,0.0,-1258707.0,-5560598.0,452849.0,909340.0
2025-03-17,2383,13000,98000,0,755969,42000,2843,12600,0,44756,-53000,10157,85400,0,711213,95000,88490.0,268874.0,-587807.0,-1363452.0,0.0,0.0,-1167822.0,-5249059.0,666459.0,851943.0
2025-03-18,2383,78592,180070,0,2179477,98000,46591,-28930,0,1122580,-64000,32001,209000,0,1056897,162000,49245.0,312508.0,-279478.0,-1326869.0,0.0,0.0,342728.0,-3806667.0,593290.0,739546.0
2025-03-19,2383,78105,110999,0,1448752,161000,-45565,-322020,0,-796795,44000,123670,433019,0,2245547,117000,32246.0,191523.0,-488103.0,-1674315.0,0.0,0.0,447707.0,-5942171.0,-129610.0,791655.0
2025-03-20,2383,19000,48000,0,880549,101000,14949,15047,0,-392842,-446000,4051,32953,0,1273391,547000,51544.0,249716.0,-336391.0,-1403242.0,0.0,0.0,-66176.0,-6552754.0,-506610.0,351655.0
2025-03-21,2383,55183,50000,0,2114773,305000,48792,-20221,0,629295,305000,6391,70221,0,1485478,0,67610.0,319142.0,-343524.0,-1465247.0,0.0,0.0,606994.0,-5319457.0,-214000.0,713820.0
2025-03-24,2383,96950,66000,0,2895000,365000,4134,-79050,0,722608,350000,92816,145050,0,2172392,15000,68901.0,327802.0,-435174.0,-1392400.0,0.0,0.0,1284846.0,-4397113.0,189000.0,1128820.0
2025-03-25,2383,74950,64707,0,1730955,350000,11407,-17322,0,-204046,337000,63543,82029,0,1935001,13000,33717.0,317936.0,-423566.0,-1269452.0,0.0,0.0,-41780.0,-3453816.0,590000.0,1561820.0
2025-03-26,2383,23150,29000,0,950172,220000,16762,-4000,0,291682,181000,6388,33000,0,658490,39000,96044.0,332047.0,-105546.0,-992756.0,0.0,0.0,1046697.0,-1800348.0,727000.0,2505430.0
2025-03-27,2383,109603,21000,0,1081013,180000,84500,-11437,0,-500367,157000,25103,32437,0,1581380,23000,165595.0,292243.0,-132030.0,-953649.0,0.0,0.0,939172.0,-5955683.0,1330000.0,1925040.0
2025-03-28,2383,183705,36000,0,1425309,160000,155263,-58854,0,-101602,160000,28442,94854,0,1526911,0,272066.0,428299.0,-170663.0,-1361928.0,0.0,0.0,208275.0,-5429717.0,1185000.0,1127378.0
2025-03-31,2383,418000,95300,0,1532803,128390,302699,-26023,0,-947071,-189610,115301,121323,0,2479874,318000,570631.0,693053.0,-117636.0,-1318169.0,0.0,0.0,-1461404.0,-6041573.0,645390.0,481819.0
2025-04-01,2383,144639,65000,0,899531,143000,87812,3605,0,-1026385,-234000,56827,61395,0,1925916,377000,647036.0,737404.0,-96709.0,-1461014.0,0.0,0.0,-2283743.0,-5249783.0,74390.0,41600.0
2025-04-02,2383,222001,164000,0,2094088,1000,118349,-120968,0,-79947,-218218,103652,284968,0,2174035,219218,748623.0,826417.0,-213677.0,-1614751.0,0.0,0.0,-2655372.0,-5206697.0,-324828.0,133382.0
2025-04-07,2383,0,0,0,510999,0,-37273,-45000,0,406999,-2000,37273,45000,0,104000,2000,626850.0,847620.0,-247240.0,-1713615.0,0.0,0.0,-1748006.0,-3847495.0,-483828.0,276382.0
2025-04-08,2383,423765,198373,0,6910379,38000,330009,-148941,0,2507650,-2560000,93756,347314,0,4402729,2598000,801596.0,1248642.0,-337327.0,-1634954.0,0.0,0.0,861246.0,417808.0,-3203828.0,-1779979.0
2025-04-09,2383,569532,149000,0,4318357,122390,476641,15288,0,1147575,-2160610,92891,133712,0,3170782,2283000,975538.0,1703560.0,-296016.0,-1436633.0,0.0,0.0,2955892.0,1611512.0,-5174828.0,-3673979.0
2025-04-10,2383,101000,0,0,148997,0,94000,-23000,0,-10114,0,7000,23000,0,159111,0,981726.0,1711724.0,-322621.0,-1122374.0,0.0,0.0,3972163.0,1989368.0,-4940828.0,-3683148.0
2025-04-11,2383,274552,93816,0,4069155,393000,100971,-40834,0,584816,291000,173581,134650,0,3484339,102000,964348.0,1841261.0,-242487.0,-1049813.0,0.0,0.0,4636926.0,3475958.0,-4431610.0,-4159048.0
2025-04-14,2383,216643,169002,0,3662155,266561,-11596,-33427,0,-1084963,233144,228239,202429,0,4747118,33417,990025.0,1834014.0,-230914.0,-946575.0,0.0,0.0,3144964.0,2269954.0,-4196466.0,-3856904.0
2025-04-15,2383,88057,29486,0,2146315,907000,33509,-22996,0,-685022,902000,54548,52482,0,2831337,5000,693525.0,1834797.0,-104969.0,-956483.0,0.0,0.0,-47708.0,1628807.0,-734466.0,-2967294.0
2025-04-16,2383,85218,63000,0,1823337,62000,23532,-31181,0,-15095,21000,61686,94181,0,1838432,41000,240416.0,1855486.0,-151438.0,-1000264.0,0.0,0.0,-1210378.0,1568956.0,1447144.0,-2893294.0
2025-04-17,2383,110394,69021,0,1483056,24000,47309,7684,0,-1137405,-13000,63085,61337,0,2620461,37000,193725.0,1856204.0,-120754.0,-963650.0,0.0,0.0,-2337669.0,-691029.0,1434144.0,-2842294.0
2025-04-18,2383,72517,33238,0,1138579,452000,10207,-42304,0,194893,104000,62310,75542,0,943686,348000,102961.0,1911976.0,-122224.0,-683934.0,0.0,0.0,-2727592.0,300659.0,1247144.0,-2782294.0
2025-04-21,2383,166030,15200,0,837350,322000,118367,-46010,0,-183650,-27000,47663,61210,0,1021000,349000,232924.0,2015394.0,-134807.0,-744991.0,0.0,0.0,-1826279.0,509851.0,987000.0,-2363294.0
2025-04-22,2383,224062,40632,0,1365708,228000,166541,-23801,0,243036,-234000,57521,64433,0,1122672,462000,365956.0,2133143.0,-135612.0,-748571.0,0.0,0.0,-898221.0,123592.0,-149000.0,-2902294.0
2025-04-23,2383,48888,48838,0,1610184,85000,31726,14546,0,129250,-240000,17162,34292,0,1480934,325000,374150.0,2160735.0,-89885.0,-654975.0,0.0,0.0,-753876.0,-469766.0,-410000.0,-3492294.0
2025-04-24,2383,35457,14000,0,912086,46000,13461,1000,0,-115527,-281000,21996,13000,0,1027613,327000,340302.0,2162789.0,-96569.0,-636653.0,0.0,0.0,268002.0,-381247.0,-678000.0,-4110294.0
2025-04-25,2383,115986,124957,0,2398793,728000,42410,17455,0,-677122,686000,73576,107502,0,3075915,42000,372505.0,2188437.0,-36810.0,-615198.0,0.0,0.0,-604013.0,-1350051.0,-96000.0,-3605294.0
2025-04-28,2383,23000,73259,0,1469452,613000,-72821,4154,0,-45786,521000,95821,69105,0,1515238,92000,181317.0,2031116.0,13354.0,-599607.0,0.0,0.0,-466149.0,-895470.0,452000.0,-3241294.0
2025-04-29,2383,107162,169868,0,2366475,161000,80146,129793,0,99903,-99000,27016,40075,0,2266572,260000,94922.0,1955999.0,166948.0,-410960.0,0.0,0.0,-609282.0,-693965.0,587000.0,-3500294.0
2025-04-30,2383,17316,33991,0,1787120,32000,-56223,-32839,0,169019,-490000,73539,66830,0,1618101,522000,6973.0,1597077.0,119563.0,-417776.0,0.0,0.0,-569513.0,422125.0,337000.0,-3800684.0
2025-05-02,2383,140203,61154,0,3707045,642000,-20138,-179896,0,2460199,432000,160341,241050,0,1246846,210000,-26626.0,1489127.0,-61333.0,-601277.0,0.0,0.0,2006213.0,3908709.0,1050000.0,-3134684.0
2025-05-05,2383,71640,70157,0,3897408,980339,-105400,-41670,0,227303,872339,177040,111827,0,3670105,108000,-174436.0,1265378.0,-120458.0,-521979.0,0.0,0.0,2910638.0,4215959.0,1236339.0,-2044127.0
2025-05-06,2383,29074,51000,0,3197326,463000,-84122,-64648,0,165856,66434,113196,115648,0,3031470,396566,-185737.0,1218529.0,-189260.0,-541627.0,0.0,0.0,3122280.0,3974816.0,781773.0,-1975693.0
2025-05-07,2383,14675,5000,0,1883369,254000,-76756,-40970,0,333548,97842,91431,45970,0,1549821,156158,-342639.0,811764.0,-360023.0,-433656.0,0.0,0.0,3355925.0,1800714.0,978615.0,682149.0
2025-05-08,2383,103821,42040,0,6650951,839000,-30400,-49721,0,2367024,793184,134221,91761,0,4283927,45816,-316816.0,304723.0,-376905.0,-498665.0,0.0,0.0,5553930.0,3020163.0,2261799.0,3635943.0
2025-05-09,2383,81619,90702,0,2992480,1431000,12312,-15261,0,-42729,1431000,69307,105963,0,3035209,0,-284366.0,223035.0,-212270.0,-490926.0,0.0,0.0,3051002.0,2987548.0,3260799.0,5066943.0
2025-05-12,2383,18655,29079,0,1986396,185000,-31451,1050,0,667547,83592,50106,28029,0,1318849,101408,-210417.0,90613.0,-169550.0,-449042.0,0.0,0.0,3491246.0,3070279.0,2472052.0,4859535.0
2025-05-13,2383,35844,68200,0,2004456,332000,21839,31875,0,587068,161592,14005,36325,0,1417388,170408,-104456.0,124048.0,-73027.0,-383740.0,0.0,0.0,3912458.0,4742310.0,2567210.0,4787983.0
2025-05-14,2383,48388,99650,0,2237179,176000,-16747,64650,0,546869,142000,65135,35000,0,1690310,34000,-44447.0,73792.0,32593.0,-296094.0,0.0,0.0,4125779.0,5974201.0,2611368.0,4027983.0
2025-05-15,2383,22043,16050,0,1518521,85000,-1637,-25320,0,418879,64941,23680,41370,0,1099642,20059,-15684.0,48623.0,56994.0,-290233.0,0.0,0.0,2177634.0,6408175.0,1883125.0,4071924.0
2025-05-16,2383,31518,13220,0,1421326,3000,10459,-14830,0,257326,-29408,21059,28050,0,1164000,32408,-17537.0,11773.0,57425.0,-312747.0,0.0,0.0,2477689.0,7802906.0,422717.0,4055516.0
2025-05-19,2383,25730,37034,0,1625587,52000,-38698,-8348,0,789577,-238685,64428,45382,0,836010,290685,-24784.0,-37132.0,48027.0,-278791.0,0.0,0.0,2599719.0,8397590.0,100440.0,3712831.0
2025-05-20,2383,36625,36210,0,1190875,80000,31940,13210,0,43665,-7404,4685,23000,0,1147210,87404,-14683.0,-123559.0,29362.0,-219571.0,0.0,0.0,2056316.0,8624905.0,-68556.0,3732427.0
2025-05-21,2383,341401,122563,0,2595981,619000,297998,50558,0,68165,552000,43403,72005,0,2527816,67000,300062.0,7898.0,15270.0,-145212.0,0.0,0.0,1577612.0,8450034.0,341444.0,4518427.0
2025-05-22,2383,9868,26107,0,1660525,144000,-67944,3857,0,619156,90596,77812,22250,0,1041369,53404,233755.0,-91772.0,44447.0,-155901.0,0.0,0.0,1777889.0,8939940.0,367099.0,4849023.0
2025-05-23,2383,17557,116081,0,2272274,251000,-17268,6251,0,458170,162000,34825,109830,0,1814104,89000,206028.0,-122501.0,65528.0,-150650.0,0.0,0.0,1978733.0,9513637.0,558507.0,5292023.0
2025-05-26,2383,16726,20053,0,1427850,327000,-4254,-97631,0,499653,204032,20980,117684,0,928197,122968,240472.0,-169165.0,-23755.0,-265736.0,0.0,0.0,1688809.0,10690412.0,1001224.0,4810055.0
2025-05-27,2383,29530,20103,0,1634573,392000,23281,-91881,0,289894,358127,6249,111984,0,1344679,33873,231813.0,-73063.0,-128846.0,-361771.0,0.0,0.0,1935038.0,11026092.0,1366755.0,4647182.0
2025-05-28,2383,69702,48054,0,1734722,147000,56170,729,0,255983,122000,13532,47325,0,1478739,25000,-10015.0,-97039.0,-178675.0,-490835.0,0.0,0.0,2122856.0,11182172.0,936755.0,4868182.0
2025-05-29,2383,86246,91869,0,4016517,320027,32401,22405,0,-340175,242027,53845,69464,0,4356692,78000,90330.0,-8415.0,-160127.0,-435591.0,0.0,0.0,1163525.0,10672978.0,1088186.0,5600209.0
2025-06-02,2383,82196,18000,0,3325042,429000,-82264,-41877,0,-101495,409000,164460,59877,0,3426537,20000,25334.0,-70541.0,-208255.0,-297572.0,0.0,0.0,603860.0,8111284.0,1335186.0,5577209.0
2025-06-03,2383,49478,47008,0,3703938,545000,-63964,-55623,0,-335654,539000,113442,102631,0,4039592,6000,-34376.0,-29105.0,-166247.0,-311525.0,0.0,0.0,-231447.0,7548327.0,1670154.0,5243870.0
2025-06-04,2383,16173,64065,0,1250382,132000,-38558,-8935,0,-170996,57596,54731,73000,0,1421378,74404,-96215.0,16459.0,-83301.0,-255812.0,0.0,0.0,-692337.0,7211475.0,1369623.0,5235032.0
2025-06-05,2383,68036,90867,0,1374320,1000,61621,77856,0,190870,-5204,6415,13011,0,1183450,6204,-90764.0,154836.0,-6174.0,-136986.0,0.0,0.0,-757450.0,7068797.0,1242419.0,5131986.0
2025-06-06,2383,102208,68000,0,1306998,0,67092,-11211,0,130341,-49000,35116,79211,0,1176657,49000,-56073.0,252328.0,-39790.0,-98476.0,0.0,0.0,-286934.0,4832114.0,951392.0,4289802.0
2025-06-09,2383,243347,86265,0,2733838,0,210148,-768,0,518120,-238404,33199,87033,0,2215718,238404,236339.0,450164.0,1319.0,-83983.0,0.0,0.0,332681.0,5392963.0,303988.0,2620398.0
2025-06-10,2383,156919,129845,0,4595288,41000,29632,-123955,0,930887,-143404,127287,253800,0,3664401,184404,329935.0,511247.0,-67013.0,-208988.0,0.0,0.0,1599222.0,5656303.0,-378416.0,2393402.0
2025-06-11,2383,174870,67500,0,2855928,0,41137,-95877,0,-228046,-850808,133733,163377,0,3083974,850808,409630.0,530545.0,-153955.0,-336740.0,0.0,0.0,1542172.0,4841189.0,-1286820.0,1381002.0
2025-06-12,2383,161895,118940,0,2274156,0,115087,46840,0,918440,-1242993,46808,72100,0,1355716,1242993,463096.0,662379.0,-184971.0,-354550.0,0.0,0.0,2269742.0,5212760.0,-2524609.0,-3991.0
2025-06-13,2383,57646,18450,0,3095099,0,3567,-72650,0,848367,-724000,54079,91100,0,2246732,724000,399571.0,667583.0,-246410.0,-401880.0,0.0,0.0,2987768.0,5642248.0,-3199609.0,-792932.0
2025-06-16,2383,147071,15156,0,1838872,0,95591,-95004,0,705581,-403163,51480,110160,0,1133291,403163,285014.0,752715.0,-340646.0,-482054.0,0.0,0.0,3175229.0,6090503.0,-3364368.0,-1166687.0
2025-06-17,2383,84890,115784,0,2897488,325,-44049,-160331,0,644418,-540675,128939,276115,0,2253070,541000,211333.0,747364.0,-377022.0,-634037.0,0.0,0.0,2888760.0,5945344.0,-3761639.0,-1468677.0
2025-06-18,2383,212056,117000,0,4611153,0,151046,-322000,0,1604722,-1410405,61010,439000,0,3006431,1410405,321242.0,866470.0,-603145.0,-969247.0,0.0,0.0,4721528.0,7506401.0,-4321236.0,-2871678.0
2025-06-19,2383,66083,21031,0,2166000,20000,18291,-39769,0,1311776,-804400,47792,60800,0,854224,824400,224446.0,586763.0,-689754.0,-1059574.0,0.0,0.0,5114864.0,8750012.0,-3882643.0,-4228078.0
2025-06-20,2383,72821,77000,0,4062036,5514231,22886,-139527,0,64681,1493052,49935,216527,0,3997355,4021179,243765.0,677593.0,-756631.0,-1202958.0,0.0,0.0,4331178.0,8195537.0,-1665591.0,-2825622.0
2025-06-23,2383,122227,87000,0,4415822,33000,60560,10000,0,3179303,-2936568,61667,77000,0,1236519,2969568,208734.0,755421.0,-651627.0,-1199209.0,0.0,0.0,6804900.0,10916670.0,-4198996.0,-5924190.0
2025-06-24,2383,102133,193505,0,5024497,458000,81060,156505,0,4100491,-3212000,21073,37000,0,924006,3670000,333843.0,840735.0,-334791.0,-945073.0,0.0,0.0,10260973.0,14517508.0,-6870321.0,-9340222.0
2025-06-25,2383,27119,69267,0,4158685,194000,-39596,8710,0,3158075,-3360817,66715,60557,0,1000610,3554817,143201.0,777858.0,-4081.0,-844482.0,0.0,0.0,11814326.0,17385689.0,-8820733.0,-13059166.0
2025-06-26,2383,22413,123164,0,4415824,175000,-29299,9364,0,2933259,-3356408,51712,113800,0,1482565,3531408,95611.0,692389.0,45052.0,-835847.0,0.0,0.0,13435809.0,20062965.0,-11372741.0,-16537574.0
2025-06-27,2383,42438,34886,0,2380534,174000,-20738,-97314,0,1427875,-921817,63176,132200,0,952659,1095817,51987.0,639250.0,87265.0,-955566.0,0.0,0.0,14799003.0,21831015.0,-13787610.0,-17701418.0
2025-06-30,2383,123358,103882,0,3519003,17122,28008,-13118,0,1963089,-1146408,95350,117000,0,1555914,1163530,19435.0,749522.0,64147.0,-926807.0,0.0,0.0,13582789.0,23895599.0,-11997450.0,-19256826.0
2025-07-01,2383,58020,156700,0,2798942,144627,7292,103115,0,925266,-343373,50728,53585,0,1873676,488000,-54333.0,820778.0,10757.0,-768069.0,0.0,0.0,10407564.0,25156519.0,-9128823.0,-20139199.0
2025-07-02,2383,10089,29000,0,1809209,454000,-155744,-25200,0,225120,410000,165833,54200,0,1584089,44000,-170481.0,703592.0,-23153.0,-784334.0,0.0,0.0,7474609.0,25552635.0,-5358006.0,-19786795.0
2025-07-03,2383,71576,83170,0,1690405,411000,-56987,20170,0,-302410,394050,128563,63000,0,1992815,16950,-198169.0,584984.0,-12347.0,-842020.0,0.0,0.0,4238940.0,25059355.0,-1607548.0,-19387541.0
2025-07-04,2383,44855,72305,0,1424520,44000,-36018,27202,0,-167805,-118768,80873,45103,0,1592325,162768,-213449.0,481874.0,112169.0,-803607.0,0.0,0.0,2643260.0,24761209.0,-804499.0,-19457309.0
2025-07-07,2383,44377,32151,0,1265241,3614,-12914,-21899,0,473542,-146386,57291,54050,0,791699,150000,-254371.0,258812.0,103388.0,-824738.0,0.0,0.0,1153713.0,24716631.0,195523.0,-19365291.0
2025-07-08,2383,102395,28000,0,2407009,153619,52110,-178409,0,856984,61619,50285,206409,0,1550025,92000,-209553.0,281290.0,-178136.0,-879192.0,0.0,0.0,1085431.0,24642728.0,600515.0,-19160268.0
2025-07-09,2383,47909,81000,0,1982298,1000,-32249,48700,0,98029,-57000,80158,32300,0,1884269,58000,-86058.0,207904.0,-104236.0,-734615.0,0.0,0.0,958340.0,24968803.0,133515.0,-18366460.0
2025-07-10,2383,87093,66300,0,2912327,20000,-40235,-195800,0,263257,-245412,127328,262100,0,2649070,265412,-69306.0,52582.0,-320206.0,-977255.0,0.0,0.0,1524007.0,24313620.0,-505947.0,-17368879.0
2025-07-11,2383,110038,45000,0,2120280,141000,27497,-110300,0,257009,-405308,82541,155300,0,1863271,546308,-5791.0,76512.0,-457708.0,-1014905.0,0.0,0.0,1948821.0,23722262.0,-792487.0,-17050187.0
2025-07-14,2383,85631,68000,0,915096,2000,32570,-38000,0,-44961,-239161,53061,106000,0,960057,241161,39693.0,13491.0,-473809.0,-957901.0,0.0,0.0,1430318.0,22971720.0,-885262.0,-16886185.0
2025-07-15,2383,142864,147998,0,1841158,160000,87491,62998,0,448555,53258,55373,85000,0,1392603,106742,75074.0,145031.0,-232402.0,-734572.0,0.0,0.0,1021889.0,22775857.0,-893623.0,-16292252.0
2025-07-16,2383,229749,204000,0,2189625,708247,138372,-169800,0,-571672,702335,91377,373800,0,2761297,5912,245695.0,132357.0,-450902.0,-582372.0,0.0,0.0,352188.0,20599463.0,-134288.0,-14179512.0
2025-07-17,2383,117000,71000,0,1755866,37039,12657,34000,0,-609033,-21961,104343,37000,0,2364899,59000,298587.0,126723.0,-221102.0,-508603.0,0.0,0.0,-520102.0,18678654.0,89163.0,-13397073.0
2025-07-18,2383,266831,70148,0,3463585,201000,88690,-50852,0,2253729,60387,178141,121000,0,1209856,140613,359780.0,192527.0,-161654.0,-419928.0,0.0,0.0,1476618.0,20867702.0,554858.0,-14829738.0
2025-07-21,2383,34436,60000,0,832654,25000,-61623,29000,0,-383361,7239,96059,31000,0,1216015,17761,265587.0,70344.0,-94654.0,-400928.0,0.0,0.0,1138218.0,17305038.0,801258.0,-11885931.0
2025-07-22,2383,56600,40000,0,1467015,61060,-80067,-67100,0,324134,34060,136667,107100,0,1142881,27000,98029.0,-90783.0,-224752.0,-624533.0,0.0,0.0,1013797.0,13528681.0,782060.0,-8639871.0
2025-07-23,2383,64100,103148,0,806881,19000,24991,-19152,0,-582607,-42000,39109,122300,0,1389488,61000,-15352.0,-26196.0,-74104.0,-652395.0,0.0,0.0,1002862.0,9787999.0,37725.0,-5321054.0
2025-07-24,2383,88834,32000,0,1545228,16100,28861,16000,0,-386888,-45313,59973,16000,0,1932116,61413,852.0,31964.0,-92104.0,-645759.0,0.0,0.0,1225007.0,6467852.0,14373.0,-2009959.0
2025-07-25,2383,30871,84559,0,955564,23000,-4594,-18441,0,-22671,-44000,35465,103000,0,978235,67000,-92432.0,48108.0,-59693.0,-566886.0,0.0,0.0,-1051393.0,5017306.0,-90014.0,-1132142.0
2025-07-28,2383,79890,57000,0,1898597,329000,3190,-37042,0,652837,323988,76700,94042,0,1245760,5012,-27619.0,23290.0,-125735.0,-590810.0,0.0,0.0,-15195.0,3707054.0,226735.0,338254.0
2025-07-29,2383,58506,45855,0,707051,429000,17454,35438,0,-198203,421700,41052,10417,0,905254,7300,69902.0,33452.0,-23197.0,-658487.0,0.0,0.0,-537532.0,2583585.0,614375.0,1103327.0
2025-07-30,2383,100352,156650,0,1537782,20000,42215,106650,0,-531149,-1000,58137,50000,0,2068931,21000,87126.0,231411.0,102605.0,-526637.0,0.0,0.0,-486074.0,1827316.0,655375.0,692327.0
2025-07-31,2383,82717,46956,0,3260779,52000,-41826,-79305,0,1908135,32000,124543,126261,0,1352644,20000,16439.0,246572.0,7300.0,-626112.0,0.0,0.0,1808949.0,4037861.0,732688.0,330277.0
2025-08-01,2383,83379,143000,0,4354343,284000,-32151,85584,0,293092,267983,115530,57416,0,4061251,16017,-11118.0,250439.0,111325.0,-567730.0,0.0,0.0,2124712.0,4498758.0,1044671.0,717028.0
2025-08-04,2383,59111,42000,0,2682235,68000,-15694,-15000,0,427170,68000,74805,57000,0,2255065,0,-30002.0,247659.0,133367.0,-560831.0,0.0,0.0,1899045.0,4452386.0,788683.0,931414.0
2025-08-05,2383,26678,54000,0,2787933,71500,13024,6800,0,385604,38198,13654,47200,0,2402329,33302,-34432.0,208573.0,104729.0,-375622.0,0.0,0.0,2482852.0,3981006.0,405181.0,907993.0
2025-08-06,2383,68147,133148,0,872340,32000,30305,88978,0,-504457,-4640,37842,44170,0,1376797,36640,-46342.0,271127.0,87057.0,-335344.0,0.0,0.0,2509544.0,3378520.0,401541.0,960353.0
2025-08-07,2383,64528,130618,0,1268156,150401,54424,89618,0,-67949,141797,10104,41000,0,1336105,8604,49908.0,365786.0,255980.0,-49926.0,0.0,0.0,533460.0,3047314.0,511338.0,1347562.0
2025-08-08,2383,32840,68317,0,666581,152000,2634,49856,0,-227172,130440,30206,18461,0,893753,21560,84693.0,340923.0,220252.0,110230.0,0.0,0.0,13196.0,2563133.0,373795.0,1883310.0
2025-08-11,2383,56903,85248,0,1154272,72000,31667,51807,0,176993,-307684,25236,33441,0,977279,379684,132054.0,340020.0,287059.0,200037.0,0.0,0.0,-236981.0,2785087.0,-1889.0,1814787.0
2025-08-12,2383,37863,72556,0,841757,136000,280,40124,0,-365,-4664,37583,32432,0,842122,140664,119310.0,252809.0,320383.0,177163.0,0.0,0.0,-622950.0,2336167.0,-44751.0,1756865.0
2025-08-13,2383,46623,188400,0,1858522,137000,-4644,70992,0,-220170,136000,51267,117408,0,2078692,1000,84361.0,109793.0,302397.0,417955.0,0.0,0.0,-338663.0,2687669.0,95889.0,1190530.0
2025-08-14,2383,8351,62800,0,1136189,192060,-43945,23800,0,-90060,-121311,52296,39000,0,1226249,313371,-14008.0,53191.0,236579.0,407755.0,0.0,0.0,-360774.0,3206642.0,-167219.0,1091180.0
2025-08-15,2383,62109,158943,0,2262496,196000,46435,97943,0,-228774,109535,15674,61000,0,2491270,86465,29793.0,10936.0,284666.0,556550.0,0.0,0.0,-362376.0,724139.0,-188124.0,1140328.0
2025-08-18,2383,12599,76800,0,1737064,105120,-28602,34281,0,-676975,66872,41201,42519,0,2414039,38248,-30476.0,43957.0,267140.0,561831.0,0.0,0.0,-1216344.0,430525.0,186432.0,1199961.0
2025-08-19,2383,126669,196159,0,2064533,173060,64013,46439,0,-544261,-126342,62656,149720,0,2608794,299402,33257.0,188037.0,273455.0,675370.0,0.0,0.0,-1760240.0,-437870.0,64754.0,1039559.0
2025-08-20,2383,158575,190100,0,3496701,9620,120976,-32671,0,127668,-441682,37599,222771,0,3369033,451302,158877.0,284022.0,169792.0,661851.0,0.0,0.0,-1412402.0,272405.0,-512928.0,639877.0
2025-08-21,2383,122092,135100,0,3720048,130060,33572,-42609,0,-489958,57158,88520,177709,0,4210006,72902,236394.0,288733.0,103383.0,603242.0,0.0,0.0,-1812300.0,169335.0,-334459.0,742348.0
2025-08-22,2383,42168,72005,0,2327556,16000,-34589,-49033,0,-226039,-78800,76757,121038,0,2553595,94800,155370.0,258738.0,-43593.0,572650.0,0.0,0.0,-1809565.0,-34033.0,-522794.0,707548.0
2025-08-25,2383,24799,90248,0,1576601,51133,18766,-49752,0,-39946,-3967,6033,140000,0,1616547,55100,202738.0,274314.0,-127626.0,559940.0,0.0,0.0,-1172536.0,-726816.0,-593633.0,379593.0
2025-08-26,2383,36626,29294,0,1902257,194011,-11056,-171806,0,-303269,-90989,47682,201100,0,2205526,285000,127669.0,245804.0,-345871.0,352696.0,0.0,0.0,-931544.0,-831882.0,-558280.0,-133096.0
2025-08-27,2383,82927,171700,0,2030603,78000,50933,102445,0,52133,-46000,31994,69255,0,1978470,124000,57626.0,254522.0,-210755.0,348491.0,0.0,0.0,-1007079.0,-248600.0,-162598.0,-178096.0
2025-08-28,2383,36952,62030,0,1416522,99000,-36366,-28638,0,-246487,-146000,73318,90668,0,1663009,245000,-12312.0,259982.0,-196784.0,399158.0,0.0,0.0,-763608.0,-2403222.0,-365756.0,-356096.0
2025-08-29,2383,22668,44000,0,1440788,25000,-43367,-101100,0,-249976,-110000,66035,145100,0,1690764,135000,-21090.0,248766.0,-248851.0,212474.0,0.0,0.0,-787545.0,-2946290.0,-396956.0,-734079.0
2025-09-01,2383,92492,46400,0,3487504,102065,-23105,-194616,0,38278,-385835,115597,241016,0,3449226,487900,-62961.0,241355.0,-393715.0,32858.0,0.0,0.0,-709321.0,-3335182.0,-778824.0,-1187914.0
2025-09-02,2383,17057,56600,0,1671475,6000,5921,23309,0,81779,-529000,11136,33291,0,1589696,535000,-45984.0,234252.0,-198600.0,49367.0,0.0,0.0,-324273.0,-3639007.0,-1216835.0,-1755112.0
2025-09-03,2383,13976,34100,0,1630316,65000,4977,-3000,0,336745,-122800,8999,37100,0,1293571,187800,-91940.0,208924.0,-304045.0,-42611.0,0.0,0.0,-39661.0,-2797805.0,-1293635.0,-1873272.0
2025-09-04,2383,139236,202800,0,4037426,21000,30683,-83225,0,1259997,-1619200,108553,286025,0,2777429,1640200,-24891.0,185183.0,-358632.0,-215454.0,0.0,0.0,1466823.0,-1469859.0,-2766835.0,-3634269.0
2025-09-05,2383,58587,99400,0,3008099,207000,21355,64800,0,-869491,-13500,37232,34600,0,3877590,220500,39831.0,203904.0,-192732.0,-200510.0,0.0,0.0,847308.0,-2112178.0,-2670335.0,-3778209.0
2025-09-08,2383,15837,25346,0,1728479,0,-32623,-21134,0,-214848,-219403,48460,46480,0,1943327,219403,30313.0,139614.0,-19250.0,-273451.0,0.0,0.0,594182.0,-2504019.0,-2503903.0,-3689928.0
2025-09-09,2383,174438,101483,0,3787091,203000,61705,-110493,0,1050027,197900,112733,211976,0,2737064,5100,86097.0,201039.0,-153052.0,-424068.0,0.0,0.0,1562430.0,-1453627.0,-1777003.0,-3487364.0
2025-09-10,2383,52283,70300,0,3137822,96000,-28046,-24100,0,-185239,65299,80329,94400,0,3323061,30701,53074.0,177637.0,-174152.0,-519160.0,0.0,0.0,1040446.0,-1418696.0,-1588904.0,-3558065.0
2025-09-11,2383,215725,181798,0,4109119,357000,117690,36298,0,792804,346436,98035,145500,0,3316315,10564,140081.0,339272.0,-54629.0,-506662.0,0.0,0.0,573253.0,-535832.0,376732.0,-3090318.0
2025-09-12,2383,67751,69398,0,2107503,470000,-39896,3998,0,-324585,421000,107647,65400,0,2432088,49000,78830.0,252941.0,-115431.0,-600607.0,0.0,0.0,1118159.0,-631643.0,811232.0,-2778853.0
2025-09-15,2383,39433,29100,0,1353866,201000,-13196,-81150,0,-93596,121593,52629,110250,0,1447462,79407,98257.0,268347.0,-175447.0,-716038.0,0.0,0.0,1239411.0,-48264.0,1152228.0,-2724132.0
2025-09-16,2383,17854,15454,0,1355307,61002,-47065,-32846,0,-236251,12401,64919,48300,0,1591558,48601,-10513.0,157269.0,-97800.0,-795323.0,0.0,0.0,-46867.0,259746.0,966729.0,-2585389.0
2025-09-17,2383,46606,65400,0,2143558,280000,17905,-57292,0,132263,245593,28701,122692,0,2011295,34407,35438.0,54198.0,-130992.0,-819944.0,0.0,0.0,270635.0,264341.0,1147023.0,-1898114.0
2025-09-18,2383,70968,85941,0,1278562,82000,25982,54741,0,-206561,15000,44986,31200,0,1485123,67000,-56270.0,46608.0,-112549.0,-722594.0,0.0,0.0,-728730.0,547738.0,815587.0,-1940272.0
2025-09-19,2383,13122,42000,0,1981696,187306,-34520,-18330,0,-394840,123952,47642,60330,0,2376536,63354,-50894.0,46677.0,-134877.0,-691891.0,0.0,0.0,-798985.0,378937.0,518539.0,-1737520.0
2024-09-23,2454,46560,105200,0,1820254,1499000,-20289,41200,0,-1124668,1433000,66849,64000,0,2944922,66000,-20289.0,-20289.0,41200.0,41200.0,0.0,0.0,-1124668.0,-1124668.0,1433000.0,1433000.0
2024-09-24,2454,125401,85209,0,4033863,1441422,67963,54209,0,311109,1278409,57438,31000,0,3722754,163013,47674.0,47674.0,95409.0,95409.0,0.0,0.0,-813559.0,-813559.0,2711409.0,2711409.0
2024-09-25,2454,87920,254000,0,6490664,1494000,42185,202000,0,-1194207,1178405,45735,52000,0,7684871,315595,89859.0,89859.0,297409.0,297409.0,0.0,0.0,-2007766.0,-2007766.0,3889814.0,3889814.0
2024-09-26,2454,317026,142399,0,5145823,1506000,199607,105398,0,574172,1300349,117419,37001,0,4571651,205651,289466.0,289466.0,402807.0,402807.0,0.0,0.0,-1433594.0,-1433594.0,5190163.0,5190163.0
2024-09-27,2454,88423,95000,0,4811051,1050703,15482,60281,0,-646955,845698,72941,34719,0,5458006,205005,304948.0,304948.0,463088.0,463088.0,0.0,0.0,-2080549.0,-2080549.0,6035861.0,6035861.0
2024-09-30,2454,160475,60000,0,4405185,95281,-3217,-67000,0,-2480124,-177496,163692,127000,0,6885309,272777,322020.0,301731.0,354888.0,396088.0,0.0,0.0,-3436005.0,-4560673.0,4425365.0,5858365.0
2024-10-01,2454,146005,60000,0,3268138,573886,63340,25000,0,-886534,571886,82665,35000,0,4154672,2000,317397.0,365071.0,325679.0,421088.0,0.0,0.0,-4633648.0,-5447207.0,3718842.0,6430251.0
2024-10-04,2454,146208,94000,0,5242709,355514,34456,-73000,0,126194,349501,111752,167000,0,5116515,6013,309668.0,399527.0,50679.0,348088.0,0.0,0.0,-3313247.0,-5321013.0,2889938.0,6779752.0
2024-10-07,2454,382834,340000,0,4445046,621743,302432,258000,0,-1393508,616743,80402,82000,0,5838554,5000,412493.0,701959.0,203281.0,606088.0,0.0,0.0,-5280927.0,-6714521.0,2206332.0,7396495.0
2024-10-08,2454,150399,64000,0,2630750,249465,70598,14000,0,-959457,204685,79801,50000,0,3590207,44780,467609.0,772557.0,157000.0,620088.0,0.0,0.0,-5593429.0,-7673978.0,1565319.0,7601180.0
2024-10-09,2454,54606,30627,0,3698362,97141,-96884,-88650,0,882364,74138,151490,119277,0,2815998,23003,373942.0,675673.0,135350.0,531438.0,0.0,0.0,-2230941.0,-6791614.0,1816953.0,7675318.0
2024-10-11,2454,351501,116400,0,7724677,207083,131990,88400,0,3662890,186530,219511,28000,0,4061787,20553,442592.0,807663.0,198750.0,619838.0,0.0,0.0,2318483.0,-3128724.0,1431597.0,7861848.0
2024-10-14,2454,57203,36999,0,1973241,331846,-69548,8999,0,-280279,330068,126751,28000,0,2253520,1778,338588.0,738115.0,280749.0,628837.0,0.0,0.0,1912010.0,-3409003.0,1412164.0,8191916.0
2024-10-15,2454,61227,60767,0,3411866,223203,28158,35767,0,3870,214982,33069,25000,0,3407996,8221,64314.0,766273.0,58516.0,664604.0,0.0,0.0,3309388.0,-3405133.0,1010403.0,8406898.0
2024-10-16,2454,179159,122500,0,4985770,170949,72424,94500,0,-539566,91933,106735,28000,0,5525336,79016,66140.0,838697.0,139016.0,759104.0,0.0,0.0,3729279.0,-3944699.0,897651.0,8498831.0
2024-10-17,2454,122140,158000,0,2271972,219000,92939,133600,0,-1039073,72000,29201,24400,0,3311045,147000,255963.0,931636.0,361266.0,892704.0,0.0,0.0,1807842.0,-4983772.0,895513.0,8570831.0
2024-10-18,2454,298923,113284,0,5793761,174281,101984,77284,0,2401927,63276,196939,36000,0,3391834,111005,225957.0,1033620.0,350150.0,969988.0,0.0,0.0,546879.0,-2581845.0,772259.0,8634107.0
2024-10-21,2454,109389,168098,0,3262937,240281,39123,153001,0,-355710,152278,70266,15097,0,3618647,88003,334628.0,1072743.0,494152.0,1122989.0,0.0,0.0,471448.0,-2937555.0,594469.0,8786385.0
2024-10-22,2454,19758,40000,0,2398292,181238,-92898,-9185,0,-825215,119235,112656,49185,0,3223507,62003,213572.0,979845.0,449200.0,1113804.0,0.0,0.0,-357637.0,-3762770.0,498722.0,8905620.0
2024-10-23,2454,49331,55000,0,3493865,112686,10396,-67503,0,590328,-140327,38935,122503,0,2903537,253013,151544.0,990241.0,287197.0,1046301.0,0.0,0.0,772257.0,-3172442.0,266462.0,8765293.0
2024-10-24,2454,59015,74000,0,2493022,46689,-30237,-81301,0,233562,-52314,89252,155301,0,2259460,99003,28368.0,980293.0,72296.0,923800.0,0.0,0.0,2044892.0,-1814212.0,142148.0,7279979.0
2024-10-25,2454,137513,27200,0,5169008,73904,13366,20200,0,2003109,-120099,124147,7000,0,3165899,194003,-60250.0,925696.0,15212.0,889791.0,0.0,0.0,1646074.0,-122212.0,-41227.0,5881471.0
2024-10-28,2454,112060,43000,0,4011144,141242,14992,22000,0,1340992,117239,97068,21000,0,2670152,24003,-84381.0,898503.0,-115789.0,709791.0,0.0,0.0,3342776.0,2412987.0,-76266.0,4820305.0
2024-10-29,2454,172024,90000,0,1947150,718090,64055,-18100,0,-1369489,697087,107969,108100,0,3316639,21003,72572.0,762951.0,-124704.0,586293.0,0.0,0.0,2798502.0,469326.0,501586.0,4217043.0
2024-10-30,2454,83779,39000,0,3102495,195074,30027,-47000,0,264765,185071,53752,86000,0,2837730,10003,92203.0,777496.0,-104201.0,479012.0,0.0,0.0,2472939.0,1381046.0,826984.0,3556416.0
2024-11-01,2454,131822,117000,0,5997090,669944,1080,-55999,0,-1224660,608944,130742,172999,0,7221750,61000,123520.0,781793.0,-78899.0,490013.0,0.0,0.0,1014717.0,2636510.0,1488242.0,4342856.0
2024-11-04,2454,44251,3000,0,1033401,268960,-96439,-15000,0,-1003290,241960,140690,18000,0,2036691,27000,13715.0,622014.0,-114099.0,450013.0,0.0,0.0,-1991682.0,2519754.0,1850301.0,4012930.0
2024-11-05,2454,24000,3000,0,1147739,517990,-96034,-40800,0,-1179703,503990,120034,43800,0,2327442,14000,-97311.0,491524.0,-176899.0,482213.0,0.0,0.0,-4512377.0,1213857.0,2237052.0,4167419.0
2024-11-06,2454,57260,25000,0,1731704,421056,-10222,7000,0,151118,324056,67482,18000,0,1580586,97000,-171588.0,178870.0,-151799.0,231213.0,0.0,0.0,-2991770.0,2758483.0,1864021.0,3874732.0
2024-11-07,2454,36354,64000,0,2091578,126473,-11196,21972,0,-155627,24473,47550,42028,0,2247205,102000,-212811.0,97076.0,-82827.0,239185.0,0.0,0.0,-3412162.0,3562313.0,1703423.0,3694520.0
2024-11-08,2454,79170,6000,0,1030040,110894,-19789,-3500,0,-1398502,894,98959,9500,0,2428542,110000,-233680.0,174171.0,-30328.0,324335.0,0.0,0.0,-3586004.0,1281447.0,1095373.0,3621276.0
2024-11-11,2454,53873,9000,0,1009954,256033,20155,-45072,0,-457106,148874,33718,54072,0,1467060,107159,-117086.0,62336.0,-60400.0,190863.0,0.0,0.0,-3039820.0,-2838549.0,1002287.0,3583620.0
2024-11-12,2454,101366,65000,0,1596558,259872,46144,-37993,0,-1081155,208872,55222,102993,0,2677713,51000,25092.0,178028.0,-57593.0,143871.0,0.0,0.0,-2941272.0,-3639425.0,707169.0,3462424.0
2024-11-13,2454,89643,47000,0,1775548,408375,38012,-56000,0,-1017036,294349,51631,103000,0,2792584,114026,73326.0,187882.0,-120593.0,52104.0,0.0,0.0,-4109426.0,-4660331.0,677462.0,3541791.0
2024-11-14,2454,114177,121000,0,2061614,458743,39000,-88000,0,-206420,284743,75177,209000,0,2268034,174000,123522.0,154458.0,-230565.0,-130396.0,0.0,0.0,-4160219.0,-4327185.0,937732.0,3734601.0
2024-11-15,2454,105303,58000,0,3030085,41466,52689,-37000,0,931229,-201534,52614,95000,0,2098856,243000,196000.0,114208.0,-264065.0,-300996.0,0.0,0.0,-1830488.0,-2356883.0,735304.0,3461067.0
2024-11-18,2454,110291,80000,0,2130019,174236,-4216,-39000,0,-265282,10236,114507,119000,0,2395301,164000,171629.0,8008.0,-257993.0,-417280.0,0.0,0.0,-1638664.0,-5024092.0,596666.0,3408027.0
2024-11-19,2454,103115,107000,0,2607009,332608,47418,7000,0,979312,18446,55697,100000,0,1627697,314162,172903.0,16303.0,-213000.0,-563281.0,0.0,0.0,421803.0,-3689070.0,406240.0,3274195.0
2024-11-20,2454,100805,177000,0,3036673,110005,8073,97000,0,-414776,-76702,92732,80000,0,3451449,186707,142964.0,117274.0,-60000.0,-457096.0,0.0,0.0,1024063.0,-3278631.0,35189.0,3078258.0
2024-11-21,2454,31221,9533,0,1447542,178241,-22939,-15467,0,-88693,-115759,54160,25000,0,1536235,294000,81025.0,83939.0,12533.0,-405060.0,0.0,0.0,1141790.0,-3957652.0,-365313.0,3102826.0
2024-11-22,2454,167345,35300,0,4485465,148403,115302,35300,0,2975369,-225597,52043,0,0,1510096,374000,143638.0,229478.0,84833.0,-288459.0,0.0,0.0,3185930.0,-1215845.0,-389376.0,2929543.0
2024-11-25,2454,69506,113554,0,5142886,256268,-21222,73900,0,-309788,-58774,90728,39654,0,5452674,315042,126632.0,194890.0,197733.0,-234759.0,0.0,0.0,3141424.0,-3528742.0,-458386.0,2990868.0
2024-11-26,2454,34922,7971,0,1735416,77965,-15798,-49029,0,-596515,61599,50720,57000,0,2331931,16366,63416.0,164100.0,141704.0,-305788.0,0.0,0.0,1565597.0,-5466249.0,-415233.0,2935228.0
2024-11-27,2454,142826,2000,0,879286,147251,113418,-29400,0,-834268,110706,29408,31400,0,1713554,36545,168761.0,213463.0,15304.0,-317088.0,0.0,0.0,1146105.0,-4931028.0,-227825.0,2348847.0
2024-11-28,2454,92796,79998,0,2198855,541063,14204,-9102,0,-934691,486215,78592,89100,0,3133546,54848,205904.0,197640.0,21669.0,-279190.0,0.0,0.0,300107.0,-6130484.0,374149.0,2649991.0
2024-11-29,2454,116990,32000,0,2338561,125903,100790,-29000,0,-524492,83469,16200,61000,0,2863053,42434,191392.0,297350.0,-42631.0,-252191.0,0.0,0.0,-3199754.0,-5430316.0,683215.0,2124516.0
2024-12-02,2454,70161,28026,0,3145804,296918,3474,12026,0,2250565,151199,66687,16000,0,895239,145719,216088.0,397263.0,-104505.0,-225165.0,0.0,0.0,-639401.0,-2176461.0,893188.0,2033755.0
2024-12-03,2454,43418,135666,0,3095061,410000,-69870,-6334,0,389240,-124531,113288,142000,0,2705821,534531,162016.0,423427.0,-61810.0,-190699.0,0.0,0.0,346354.0,-607518.0,707058.0,1405234.0
2024-12-04,2454,59186,74458,0,3043668,66300,24770,-57542,0,600984,-446728,34416,132000,0,2442684,513028,73368.0,458419.0,-89952.0,-255241.0,0.0,0.0,1781606.0,-157652.0,149624.0,634450.0
2024-12-05,2454,78688,132300,0,2999079,99000,43413,94300,0,1585381,-374437,35275,38000,0,1413698,473437,102577.0,513028.0,13450.0,-182913.0,0.0,0.0,4301678.0,1583356.0,-711028.0,235540.0
2024-12-06,2454,55397,91000,0,2005389,79000,-5670,44000,0,-40643,-396608,61067,47000,0,2046032,475608,-3883.0,527147.0,86450.0,-135413.0,0.0,0.0,4785527.0,2941215.0,-1191105.0,-161962.0
2024-12-09,2454,58709,23566,0,3199423,263000,40283,4566,0,761774,145527,18426,19000,0,2437649,117473,32926.0,547275.0,78990.0,-85775.0,0.0,0.0,3296736.0,4160095.0,-1196777.0,-165309.0
2024-12-10,2454,139156,130991,0,5557141,85500,54146,37991,0,1635473,-241437,85010,93000,0,3921668,326937,156942.0,555277.0,123315.0,-9791.0,0.0,0.0,4542969.0,6876723.0,-1313683.0,-615618.0
2024-12-11,2454,96998,46000,0,3864109,529027,18076,-21000,0,-1075992,421231,78922,67000,0,4940101,107796,150248.0,535341.0,159857.0,25209.0,0.0,0.0,2865993.0,6817767.0,-445724.0,-488736.0
2024-12-12,2454,92359,279630,0,4674128,309500,35669,252630,0,1558620,129367,56690,27000,0,3115508,180133,142504.0,532010.0,318187.0,365839.0,0.0,0.0,2839232.0,8582807.0,58080.0,-644112.0
2024-12-13,2454,130167,110998,0,3894076,270815,78464,56998,0,1212404,-50289,51703,54000,0,2681672,321104,226638.0,557785.0,331185.0,459837.0,0.0,0.0,4092279.0,8863982.0,404399.0,-492867.0
2024-12-16,2454,89492,140000,0,3324110,273500,-5782,35744,0,-1039543,29302,95274,104256,0,4363653,244198,180573.0,556219.0,362363.0,534581.0,0.0,0.0,2290962.0,8089721.0,288174.0,-473801.0
2024-12-17,2454,133679,149569,0,6246914,315264,22634,35269,0,2261344,-438586,111045,114300,0,3985570,753850,149061.0,531435.0,359641.0,562850.0,0.0,0.0,2916833.0,9371753.0,91025.0,-930833.0
2024-12-18,2454,85428,126937,0,3298872,407687,-31038,58886,0,-692626,-236269,116466,68051,0,3991498,643956,99947.0,492324.0,439527.0,524736.0,0.0,0.0,3300199.0,9093903.0,-566475.0,-1090400.0
2024-12-19,2454,111254,84000,0,3762596,293719,87733,-28000,0,326136,-670757,23521,112000,0,3436460,964476,152011.0,602996.0,158897.0,512203.0,0.0,0.0,2067715.0,9508732.0,-1366599.0,-1645398.0
2024-12-20,2454,50375,50000,0,2887999,352127,11010,-87000,0,-254240,-788118,39365,137000,0,3142239,1140245,84557.0,498704.0,14899.0,389903.0,0.0,0.0,601071.0,6279123.0,-2104428.0,-2207919.0
2024-12-23,2454,94258,81000,0,2573811,159781,85432,67000,0,693937,-771219,8826,14000,0,1879874,931000,175771.0,605358.0,46155.0,383003.0,0.0,0.0,2334551.0,7282848.0,-2904949.0,-2920364.0
2024-12-24,2454,35597,113369,0,1554131,284000,-2514,85000,0,774372,-834000,38111,28369,0,779759,1118000,150623.0,618642.0,95886.0,517032.0,0.0,0.0,847579.0,8653735.0,-3300363.0,-3815963.0
2024-12-25,2454,43826,171843,0,1072481,175000,38528,136843,0,557047,-680000,5298,35000,0,515434,855000,220189.0,543752.0,173843.0,683275.0,0.0,0.0,2097252.0,10045050.0,-3744094.0,-4606669.0
2024-12-26,2454,53366,46000,0,1248687,225000,22301,31000,0,944136,-588772,31065,15000,0,304551,813772,154757.0,551849.0,232843.0,723377.0,0.0,0.0,2715252.0,11923877.0,-3662109.0,-5681656.0
2024-12-27,2454,37521,90986,0,1412855,246000,18846,32986,0,650785,-12960,18675,58000,0,762070,258960,162593.0,469905.0,352829.0,785363.0,0.0,0.0,3620277.0,13099154.0,-2886951.0,-5778085.0
2024-12-30,2454,90175,40000,0,1095280,354752,-39171,21000,0,-685342,212802,129346,19000,0,1780622,141950,37990.0,427260.0,306829.0,794337.0,0.0,0.0,2240998.0,10163247.0,-1902930.0,-5716482.0
2024-12-31,2454,61233,139995,0,1035041,429066,40902,105398,0,-934134,263019,20331,34597,0,1969175,166047,81406.0,538032.0,327227.0,906069.0,0.0,0.0,532492.0,8839873.0,-805911.0,-5328932.0
2025-01-02,2454,362613,83667,0,1594531,71344,50892,-422138,0,-1951496,-430988,311721,505805,0,3546027,502332,93770.0,564154.0,-231754.0,541473.0,0.0,0.0,-1976051.0,6287393.0,-556899.0,-5313192.0
2025-01-03,2454,78313,72000,0,4423165,47000,41575,-147599,0,480319,-139000,36738,219599,0,3942846,186000,113044.0,562316.0,-410353.0,299574.0,0.0,0.0,-2439868.0,5182331.0,-107127.0,-5077755.0
2025-01-06,2454,130335,176182,0,5685697,375000,82447,10182,0,3640794,101672,47888,166000,0,2044903,273328,176645.0,650433.0,-433157.0,265756.0,0.0,0.0,550141.0,8863768.0,7505.0,-4579475.0
2025-01-07,2454,238650,432413,0,7754838,252000,179874,335413,0,3997646,-219437,58776,97000,0,3757192,471437,395690.0,790024.0,-118744.0,596603.0,0.0,0.0,5233129.0,12099640.0,-424734.0,-4944439.0
2025-01-08,2454,123219,131000,0,5973370,323000,-17029,-147000,0,291467,41342,140248,278000,0,5681903,281658,337759.0,718849.0,-371142.0,411612.0,0.0,0.0,6458730.0,10755634.0,-646411.0,-4661660.0
2025-01-09,2454,123651,63000,0,4159246,147000,28816,2800,0,559483,-58425,94835,60200,0,3599763,205425,315683.0,729589.0,53796.0,435412.0,0.0,0.0,8969709.0,12391109.0,-273848.0,-5141316.0
2025-01-10,2454,117100,35000,0,4159153,752000,-15628,-60000,0,1125877,593771,132728,95000,0,3033276,158229,258480.0,678292.0,141395.0,122782.0,0.0,0.0,9615267.0,11958366.0,458923.0,-4676912.0
2025-01-13,2454,418372,220000,0,3337461,280126,47247,-69548,0,-2974251,77782,371125,289548,0,6311712,202344,223280.0,647075.0,61665.0,-3764.0,0.0,0.0,3000222.0,7771711.0,435033.0,-4548841.0
2025-01-14,2454,106400,60000,0,2717717,270000,50780,-22336,0,-1042211,253032,55620,82336,0,3759928,16968,94186.0,703637.0,-296084.0,-61844.0,0.0,0.0,-2039635.0,7769043.0,907502.0,-4325111.0
2025-01-15,2454,79316,47647,0,4618133,287000,-195797,-274380,0,1547721,178891,275113,322027,0,3070412,108109,-84582.0,485206.0,-423464.0,-371493.0,0.0,0.0,-783381.0,7055420.0,1045051.0,-3707634.0
2025-01-16,2454,121447,253490,0,3429588,353348,48082,161400,0,637692,12729,73365,92090,0,2791896,340619,-65316.0,564326.0,-264864.0,-268979.0,0.0,0.0,-705172.0,8385738.0,1116205.0,-3458636.0
2025-01-17,2454,98780,41000,0,2259370,199000,53859,-36932,0,-1046139,111248,44921,77932,0,3305509,87752,4171.0,530452.0,-241796.0,-277911.0,0.0,0.0,-2877188.0,7013463.0,633682.0,-2676631.0
2025-01-20,2454,48217,14000,0,2405418,113000,43249,-3000,0,97820,52282,4968,17000,0,2307598,60718,173.0,562691.0,-175248.0,-193911.0,0.0,0.0,194883.0,7365523.0,608182.0,-1836231.0
2025-01-21,2454,35597,25000,0,3116534,251900,-19028,-10900,0,1114044,74738,54625,35900,0,2002490,177162,-69635.0,458231.0,-163812.0,-271811.0,0.0,0.0,2351138.0,7785630.0,429888.0,-990274.0
2025-01-22,2454,56005,72325,0,3958071,327000,34266,58925,0,241387,180198,21739,13400,0,3716684,146802,160428.0,495011.0,169493.0,-297886.0,0.0,0.0,1044804.0,7252645.0,431195.0,23924.0
2025-02-03,2454,395740,324684,0,12678620,1654781,217519,39684,0,2389232,1612638,178221,285000,0,10289388,42143,329865.0,674002.0,47777.0,-395045.0,0.0,0.0,2796344.0,9084830.0,2031104.0,2316562.0
2025-02-04,2454,106624,48300,0,4419380,759200,71069,29300,0,-485023,484346,35555,19000,0,4904403,274854,347075.0,722770.0,114009.0,-396745.0,0.0,0.0,3357460.0,7655671.0,2404202.0,3389680.0
2025-02-05,2454,67850,120600,0,5758628,909000,20287,91600,0,2107495,800766,47563,29000,0,3651133,108234,324113.0,724211.0,208609.0,-338131.0,0.0,0.0,5367135.0,9112381.0,3152686.0,4203406.0
2025-02-06,2454,77896,144076,0,4068838,475913,28281,86773,0,-518149,223144,49615,57303,0,4586987,252769,371422.0,791663.0,306282.0,-272358.0,0.0,0.0,3734942.0,9279574.0,3301092.0,4213748.0
2025-02-07,2454,67130,493250,0,3131508,88000,41378,382150,0,-821154,-109248,25752,111100,0,3952662,197248,378534.0,792139.0,629507.0,4394.0,0.0,0.0,2672401.0,9392554.0,3011646.0,3841481.0
2025-02-10,2454,129965,126077,0,2361644,353826,15127,43975,0,-3413947,184860,114838,82102,0,5775591,168966,176142.0,756374.0,633798.0,470507.0,0.0,0.0,-3130778.0,7930103.0,1583868.0,4457329.0
2025-02-11,2454,47578,24276,0,4875686,263000,21528,-63070,0,770322,58444,26050,87346,0,4105364,204556,126601.0,736327.0,541428.0,555036.0,0.0,0.0,-1875433.0,8220106.0,1157966.0,4654773.0
2025-02-12,2454,110113,163250,0,3709939,267000,-5382,109766,0,1000554,-2129866,115495,53484,0,2709385,2396866,100932.0,648498.0,559594.0,654620.0,0.0,0.0,-2982374.0,5579866.0,-1772666.0,2423235.0
2025-02-13,2454,53298,81000,0,2669213,625913,15005,-10767,0,1081490,492205,38293,91767,0,1587723,133708,87656.0,483629.0,462054.0,308440.0,0.0,0.0,-1382735.0,2663710.0,-1503605.0,3134877.0
2025-02-14,2454,30812,8000,0,2459510,69913,-30872,-23318,0,350659,-775913,61684,31318,0,2108851,845826,15406.0,469786.0,56586.0,432122.0,0.0,0.0,-210922.0,2722902.0,-2170270.0,2317622.0
2025-02-17,2454,44094,27900,0,4029447,2117913,-15655,-49834,0,191506,1880409,59749,77734,0,3837941,237504,-15376.0,425315.0,-37223.0,379488.0,0.0,0.0,3394531.0,2354925.0,-474721.0,4256456.0
2025-02-18,2454,16016,47250,0,2737890,573000,-35216,8635,0,-131946,299469,51232,38615,0,2869836,273531,-72120.0,405727.0,34482.0,448123.0,0.0,0.0,2492263.0,1097102.0,-233696.0,3962154.0
2025-02-19,2454,11393,16998,0,3460347,80000,-86384,-160328,0,1283893,-361920,97777,177326,0,2176454,441920,-153122.0,272096.0,-235612.0,357343.0,0.0,0.0,2775602.0,5355246.0,1534250.0,3522452.0
2025-02-20,2454,109801,65072,0,2878974,33000,68961,18364,0,-777991,-1671426,40840,46708,0,3656965,1704426,-99166.0,290277.0,-206481.0,398043.0,0.0,0.0,916121.0,5619466.0,-629381.0,1597994.0
2025-02-21,2454,110634,57000,0,3454464,40000,80791,44042,0,1355002,-1620959,29843,12958,0,2099462,1660959,12497.0,566865.0,-139121.0,716465.0,0.0,0.0,1920464.0,5426747.0,-1474427.0,-201856.0
2025-02-24,2454,78984,16244,0,2689488,2044000,37622,-61279,0,330863,1820149,41362,77523,0,2358625,223851,65774.0,556405.0,-150566.0,493786.0,0.0,0.0,2059821.0,5119918.0,-1534687.0,1605564.0
2025-02-25,2454,99414,24000,0,4810148,1153876,-6948,-88892,0,-321531,931435,106362,112892,0,5131679,222441,94042.0,495598.0,-248093.0,441826.0,0.0,0.0,1870236.0,5844526.0,-902721.0,2425751.0
2025-02-26,2454,51467,34000,0,5951510,102526,-19570,-2000,0,1861918,-672755,71037,36000,0,4089592,775281,160856.0,432779.0,-89765.0,442826.0,0.0,0.0,2448261.0,7608624.0,-1213556.0,1700714.0
2025-02-27,2454,87013,23378,0,7061966,221876,45978,-8063,0,-361580,-2118090,41035,31441,0,7423546,2339966,137873.0,497785.0,-116192.0,445663.0,0.0,0.0,2864672.0,6133000.0,-1660220.0,-492114.0
2025-03-03,2454,522223,99250,0,4665755,1011382,184023,1993,0,-4120947,889024,338200,97257,0,8786702,122358,241105.0,647542.0,-158241.0,388731.0,0.0,0.0,-2611277.0,1770666.0,849763.0,216712.0
2025-03-04,2454,170150,88000,0,4150936,1090876,100663,-28144,0,-522351,913736,69487,116144,0,4673287,177140,304146.0,530686.0,-125106.0,320903.0,0.0,0.0,-3464491.0,-1140917.0,-56650.0,-482190.0
2025-03-05,2454,38965,76250,0,3110733,681000,7278,4722,0,-875118,555825,31687,71528,0,3985851,125175,318372.0,466895.0,-31492.0,296325.0,0.0,0.0,-4018078.0,-1531012.0,-432260.0,-410711.0
2025-03-06,2454,39493,16000,0,907549,329000,1621,-29784,0,-823737,177667,37872,45784,0,1731286,151333,339563.0,448229.0,-59276.0,174941.0,0.0,0.0,-6703733.0,-4462244.0,418162.0,-1033810.0
2025-03-07,2454,203162,60250,0,1668690,665000,36032,-33214,0,-2127159,439155,167130,93464,0,3795849,225845,329617.0,455980.0,-84427.0,54954.0,0.0,0.0,-8469312.0,-6071254.0,2975407.0,-817799.0
2025-03-10,2454,149366,62250,0,3216333,593876,57441,-27748,0,-3385579,322420,91925,89998,0,6601912,271456,203035.0,472043.0,-114168.0,-354944.0,0.0,0.0,-7733944.0,-8635679.0,2408803.0,-386131.0
2025-03-11,2454,103160,215000,0,4668076,916629,41566,-145828,0,-1745439,730273,61594,360828,0,6413515,186356,143938.0,498482.0,-231852.0,-544747.0,0.0,0.0,-8957032.0,-6967171.0,2225340.0,159282.0
2025-03-12,2454,48672,95600,0,4283720,729000,22187,14100,0,-1330383,627959,26485,81500,0,5614103,101041,158847.0,499141.0,-222474.0,-467577.0,0.0,0.0,-9412297.0,-9067876.0,2297474.0,728797.0
2025-03-13,2454,88098,12400,0,3272385,297000,15362,-60600,0,-1022400,133280,72736,73000,0,4294785,163720,172588.0,519885.0,-253290.0,-637943.0,0.0,0.0,-9610960.0,-11090830.0,2253087.0,2991943.0
2025-03-14,2454,111869,52900,0,3708806,732876,20974,-25100,0,248497,472115,90895,78000,0,3460309,260761,157530.0,525854.0,-245176.0,-652276.0,0.0,0.0,-7235304.0,-11923823.0,2286047.0,2971853.0
2025-03-17,2454,56222,9700,0,3360846,356000,25797,-87300,0,435519,218562,30425,97000,0,2925327,137438,125886.0,582523.0,-304728.0,-716258.0,0.0,0.0,-3414206.0,-11838963.0,2182189.0,3966328.0
2025-03-18,2454,192115,99076,0,5417097,2018900,18967,-117321,0,1102721,1188159,173148,216397,0,4314376,830741,103287.0,617145.0,-276221.0,-783745.0,0.0,0.0,-566046.0,-10927748.0,2640075.0,3274078.0
2025-03-19,2454,166946,105001,0,4213797,440000,107397,-361997,0,580597,-152154,59549,466998,0,3633200,592154,188497.0,759758.0,-652318.0,-1154377.0,0.0,0.0,1344934.0,-10215205.0,1859962.0,2822455.0
2025-03-20,2454,68935,321121,0,3177174,277000,43986,308752,0,-193867,-275998,24949,12369,0,3371041,552998,217121.0,890128.0,-282966.0,-685297.0,0.0,0.0,2173467.0,-11692965.0,1450684.0,2908377.0
2025-03-21,2454,55474,40300,0,2913697,200847,33316,19000,0,164670,-429906,22158,21300,0,2749027,630753,229463.0,854483.0,-238866.0,-684661.0,0.0,0.0,2089640.0,-10750304.0,548663.0,4149897.0
2025-03-24,2454,47600,60100,0,2307089,425000,18756,-57200,0,797125,-195002,28844,117300,0,1509964,620002,222422.0,792448.0,-208766.0,-785903.0,0.0,0.0,2451246.0,-11308181.0,135099.0,5575854.0
2025-03-25,2454,121850,117196,0,5309117,598000,36661,39946,0,2892128,6512,85189,77250,0,2416989,591488,240116.0,791487.0,-51499.0,-684678.0,0.0,0.0,4240653.0,-8746916.0,-1046548.0,3762217.0
2025-03-26,2454,37440,78050,0,2177008,299000,20184,3900,0,49271,-269234,17256,74150,0,2127737,568234,152903.0,818619.0,314398.0,-591886.0,0.0,0.0,3709327.0,-8376114.0,-1163628.0,2561548.0
2025-03-27,2454,92661,50650,0,2302992,218305,84068,25930,0,-829171,-25054,8593,24720,0,3132163,243359,192985.0,922257.0,31576.0,-563956.0,0.0,0.0,3074023.0,-11067203.0,-912684.0,3209249.0
2025-03-28,2454,193915,121700,0,1685075,510000,159283,32700,0,-1601414,493000,34632,89000,0,3286489,17000,318952.0,1035562.0,45276.0,-523193.0,0.0,0.0,1307939.0,-12307037.0,10222.0,5820339.0
2025-03-31,2454,365225,185000,0,2659453,991879,213083,-46859,0,-2339933,914754,152142,231859,0,4999386,77125,513279.0,1064622.0,55617.0,-572045.0,0.0,0.0,-1829119.0,-10526023.0,1119978.0,5846069.0
2025-04-01,2454,75226,20000,0,3063820,592500,16211,-81903,0,-227288,512500,59015,101903,0,3291108,80000,492829.0,980170.0,-66232.0,-625804.0,0.0,0.0,-4948535.0,-10230960.0,1625966.0,5444833.0
2025-04-02,2454,87000,75500,0,2177568,281000,38659,-9962,0,-954691,268982,48341,85462,0,3132259,12018,511304.0,1011551.0,-80094.0,-640488.0,0.0,0.0,-5952497.0,-10310533.0,2164182.0,5157990.0
2025-04-07,2454,18000,1000,0,987939,0,-33372,-6000,0,458977,0,51372,7000,0,528962,0,393864.0,976558.0,-112024.0,-616704.0,0.0,0.0,-4664349.0,-9027819.0,2189236.0,4980323.0
2025-04-08,2454,620179,268000,0,8346241,715216,315676,52345,0,-2307075,644216,304503,215655,0,10653316,71000,550257.0,1256202.0,-92379.0,-531145.0,0.0,0.0,-5370010.0,-9207735.0,2340452.0,5185384.0
2025-04-09,2454,746249,263079,0,8441883,449532,313925,-272215,0,-1906779,220376,432324,535294,0,10348662,229156,651099.0,1512686.0,-317735.0,-775612.0,0.0,0.0,-4936856.0,-7728935.0,1646074.0,5083340.0
2025-04-10,2454,23982,13000,0,612608,0,19982,13000,0,-207203,-26000,4000,0,0,819811,26000,654870.0,1491102.0,-222832.0,-616784.0,0.0,0.0,-4916771.0,-6190699.0,1107574.0,4327067.0
2025-04-11,2454,251179,221700,0,8287336,827885,91894,81488,0,1119234,816885,159285,140212,0,7168102,11000,708105.0,1560809.0,-131382.0,-549396.0,0.0,0.0,-2842846.0,-3741082.0,1655477.0,4515993.0
2025-04-14,2454,46065,99110,0,8161830,182000,-118148,-735981,0,2454568,56725,164213,835091,0,5707262,125275,623329.0,1427299.0,-861363.0,-1224777.0,0.0,0.0,-847255.0,-264114.0,1712202.0,4439438.0
2025-04-15,2454,47752,79400,0,3262871,148969,-427169,-251989,0,231725,-96723,474921,331389,0,3031146,245692,-119516.0,979156.0,-1165697.0,-1451666.0,0.0,0.0,1691545.0,-280886.0,971263.0,3870600.0
2025-04-16,2454,45955,79800,0,3648835,281000,-460851,-75627,0,104743,191658,506806,155427,0,3544092,89342,-894292.0,492508.0,-969109.0,-1439993.0,0.0,0.0,3703067.0,-611662.0,942545.0,3843696.0
2025-04-17,2454,108273,75000,0,2871816,419500,7655,-33188,0,-1569893,344164,100618,108188,0,4441709,75336,-906619.0,481196.0,-1015297.0,-1355860.0,0.0,0.0,2340377.0,-3284276.0,1312709.0,2999701.0
2025-04-18,2454,37088,46803,0,1810108,94000,4142,23803,0,167485,-48445,32946,23000,0,1642623,142445,-994371.0,377941.0,-1072982.0,-970060.0,0.0,0.0,1388628.0,-3697388.0,447379.0,3103410.0
2025-04-21,2454,110034,2250,0,776729,95200,64231,-99172,0,-463143,-41800,45803,101422,0,1239872,137000,-811992.0,398186.0,-436173.0,-1377984.0,0.0,0.0,-1529083.0,-3966664.0,348854.0,3337608.0
2025-04-22,2454,196559,128000,0,1715860,64000,105687,24068,0,-1030308,-188000,90872,103932,0,2746168,252000,-279136.0,470557.0,-160116.0,-1372916.0,0.0,0.0,-2791116.0,-5161642.0,257577.0,3579514.0
2025-04-23,2454,59788,30200,0,3524372,291000,-24823,-114800,0,965795,253106,84611,145000,0,2558577,37894,156892.0,426978.0,-199289.0,-1430516.0,0.0,0.0,-1930064.0,-4992972.0,319025.0,4027622.0
2025-04-24,2454,64198,48000,0,2658722,74000,13486,13800,0,-2067682,-6545,50712,34200,0,4726404,80545,162723.0,403803.0,-152301.0,-1456662.0,0.0,0.0,-2427853.0,-9952782.0,-31684.0,4014565.0
2025-04-25,2454,50642,29600,0,4720806,51000,-44358,-24900,0,1590722,-314704,95000,54500,0,3130084,365704,114223.0,339261.0,-201004.0,-1485462.0,0.0,0.0,-1004616.0,-8411331.0,-297943.0,3969095.0
2025-04-28,2454,49483,93200,0,1448835,30000,30667,65159,0,-2540388,-76368,18816,28041,0,3989223,106368,80659.0,285860.0,-36673.0,-1446233.0,0.0,0.0,-3081861.0,-10122548.0,-332511.0,3917781.0
2025-04-29,2454,73397,56071,0,3100469,45000,47871,-1361,0,-431556,-436098,25526,57432,0,3532025,481098,22843.0,174448.0,-62102.0,-1480294.0,0.0,0.0,-2483109.0,-8952690.0,-580609.0,2988683.0
2025-04-30,2454,22716,18600,0,2809100,69000,-27524,-41274,0,-946450,-362721,50240,59874,0,3755550,431721,20142.0,-66159.0,11424.0,-1474709.0,0.0,0.0,-4395354.0,-7559207.0,-1196436.0,1711208.0
2025-05-02,2454,213642,98100,0,4410814,17000,-35287,-100252,0,-6248183,-1359365,248929,198352,0,10658997,1376365,-28631.0,-117657.0,-102628.0,-1493058.0,0.0,0.0,-8575855.0,-13580102.0,-2549256.0,-160657.0
2025-05-05,2454,16300,45100,0,3531722,53000,-41359,-33948,0,1363909,-456867,57659,79048,0,2167813,509867,-25632.0,-197675.0,-111676.0,-1517044.0,0.0,0.0,-8802668.0,-11261502.0,-2691419.0,-886506.0
2025-05-06,2454,38000,7000,0,3574911,89000,-90458,-314939,0,-179635,-940757,128458,321939,0,3754546,1029757,-146757.0,-254761.0,-491774.0,-1825983.0,0.0,0.0,-6441915.0,-11900114.0,-3555808.0,-1827263.0
2025-05-07,2454,22000,48000,0,3568208,28000,-56586,-133399,0,691667,-458066,78586,181399,0,2876541,486066,-251214.0,-627023.0,-623812.0,-2011727.0,0.0,0.0,-5318692.0,-8901372.0,-3577776.0,-2929545.0
2025-05-08,2454,41369,40000,0,3156289,44000,7718,-109000,0,-207575,-173137,33651,149000,0,3363864,217137,-215972.0,-933230.0,-691538.0,-1848512.0,0.0,0.0,-4579817.0,-7202168.0,-3388192.0,-3323058.0
2025-05-09,2454,16874,34010,0,3616669,31000,-4849,-27990,0,271587,-32288,21723,62000,0,3345082,63288,-185534.0,-958061.0,-619276.0,-1889502.0,0.0,0.0,1939953.0,-6723378.0,-2061115.0,-3329346.0
2025-05-12,2454,15000,21000,0,1570356,24000,-27119,-33010,0,-1126506,-251561,42119,54010,0,2696862,275561,-171294.0,-1077074.0,-618338.0,-2004000.0,0.0,0.0,-550462.0,-8969118.0,-1855809.0,-4397792.0
2025-05-13,2454,76532,153015,0,6415555,56000,-30690,125015,0,1188691,-271805,107222,28000,0,5226864,327805,-111526.0,-989616.0,-178384.0,-1143004.0,0.0,0.0,817864.0,-10234995.0,-1186857.0,-4726322.0
2025-05-14,2454,15072,156000,0,3180679,16000,-9670,41985,0,-272070,-829263,24742,114015,0,3452749,845263,-64610.0,-572117.0,-3000.0,-849030.0,0.0,0.0,-145873.0,-10738790.0,-1558054.0,-5458862.0
2025-05-15,2454,20503,18000,0,3893142,120000,-16976,-127000,0,1368714,4106,37479,145000,0,2524428,115894,-89304.0,-128242.0,-21000.0,-900403.0,0.0,0.0,1430416.0,-9474819.0,-1380811.0,-5646414.0
2025-05-16,2454,7880,5000,0,1769616,44000,-14934,-25000,0,-48745,-688697,22814,30000,0,1818361,732697,-99389.0,-150831.0,-18010.0,-892215.0,0.0,0.0,1110084.0,-7953671.0,-2037220.0,-6679275.0
2025-05-19,2454,113414,61000,0,1495257,4000,-26662,8291,0,-2687084,-912307,140076,52709,0,4182341,916307,-98932.0,-181635.0,23291.0,-907727.0,0.0,0.0,-450494.0,-10808240.0,-2697966.0,-7543137.0
2025-05-20,2454,15389,77000,0,3453137,47000,-26507,-32000,0,747489,-563039,41896,109000,0,2705648,610039,-94749.0,-272373.0,-133724.0,-840555.0,0.0,0.0,-891696.0,-9597608.0,-2989200.0,-8064376.0
2025-05-21,2454,95973,10000,0,2664718,32000,35170,-157000,0,1089783,-570469,60803,167000,0,1574935,602469,-49909.0,-342890.0,-332709.0,-1021623.0,0.0,0.0,470157.0,-7477517.0,-2730406.0,-8446845.0
2025-05-22,2454,13213,18000,0,1787793,24000,-67559,-99277,0,-120480,-352986,80772,117277,0,1908273,376986,-100492.0,-385626.0,-304986.0,-1006100.0,0.0,0.0,-1019037.0,-8563792.0,-3087498.0,-9052937.0
2025-05-23,2454,8160,2000,0,1811040,9000,-69580,-121129,0,-1162895,-288781,77740,123129,0,2973935,297781,-155138.0,-468692.0,-401115.0,-1141029.0,0.0,0.0,-2133187.0,-7659005.0,-2687582.0,-9335173.0
2025-05-26,2454,20543,22000,0,2583925,19000,-18721,-226999,0,-2771502,-540873,39264,248999,0,5355427,559873,-147197.0,-443055.0,-636405.0,-1343128.0,0.0,0.0,-2217605.0,-12021229.0,-2316148.0,-9561342.0
2025-05-27,2454,21271,27000,0,2375273,500000,14856,-327704,0,-1802458,195085,6415,354704,0,4177731,304915,-105834.0,-458866.0,-932109.0,-1735991.0,0.0,0.0,-4767552.0,-11283299.0,-1558024.0,-9289889.0
2025-05-28,2454,21000,12000,0,4648968,93000,-13416,-39000,0,-1167090,-535390,34416,51000,0,5816058,628390,-154420.0,-520153.0,-814109.0,-1773630.0,0.0,0.0,-7024425.0,-12018833.0,-1522945.0,-9389181.0
2025-05-29,2454,52225,122100,0,12845847,74103,12341,99512,0,-4017997,-396086,39884,22588,0,16863844,470189,-74520.0,-480288.0,-615320.0,-1632844.0,0.0,0.0,-10921942.0,-15090380.0,-1566045.0,-9422546.0
2025-06-02,2454,340443,19000,0,4705585,1063000,14202,-98008,0,-1410062,-1265877,326241,117008,0,6115647,2328877,9262.0,-430799.0,-592199.0,-1630600.0,0.0,0.0,-11169109.0,-10252259.0,-2543141.0,-9329058.0
2025-06-03,2454,51503,62000,0,2758419,772000,8214,30000,0,-642587,333691,43289,32000,0,3401006,438309,36197.0,-381226.0,-335200.0,-1566652.0,0.0,0.0,-9040194.0,-12258755.0,-1668577.0,-8538500.0
2025-06-04,2454,26319,162000,0,5867467,7000,-2175,80000,0,2619709,-4760459,28494,82000,0,3247758,4767459,19166.0,-292943.0,72504.0,-1171713.0,0.0,0.0,-4618027.0,-9459411.0,-6624121.0,-12358202.0
2025-06-05,2454,56396,380100,0,7915181,34000,9601,124965,0,1178121,-5986517,46795,255135,0,6737060,6020517,42183.0,-226756.0,236469.0,-913349.0,0.0,0.0,-2272816.0,-8972957.0,-12075248.0,-17886653.0
2025-06-06,2454,35024,51000,0,7633357,60000,7764,2000,0,5166826,-3862967,27260,49000,0,2466531,3922967,37606.0,-226710.0,138957.0,-802349.0,0.0,0.0,6912007.0,-3598556.0,-15542129.0,-21576483.0
2025-06-09,2454,16000,126000,0,5001506,1000,1804,58000,0,3173726,-3878443,14196,68000,0,1827780,3879443,25208.0,-220057.0,294965.0,-716359.0,0.0,0.0,11495795.0,-696417.0,-18154695.0,-25422638.0
2025-06-10,2454,145455,154098,0,7288161,382000,44144,127098,0,5542558,-3267570,101311,27000,0,1745603,3649570,61138.0,-148794.0,392063.0,-556251.0,0.0,0.0,17680940.0,5972647.0,-21755956.0,-28438647.0
2025-06-11,2454,20965,69000,0,6418544,332000,-2617,33000,0,1822030,-3879871,23582,36000,0,4596514,4211871,60696.0,-120721.0,345063.0,-648266.0,0.0,0.0,16883261.0,6605986.0,-20875368.0,-32046713.0
2025-06-12,2454,17000,80000,0,5971323,141000,-1423,-51000,0,1272483,-4247326,18423,131000,0,4698840,4388326,49672.0,-112474.0,169098.0,-741251.0,0.0,0.0,16977623.0,8150539.0,-19136177.0,-35464776.0
2025-06-13,2454,32660,22000,0,3207849,217000,17936,-93125,0,-3407069,5054,14724,115125,0,6614918,211946,59844.0,-77562.0,73973.0,-707376.0,0.0,0.0,8403728.0,3374756.0,-15268156.0,-35463828.0
2025-06-16,2454,41234,42000,0,1799741,0,-12975,-112000,0,-393227,-150143,54209,154000,0,2192968,150143,45065.0,-75603.0,-96027.0,-794376.0,0.0,0.0,4836775.0,3030274.0,-11539856.0,-34925274.0
2025-06-17,2454,81903,272000,0,2948265,111000,49328,178000,0,-231046,-379179,32575,94000,0,3179311,490179,50249.0,387.0,-45125.0,-624667.0,0.0,0.0,-936829.0,5486312.0,-8651465.0,-34392146.0
2025-06-18,2454,85270,99000,0,3903929,103000,6806,-90000,0,768302,-320147,78464,189000,0,3135627,423147,59672.0,33700.0,-168125.0,-682667.0,0.0,0.0,-1990557.0,5507125.0,-5091741.0,-34149254.0
2025-06-19,2454,39548,270000,0,2406933,62000,23298,252000,0,-632119,-512857,16250,18000,0,3039052,574857,84393.0,21828.0,134875.0,-273667.0,0.0,0.0,-3895159.0,3785223.0,-1357272.0,-34091642.0
2025-06-20,2454,47000,142000,0,2617908,214000,22935,92000,0,-729786,-713416,24065,50000,0,3347694,927416,89392.0,112322.0,320000.0,-82390.0,0.0,0.0,-1217876.0,3175917.0,-2075742.0,-34452072.0
2025-06-23,2454,68739,128000,0,2060817,272000,58660,102755,0,-487851,-195831,10079,25245,0,2548668,467831,161027.0,240562.0,534755.0,141494.0,0.0,0.0,-1312500.0,3850961.0,-2121430.0,-34359122.0
2025-06-24,2454,21049,253000,0,2144348,204000,9126,242000,0,-338565,-34682,11923,11000,0,2482913,238682,120825.0,268409.0,598755.0,610493.0,0.0,0.0,-1420019.0,6283898.0,-1776933.0,-33852931.0
2025-06-25,2454,59294,135200,0,4053376,350000,28766,113200,0,1551070,36087,30528,22000,0,2502306,313913,142785.0,282319.0,801955.0,1051397.0,0.0,0.0,-637251.0,9637426.0,-1420699.0,-34011929.0
2025-06-26,2454,68000,226000,0,2590188,312000,45579,161000,0,-984896,-15964,22421,65000,0,3575084,327964,165066.0,341314.0,710955.0,1251397.0,0.0,0.0,-990028.0,9819620.0,-923806.0,-33492503.0
2025-06-27,2454,34363,220000,0,3397197,111000,-20457,62525,0,1052667,-1292156,54820,157475,0,2344530,1403156,121674.0,308516.0,681480.0,1214410.0,0.0,0.0,792425.0,14890284.0,-1502546.0,-34388573.0
2025-06-30,2454,39000,376000,0,3577883,152649,22027,336600,0,-1819405,-1402623,16973,39400,0,5397288,1555272,85041.0,316341.0,915325.0,1649018.0,0.0,0.0,-539129.0,14480941.0,-2709338.0,-34525319.0
2025-07-01,2454,39764,260000,0,5501030,378379,7582,231700,0,2098325,-667946,32182,28300,0,3402705,1046325,83497.0,315709.0,905025.0,1850718.0,0.0,0.0,1897761.0,17221853.0,-3342602.0,-35526956.0
2025-07-02,2454,8907,311100,0,4359980,254000,-7097,289100,0,317883,-335709,16004,22000,0,4042097,589709,47634.0,310787.0,1080925.0,2059818.0,0.0,0.0,664574.0,14920027.0,-3714398.0,-31102206.0
2025-07-03,2454,39000,78100,0,6197651,80000,-18200,-560600,0,3292858,-5583911,57200,638700,0,2904793,5663911,-16145.0,282986.0,359325.0,1374253.0,0.0,0.0,4942328.0,17034764.0,-9282345.0,-30699600.0
2025-07-04,2454,107855,49300,0,4824612,145000,22325,5300,0,3731683,-1356203,85530,44000,0,1092929,1501203,26637.0,297547.0,302100.0,1377553.0,0.0,0.0,7621344.0,15599621.0,-9346392.0,-28192836.0
2025-07-07,2454,37000,15000,0,1925806,174422,16118,-52700,0,-466006,-977594,20882,67700,0,2391812,1152016,20728.0,311861.0,-87200.0,1266853.0,0.0,0.0,8974743.0,11959889.0,-8921363.0,-25291987.0
2025-07-08,2454,19000,21000,0,1404538,292284,17519,6000,0,-583825,172284,1481,15000,0,1988363,120000,30665.0,285236.0,-312900.0,1145755.0,0.0,0.0,6292593.0,5833506.0,-8081133.0,-21852133.0
2025-07-09,2454,334389,191099,0,8357936,991000,6911,56099,0,5284049,726985,327478,135000,0,3073887,264015,44673.0,294764.0,-545901.0,1168854.0,0.0,0.0,11258759.0,9295525.0,-7018439.0,-17245277.0
2025-07-10,2454,44599,55097,0,6603347,1073000,-37181,-148101,0,1544868,784841,81780,203198,0,5058479,288159,25692.0,259006.0,-133402.0,1071753.0,0.0,0.0,9510769.0,9567910.0,-649687.0,-12213110.0
2025-07-11,2454,35106,27392,0,6293097,332000,-37348,-195608,0,639303,103751,72454,223000,0,5653794,228249,-33981.0,203722.0,-334310.0,969270.0,0.0,0.0,6418389.0,13614282.0,810267.0,-12114413.0
2025-07-14,2454,65268,37432,0,3292864,274000,34725,-189568,0,-469497,117440,30543,227000,0,3762361,156560,-15374.0,251422.0,-471178.0,891702.0,0.0,0.0,6414898.0,13538012.0,1905301.0,-11846830.0
2025-07-15,2454,34533,43200,0,2512715,56000,23907,21200,0,-509285,-73646,10626,22000,0,3022000,129646,-8986.0,226001.0,-455978.0,734902.0,0.0,0.0,6489438.0,13259773.0,1659371.0,-11541297.0
2025-07-16,2454,58220,44999,0,3261526,36308,25761,-101795,0,342726,-107604,32459,146794,0,2918800,143912,9864.0,244956.0,-613872.0,723107.0,0.0,0.0,1548115.0,12834197.0,824782.0,-11328754.0
2025-07-17,2454,67445,90000,0,2472755,37267,53587,43500,0,-1170856,-442741,13858,46500,0,3643611,480008,100632.0,275245.0,-422271.0,514607.0,0.0,0.0,-1167609.0,12295460.0,-402800.0,-11258638.0
2025-07-18,2454,54519,41282,0,3680709,22000,34863,-13718,0,1773828,-73665,19656,55000,0,1906881,95665,172843.0,287173.0,-240381.0,408889.0,0.0,0.0,-33084.0,14799074.0,-580216.0,-10618887.0
2025-07-21,2454,130987,38350,0,2529691,76000,87728,-1650,0,-68808,-145155,43259,40000,0,2598499,221155,225846.0,316241.0,-52463.0,304484.0,0.0,0.0,367605.0,15218117.0,-842811.0,-10568211.0
2025-07-22,2454,132133,62587,0,5042853,123317,-39400,-23413,0,2588209,-194035,171533,86000,0,2454644,317352,162539.0,267715.0,-97076.0,39071.0,0.0,0.0,3465099.0,18144891.0,-963200.0,-10727564.0
2025-07-23,2454,32935,116000,0,2315569,253000,12099,111000,0,-249331,-40000,20836,5000,0,2564900,293000,148877.0,251048.0,115719.0,36871.0,0.0,0.0,2873042.0,16344490.0,-895596.0,-10803651.0
2025-07-24,2454,37101,30615,0,2916392,70000,34777,19615,0,365181,-394634,2324,11000,0,2551211,464634,130067.0,240246.0,91834.0,-104514.0,0.0,0.0,4409079.0,17694567.0,-847489.0,-11182321.0
2025-07-25,2454,20356,28500,0,3391433,603000,1932,-16500,0,1786658,-86000,18424,45000,0,1604775,689000,97136.0,262635.0,89052.0,-183539.0,0.0,0.0,4421909.0,18428558.0,-859824.0,-9976165.0
2025-07-28,2454,319010,96000,0,2551840,434000,197663,41040,0,-610129,-394146,121347,54960,0,3161969,828146,207071.0,438271.0,131742.0,-479099.0,0.0,0.0,3880588.0,19637834.0,-1108815.0,-8967688.0
2025-07-29,2454,360871,219000,0,4026556,418000,310810,113400,0,-1420887,-266889,50061,105600,0,5447443,684889,557281.0,741499.0,268555.0,-597399.0,0.0,0.0,-128508.0,16118622.0,-1181669.0,-8566631.0
2025-07-30,2454,175119,94000,0,3512439,374000,140495,65000,0,266004,-265010,34624,29000,0,3246435,639010,685677.0,889091.0,222555.0,-821499.0,0.0,0.0,386827.0,16066743.0,-1406679.0,-8495932.0
2025-07-31,2454,112378,121000,0,4874218,211000,52563,35001,0,-1124392,-644386,59815,85999,0,5998610,855386,703463.0,959854.0,237941.0,-225898.0,0.0,0.0,-1102746.0,11649493.0,-1656431.0,-3556407.0
2025-08-01,2454,210915,44000,0,2111751,64000,55117,10000,0,-2054504,-61091,155798,34000,0,4166255,125091,756648.0,992646.0,264441.0,-221198.0,0.0,0.0,-4943908.0,5863306.0,-1631522.0,-2261295.0
2025-08-04,2454,88165,6000,0,1878548,80000,33765,-591334,0,-966926,-203766,54400,597334,0,2845474,283766,592750.0,1010293.0,-367933.0,-759832.0,0.0,0.0,-5300705.0,5362386.0,-1441142.0,-1487467.0
2025-08-05,2454,16089,10000,0,1020136,38000,-1055,-133125,0,-1224680,-113482,17144,143125,0,2244816,151482,280885.0,991719.0,-614458.0,-898957.0,0.0,0.0,-5104498.0,4721531.0,-1287735.0,-1773233.0
2025-08-06,2454,50408,4000,0,2976293,70000,44708,-655000,0,-204121,-92605,5700,659000,0,3180414,162605,185098.0,1029516.0,-1334458.0,-1610056.0,0.0,0.0,-5574623.0,-766639.0,-1115330.0,-2592823.0
2025-08-07,2454,30040,39500,0,3395047,58590,12075,-432500,0,1006409,13908,17965,472000,0,2388638,44682,144610.0,1078772.0,-1801959.0,-1894455.0,0.0,0.0,-3443822.0,-1305098.0,-457036.0,-3363756.0
2025-08-08,2454,30039,44000,0,2608257,17000,-6826,-23200,0,-1211425,-117338,36865,67200,0,3819682,134338,82667.0,1109294.0,-1835159.0,-1722047.0,0.0,0.0,-2600743.0,-3155826.0,-513283.0,-3584845.0
2025-08-11,2454,24663,37000,0,2268648,43000,12635,15000,0,-24402,-125736,12028,22000,0,2293050,168736,61537.0,1087204.0,-1228825.0,-1517479.0,0.0,0.0,-1658219.0,-2710731.0,-435253.0,-3828021.0
2025-08-12,2454,10619,1000,0,1667070,55782,-3790,-500,0,-210592,-89950,14409,1500,0,1877662,145732,58802.0,1059507.0,-1096200.0,-1539179.0,0.0,0.0,-644131.0,-2412038.0,-411721.0,-3844325.0
2025-08-13,2454,57095,17300,0,5044789,50000,28705,-33037,0,-131017,-1016,28390,50337,0,5175806,51016,42799.0,1062451.0,-474237.0,-1470421.0,0.0,0.0,-571027.0,-2885781.0,-320132.0,-3737737.0
2025-08-14,2454,49219,45000,0,2575034,56100,20194,40000,0,615529,-11491,29025,5000,0,1959505,67591,50918.0,1029058.0,-1737.0,-1473921.0,0.0,0.0,-961907.0,-1099396.0,-345531.0,-3306487.0
2025-08-15,2454,15561,119300,0,1984947,75000,-4762,73300,0,-747030,-134968,20323,46000,0,2731977,209968,52982.0,989433.0,94763.0,-1386903.0,0.0,0.0,-497512.0,-3620254.0,-363161.0,-3367790.0
2025-08-18,2454,76140,85819,0,5321756,371636,3040,71319,0,2436202,325507,73100,14500,0,2885554,46129,43387.0,904745.0,151082.0,-1313934.0,0.0,0.0,1963092.0,-1115244.0,88082.0,-2897128.0
2025-08-19,2454,22626,62375,0,3172214,311318,-35493,375,0,-100189,114839,58119,62000,0,3272403,196479,11684.0,908652.0,151957.0,-1290146.0,0.0,0.0,2073495.0,-3803642.0,292871.0,-2588254.0
2025-08-20,2454,229079,41000,0,3425728,218636,134682,24000,0,-1098663,179157,94397,17000,0,4524391,39479,117661.0,1031235.0,208994.0,-1377146.0,0.0,0.0,1105849.0,-4652974.0,473044.0,-2369097.0
2025-08-21,2454,56683,14400,0,2518958,167318,46247,-10632,0,46196,-46390,10436,25032,0,2472762,213708,143714.0,1042705.0,158362.0,-1407393.0,0.0,0.0,536516.0,-4971959.0,438145.0,-2020853.0
2025-08-22,2454,34802,7300,0,1855166,29000,10692,-16700,0,124484,-75279,24110,24000,0,1730682,104279,159168.0,1051465.0,68362.0,-1407593.0,0.0,0.0,1408030.0,-6634133.0,497834.0,-2010132.0
2025-08-25,2454,46051,159299,0,3640572,111706,23512,146299,0,2015502,29690,22539,13000,0,1625070,82016,179640.0,877314.0,143342.0,-1302334.0,0.0,0.0,987330.0,-4008502.0,202017.0,-1586296.0
2025-08-26,2454,19125,68992,0,2956428,36063,-12004,23638,0,-1044248,-138937,31129,45354,0,4000676,175000,203129.0,554500.0,166605.0,-1392096.0,0.0,0.0,43271.0,-3631863.0,-51759.0,-1458344.0
2025-08-27,2454,7133,113873,0,2167352,39000,-5744,102584,0,383048,-227000,12877,11289,0,1784304,266000,62703.0,408261.0,245189.0,-1354512.0,0.0,0.0,1524982.0,-3514819.0,-457916.0,-1420334.0
2025-08-28,2454,20932,46794,0,2324727,5000,14998,33794,0,126457,-300287,5934,13000,0,2198270,305287,31454.0,370696.0,289615.0,-1355719.0,0.0,0.0,1605243.0,-2263970.0,-711813.0,-1076235.0
2025-08-29,2454,22258,55300,0,1453469,37000,7183,20827,0,-1055680,-417771,15075,34473,0,2509149,454771,27945.0,322762.0,327142.0,-1344892.0,0.0,0.0,425079.0,-1265146.0,-1054305.0,-1432915.0
2025-09-01,2454,38768,43700,0,1796880,254347,18727,-56300,0,-234017,-69653,20041,100000,0,2030897,324000,23160.0,307724.0,124543.0,-809858.0,0.0,0.0,-1824440.0,-532237.0,-1153648.0,-1298802.0
2025-09-02,2454,27660,1100,0,2248616,71000,8348,-900,0,454618,31458,19312,2000,0,1793998,39542,43512.0,317127.0,100005.0,-677633.0,0.0,0.0,-325574.0,1147061.0,-983253.0,-1153862.0
2025-09-03,2454,29536,48663,0,3461642,226000,-5307,12663,0,1370972,197187,34843,36000,0,2090670,28813,43949.0,267112.0,10084.0,-9970.0,0.0,0.0,662350.0,2722154.0,-559066.0,-864070.0
2025-09-04,2454,4533,33100,0,1941012,128000,-8254,20100,0,525770,41992,12787,13000,0,1415242,86008,20697.0,246783.0,-3610.0,442630.0,0.0,0.0,1061663.0,2241515.0,-216787.0,-835986.0
2025-09-05,2454,77054,125300,0,6000225,23000,18977,42300,0,4433847,-70280,58077,83000,0,1566378,93280,32491.0,272586.0,17863.0,508130.0,0.0,0.0,6551190.0,7886787.0,130704.0,-788928.0
2025-09-08,2454,22601,21300,0,3632896,12000,-62876,-131100,0,737389,-56165,85477,152400,0,2895507,68165,-49112.0,197075.0,-56937.0,362030.0,0.0,0.0,7522596.0,8648578.0,144192.0,-719357.0
2025-09-09,2454,206285,400000,0,7699116,42000,135889,344500,0,4793778,-413571,70396,55500,0,2905338,455571,78429.0,336754.0,288463.0,707030.0,0.0,0.0,11861756.0,13652948.0,-300837.0,-1042978.0
2025-09-10,2454,14303,120000,0,3541230,42000,-94248,29000,0,-156278,-308331,108551,91000,0,3697508,350331,-10512.0,213801.0,304800.0,769067.0,0.0,0.0,10334506.0,13627687.0,-806355.0,-1350293.0
2025-09-11,2454,14549,69800,0,2544117,80000,-72384,-12200,0,635841,-184110,86933,82000,0,1908276,264110,-74642.0,121223.0,272500.0,716867.0,0.0,0.0,10444577.0,13647999.0,-1032457.0,-1522912.0
2025-09-12,2454,34647,236800,0,2606672,78000,-6464,203800,0,114386,-208560,41111,33000,0,2492286,286560,-100083.0,119521.0,434000.0,847367.0,0.0,0.0,6125116.0,14509415.0,-1170737.0,-1596504.0
2025-09-15,2454,39980,73107,0,1546317,202000,17416,5107,0,331587,52844,22564,68000,0,1214730,149156,-19791.0,133897.0,570207.0,781155.0,0.0,0.0,5719314.0,12404800.0,-1061728.0,-1869167.0
2025-09-16,2454,144734,226630,0,5213088,755011,56213,117630,0,1959551,469763,88521,109000,0,3253537,285248,-99467.0,225603.0,343337.0,898410.0,0.0,0.0,2885087.0,14464540.0,-178394.0,-1514243.0
2025-09-17,2454,3605,126000,0,2782098,47000,-89265,-156405,0,-342885,-62854,92870,282405,0,3124983,109854,-94484.0,1656.0,157932.0,718005.0,0.0,0.0,2698480.0,15220318.0,67083.0,-1756254.0
2025-09-18,2454,22444,152405,0,1692059,100000,-20844,43205,0,-131257,56439,43288,109200,0,1823316,43561,-42944.0,-65435.0,213337.0,771842.0,0.0,0.0,1931382.0,15042865.0,307632.0,-1653425.0
2025-09-19,2454,328189,204000,0,4103599,250650,48963,-127198,0,-4322738,-438911,279226,331198,0,8426337,689561,12483.0,-27164.0,-117661.0,661344.0,0.0,0.0,-2505742.0,10595643.0,77281.0,-2017057.0
2024-09-23,3035,6000,99362,0,520000,6000,2000,38838,0,106988,-25000,4000,60524,0,413012,31000,2000.0,2000.0,38838.0,38838.0,0.0,0.0,106988.0,106988.0,-25000.0,-25000.0
2024-09-24,3035,4000,195001,0,393050,1000,-22526,22887,0,-591954,1000,26526,172114,0,985004,0,-20526.0,-20526.0,61725.0,61725.0,0.0,0.0,-484966.0,-484966.0,-24000.0,-24000.0
2024-09-25,3035,55531,367052,0,2153228,20000,48531,288930,0,894228,-230000,7000,78122,0,1259000,250000,28005.0,28005.0,350655.0,350655.0,0.0,0.0,409262.0,409262.0,-254000.0,-254000.0
2024-09-26,3035,6000,187000,0,401000,9000,-7225,-23503,0,-737893,9000,13225,210503,0,1138893,0,20780.0,20780.0,327152.0,327152.0,0.0,0.0,-328631.0,-328631.0,-245000.0,-245000.0
2024-09-27,3035,141961,300965,0,1929000,108000,135961,163182,0,115000,107000,6000,137783,0,1814000,1000,156741.0,156741.0,490334.0,490334.0,0.0,0.0,-213631.0,-213631.0,-138000.0,-138000.0
2024-09-30,3035,58039,106960,0,1287163,1000,38348,-127133,0,-316917,-602,19691,234093,0,1604080,1602,193089.0,195089.0,324363.0,363201.0,0.0,0.0,-637536.0,-530548.0,-113602.0,-138602.0
2024-10-01,3035,3000,104000,0,558006,0,-69626,-178398,0,-980994,-41000,72626,282398,0,1539000,41000,145989.0,125463.0,123078.0,184803.0,0.0,0.0,-1026576.0,-1511542.0,-155602.0,-179602.0
2024-10-04,3035,6150,112545,0,713023,0,-13005,-72948,0,117792,-2000,19155,185493,0,595231,2000,84453.0,112458.0,-238800.0,111855.0,0.0,0.0,-1803012.0,-1393750.0,72398.0,-181602.0
2024-10-07,3035,18697,111563,0,697311,0,11610,65239,0,50311,0,7087,46324,0,647000,0,103288.0,124068.0,-150058.0,177094.0,0.0,0.0,-1014808.0,-1343439.0,63398.0,-181602.0
2024-10-08,3035,11000,116250,0,1067062,0,-66309,-86286,0,-411038,-271000,77309,202536,0,1478100,271000,-98982.0,57759.0,-399526.0,90808.0,0.0,0.0,-1540846.0,-1754477.0,-314602.0,-452602.0
2024-10-09,3035,13199,124211,0,1200200,133000,-20461,21172,0,144007,126000,33660,103039,0,1056193,7000,-157791.0,37298.0,-251221.0,111980.0,0.0,0.0,-1079922.0,-1610470.0,-188000.0,-326602.0
2024-10-11,3035,81112,256494,0,1694050,0,72718,176545,0,866046,0,8394,79949,0,828004,0,-15447.0,110016.0,103722.0,288525.0,0.0,0.0,767118.0,-744424.0,-147000.0,-326602.0
2024-10-14,3035,85838,173618,0,1169000,634000,27361,48832,0,-464000,631000,58477,124786,0,1633000,3000,24919.0,137377.0,225502.0,337357.0,0.0,0.0,185326.0,-1208424.0,486000.0,304398.0
2024-10-15,3035,50000,176152,0,1151000,265000,11001,54951,0,-1148000,264000,38999,121201,0,2299000,1000,24310.0,148378.0,215214.0,392308.0,0.0,0.0,-1012985.0,-2356424.0,750000.0,568398.0
2024-10-16,3035,35000,237000,0,506327,1000,-38312,201145,0,-915220,-5978,73312,35855,0,1421547,6978,52307.0,110066.0,502645.0,593453.0,0.0,0.0,-1517167.0,-3271644.0,1015022.0,562420.0
2024-10-17,3035,18000,122000,0,279000,20000,6865,82616,0,-418000,5000,11135,39384,0,697000,15000,79633.0,116931.0,564089.0,676069.0,0.0,0.0,-2079174.0,-3689644.0,894022.0,567420.0
2024-10-18,3035,11000,76000,0,249078,20000,-23522,-160382,0,-1073922,19000,34522,236382,0,1323000,1000,-16607.0,93409.0,227162.0,515687.0,0.0,0.0,-4019142.0,-4763566.0,913022.0,586420.0
2024-10-21,3035,72019,379615,0,2416000,52000,64819,334658,0,1442000,-97000,7200,44957,0,974000,149000,20851.0,158228.0,512988.0,850345.0,0.0,0.0,-2113142.0,-3321566.0,185022.0,489420.0
2024-10-22,3035,40307,60277,0,574000,88000,7218,22543,0,-466486,-177000,33089,37734,0,1040486,265000,17068.0,165446.0,480580.0,872888.0,0.0,0.0,-1431628.0,-3788052.0,-255978.0,312420.0
2024-10-23,3035,3000,40000,0,554050,0,-31424,-74071,0,-297849,-2000,34424,114071,0,851899,2000,23956.0,134022.0,205364.0,798817.0,0.0,0.0,-814257.0,-4085901.0,-252000.0,310420.0
2024-10-24,3035,2000,85170,0,447115,0,-48752,-294208,0,-1758885,-13000,50752,379378,0,2206000,13000,-31661.0,83270.0,-171460.0,465771.0,0.0,0.0,-2155142.0,-5951774.0,-270000.0,322420.0
2024-10-25,3035,10000,399000,0,1106479,150000,-10308,306655,0,-1651521,95000,20308,92345,0,2758000,55000,-18447.0,95488.0,295577.0,749539.0,0.0,0.0,-2732741.0,-7011341.0,-194000.0,416420.0
2024-10-28,3035,3000,76000,0,994115,58000,-15333,7796,0,-65885,-366000,18333,68204,0,1060000,424000,-98599.0,31624.0,-31285.0,468405.0,0.0,0.0,-4240626.0,-7971454.0,-463000.0,280420.0
2024-10-29,3035,8000,367025,0,2889336,3000,-53414,-370074,0,-1062664,-607000,61414,737099,0,3952000,610000,-159231.0,-14565.0,-423902.0,121834.0,0.0,0.0,-4836804.0,-8296225.0,-893000.0,-335580.0
2024-10-30,3035,32255,515657,0,4433594,408000,7146,200009,0,-2768596,290000,25109,315648,0,7202190,118000,-120661.0,-143380.0,-149822.0,158661.0,0.0,0.0,-7307551.0,-11179821.0,-601000.0,-152580.0
2024-11-01,3035,52000,326000,0,3939720,0,30143,126172,0,-449743,-678809,21857,199828,0,4389463,678809,-41766.0,-151585.0,270558.0,411966.0,0.0,0.0,-5998409.0,-11312647.0,-1266809.0,-830787.0
2024-11-04,3035,10500,185093,0,2168329,0,-30574,-165816,0,897659,-944000,41074,350909,0,1270670,944000,-62032.0,-112533.0,-201913.0,424548.0,0.0,0.0,-3449229.0,-9433994.0,-2305809.0,-1733787.0
2024-11-05,3035,19000,46000,0,1164544,4000,11000,-56413,0,165544,-314000,8000,102413,0,999000,318000,-35699.0,-88528.0,-266122.0,441083.0,0.0,0.0,-3217800.0,-9386242.0,-2253809.0,-2045787.0
2024-11-06,3035,30000,233000,0,1382100,2000,14000,125566,0,163095,-181000,16000,107434,0,1219005,183000,31715.0,-86138.0,229518.0,501410.0,0.0,0.0,-1992041.0,-9273458.0,-1827809.0,-2226787.0
2024-11-07,3035,6000,170000,0,753093,1000,-15000,-34886,0,-562912,-140000,21000,204886,0,1316005,141000,9569.0,-34829.0,-5377.0,552810.0,0.0,0.0,213643.0,-9425332.0,-2257809.0,-2095787.0
2024-11-08,3035,2000,176000,0,1552939,0,-4766,9631,0,731777,-1245000,6766,166369,0,821162,1245000,-25340.0,-19134.0,-121918.0,541269.0,0.0,0.0,1395163.0,-8837562.0,-2824000.0,-3466787.0
2024-11-11,3035,4316,70366,0,1598594,4000,-1684,-5780,0,528594,-434000,6000,76146,0,1070000,438000,3550.0,-93536.0,38118.0,358944.0,0.0,0.0,1026098.0,-9175014.0,-2314000.0,-3900787.0
2024-11-12,3035,1000,138000,0,729072,3000,-11419,7103,0,-863928,-406000,12419,130897,0,1593000,409000,-18869.0,-132316.0,101634.0,317215.0,0.0,0.0,-3374.0,-9574942.0,-2406000.0,-4937787.0
2024-11-13,3035,6000,119000,0,869000,6000,4000,20817,0,-685086,5000,2000,98183,0,1554086,1000,-28869.0,-139317.0,-3115.0,283081.0,0.0,0.0,-851555.0,-9112028.0,-2220000.0,-5196787.0
2024-11-14,3035,11000,176999,0,1991000,7000,-7108,67003,0,464000,-174000,18108,109996,0,1527000,181000,-20977.0,-108113.0,98774.0,148939.0,0.0,0.0,175357.0,-7732808.0,-2254000.0,-5364809.0
2024-11-15,3035,14000,124000,0,2194011,0,5662,49947,0,1177011,-543000,8338,74053,0,1017000,543000,-10549.0,-109316.0,139090.0,116270.0,0.0,0.0,620591.0,-6137797.0,-1552000.0,-5912809.0
2024-11-18,3035,15000,160000,0,1081810,16046,3167,39020,0,14393,-59954,11833,120980,0,1067417,76000,-5698.0,-82627.0,183890.0,315672.0,0.0,0.0,106390.0,-5049482.0,-1177954.0,-5991763.0
2024-11-19,3035,57608,232000,0,2462500,4000,54608,110633,0,460491,-61000,3000,121367,0,2002009,65000,60329.0,-92838.0,287420.0,91647.0,0.0,0.0,1430809.0,-6030991.0,-832954.0,-5955763.0
2024-11-20,3035,10100,42000,0,1364486,0,-3900,-12013,0,202834,-60000,14000,54013,0,1161652,60000,52429.0,-103956.0,254590.0,57091.0,0.0,0.0,2318729.0,-5361671.0,-897954.0,-5838763.0
2024-11-21,3035,12000,70000,0,678000,25000,9000,45798,0,-15000,22000,3000,24202,0,693000,3000,68537.0,-63532.0,233385.0,176960.0,0.0,0.0,1839729.0,-5078822.0,-701954.0,-5814763.0
2024-11-22,3035,5000,79000,0,620521,0,-20162,-70370,0,-471,0,25162,149370,0,620992,0,42713.0,-34942.0,113068.0,400798.0,0.0,0.0,662247.0,-3320408.0,-158954.0,-5801763.0
2024-11-25,3035,54000,130408,0,1053329,27000,54000,94408,0,619381,27000,0,36000,0,433948,0,93546.0,29366.0,168456.0,188551.0,0.0,0.0,1267235.0,-1049506.0,-72000.0,-5869763.0
2024-11-26,3035,8000,50000,0,656011,0,-14000,-68561,0,-383406,-1155,22000,118561,0,1039417,1155,24938.0,30699.0,-10738.0,112194.0,0.0,0.0,423338.0,-1367027.0,-12155.0,-5504918.0
2024-11-27,3035,2000,109928,0,481795,0,-20313,-50931,0,-1000205,-2154,22313,160859,0,1482000,2154,8525.0,63800.0,-49656.0,431337.0,0.0,0.0,-779701.0,-1304568.0,45691.0,-4900072.0
2024-11-28,3035,17000,188023,0,1385044,10000,11518,50941,0,602431,-42712,5482,137082,0,782613,52712,11043.0,68172.0,-44513.0,282269.0,0.0,0.0,-162270.0,2066459.0,-19021.0,-5232784.0
2024-11-29,3035,29500,29107,0,1141116,0,20500,-23661,0,505808,-3000,9000,52768,0,635308,3000,51705.0,58529.0,2196.0,132436.0,0.0,0.0,344009.0,3022010.0,-22021.0,-4556975.0
2024-12-02,3035,3000,63000,0,417166,0,-27000,-77942,0,-245834,-75000,30000,140942,0,663000,75000,-29295.0,62103.0,-170154.0,220310.0,0.0,0.0,-521206.0,1878517.0,-124021.0,-3687975.0
2024-12-03,3035,2000,83212,0,903399,0,-4000,3212,0,81899,-136000,6000,80000,0,821500,136000,-19295.0,47103.0,-98381.0,279935.0,0.0,0.0,-55901.0,1794872.0,-258866.0,-3509975.0
2024-12-04,3035,33500,119398,0,1355301,0,32496,117918,0,312301,-13000,1004,1480,0,1043000,13000,33514.0,65599.0,70468.0,272287.0,0.0,0.0,1256605.0,1944078.0,-269712.0,-3341975.0
2024-12-05,3035,172898,159094,0,1416020,0,144898,72868,0,-575532,-83000,28000,86226,0,1991552,83000,166894.0,225497.0,92395.0,380041.0,0.0,0.0,78642.0,1931458.0,-310000.0,-3284975.0
2024-12-06,3035,45380,233728,0,1200304,0,-19933,8525,0,-79290,-2000,65313,225203,0,1279594,2000,126461.0,210330.0,124581.0,378935.0,0.0,0.0,-506456.0,1120391.0,-309000.0,-2041975.0
2024-12-09,3035,111420,361932,0,1241885,0,89048,157168,0,-543415,-2000,22372,204764,0,1785300,2000,242509.0,301062.0,359691.0,541883.0,0.0,0.0,-804037.0,48382.0,-236000.0,-1609975.0
2024-12-10,3035,43050,325541,0,1219058,0,-49618,22276,0,-621237,-2000,92668,303265,0,1840295,2000,196891.0,262863.0,378755.0,557056.0,0.0,0.0,-1507173.0,291073.0,-102000.0,-1205975.0
2024-12-11,3035,39927,70183,0,1063207,0,-22077,-298035,0,220207,0,62004,368218,0,843000,0,142318.0,236786.0,-37198.0,238204.0,0.0,0.0,-1599267.0,1196366.0,-89000.0,-1210975.0
2024-12-12,3035,6130,49035,0,685078,0,-68426,-143137,0,87078,-4237,74556,192172,0,598000,4237,-71006.0,175468.0,-253203.0,28064.0,0.0,0.0,-936657.0,819444.0,-10237.0,-1041212.0
2024-12-13,3035,12525,19929,0,915010,0,5277,-36304,0,405010,-3000,7248,56233,0,510000,3000,-45796.0,175083.0,-298032.0,-58187.0,0.0,0.0,-452357.0,47443.0,-11237.0,-501212.0
2024-12-16,3035,59747,254295,0,2466230,0,39444,54572,0,-1200870,-2000,20303,199723,0,3667100,2000,-95400.0,211360.0,-400628.0,-42635.0,0.0,0.0,-1109812.0,-1167820.0,-11237.0,-443258.0
2024-12-17,3035,178050,946565,0,4863281,144000,101246,465916,0,-1395849,139000,76804,480649,0,6259130,5000,55464.0,257998.0,43012.0,312648.0,0.0,0.0,-1884424.0,-3024160.0,129763.0,-243258.0
2024-12-18,3035,63000,440000,0,1750061,1000,-23833,318589,0,-1355939,1000,86833,121411,0,3106000,0,53708.0,238065.0,659636.0,643250.0,0.0,0.0,-3460570.0,-4582933.0,130763.0,-182258.0
2024-12-19,3035,9000,256000,0,1196193,0,-34639,-97755,0,-508807,-5000,43639,353755,0,1705000,5000,87495.0,194426.0,705018.0,499697.0,0.0,0.0,-4056455.0,-5076740.0,130000.0,-209258.0
2024-12-20,3035,26697,161658,0,1278062,0,6697,-230835,0,-610227,-2000,20000,392493,0,1888289,2000,88915.0,221285.0,510487.0,339232.0,0.0,0.0,-5071692.0,-5686496.0,131000.0,-211258.0
2024-12-23,3035,41086,263590,0,1268975,1000,28437,133954,0,556447,1000,12649,129636,0,712528,0,77908.0,195722.0,589869.0,378778.0,0.0,0.0,-3314375.0,-5749430.0,134000.0,-237258.0
2024-12-24,3035,7000,83000,0,652987,0,-27236,-61853,0,-586909,-2000,34236,144853,0,1239896,2000,-50574.0,182486.0,62100.0,385486.0,0.0,0.0,-2505435.0,-5952933.0,-7000.0,-238103.0
2024-12-25,3035,18099,104341,0,912135,0,-9108,62499,0,695841,-2000,27207,41842,0,216294,2000,-35849.0,193691.0,-193990.0,498916.0,0.0,0.0,-453655.0,-4256887.0,-10000.0,-237949.0
2024-12-26,3035,2000,39000,0,331010,1000,-17876,-92113,0,-220500,-2000,19876,131113,0,551510,3000,-19086.0,164297.0,-188348.0,355862.0,0.0,0.0,-165348.0,-5079818.0,-7000.0,-197237.0
2024-12-27,3035,173655,304862,0,3642120,7000,170565,43927,0,1835180,1000,3090,260935,0,1806940,6000,144782.0,314362.0,86414.0,423450.0,0.0,0.0,2280059.0,-3750446.0,-4000.0,-193237.0
2024-12-30,3035,23346,141000,0,471762,0,-57402,3384,0,-4001238,-4155,80748,137616,0,4473000,4155,58943.0,283960.0,-44156.0,504776.0,0.0,0.0,-2277626.0,-7505850.0,-9155.0,-122392.0
2024-12-31,3035,31512,131000,0,731148,0,20826,5835,0,-658873,-11000,10686,125165,0,1390021,11000,107005.0,308786.0,23532.0,507399.0,0.0,0.0,-2349590.0,-8246622.0,-18155.0,2608.0
2025-01-02,3035,19000,76000,0,381643,2000,-41315,-100567,0,-1507377,0,60315,176567,0,1889020,2000,74798.0,234975.0,-139534.0,288914.0,0.0,0.0,-4552808.0,-10066300.0,-16155.0,15608.0
2025-01-03,3035,14000,92000,0,371330,0,-7670,-28836,0,-1253670,-35000,21670,120836,0,1625000,35000,85004.0,82407.0,-76257.0,187210.0,0.0,0.0,-5585978.0,-10744438.0,-49155.0,63608.0
2025-01-06,3035,184570,32013,0,2156849,1000,177153,-40884,0,1665849,-69000,7417,72897,0,491000,70000,91592.0,279493.0,-161068.0,137801.0,0.0,0.0,-5755309.0,-8999299.0,-119155.0,-3392.0
2025-01-07,3035,31965,86000,0,1276189,0,-95971,-160269,0,303177,-3000,127936,246269,0,973012,3000,53023.0,94474.0,-324721.0,-179636.0,0.0,0.0,-1450894.0,-8152707.0,-118000.0,-4392.0
2025-01-08,3035,84000,248000,0,816762,1000,20956,-91862,0,-1539238,-5000,63044,339862,0,2356000,6000,53153.0,165048.0,-422418.0,-293774.0,0.0,0.0,-2331259.0,-9070708.0,-112000.0,-7392.0
2025-01-09,3035,15000,207000,0,509569,479,-122801,-77302,0,-2001431,-19521,137801,284302,0,2511000,20000,-28333.0,64324.0,-399153.0,-73041.0,0.0,0.0,-2825313.0,-11292346.0,-131521.0,-26913.0
2025-01-10,3035,0,36000,0,699750,1000,-47256,-291100,0,-611870,-21000,47256,327100,0,1311620,22000,-67919.0,85494.0,-661417.0,-221004.0,0.0,0.0,-2183513.0,-11991294.0,-117521.0,-43676.0
2025-01-13,3035,10855,334457,0,1556050,0,-60591,13222,0,-330337,-125000,71446,321235,0,1886387,125000,-305663.0,19626.0,-607311.0,-171478.0,0.0,0.0,-4179699.0,-12726641.0,-173521.0,-165676.0
2025-01-14,3035,21832,148750,0,1840924,2000,-9713,-112168,0,394924,-350204,31545,260918,0,1446000,352204,-219405.0,-29531.0,-559210.0,-338218.0,0.0,0.0,-4087952.0,-11130847.0,-520725.0,-513880.0
2025-01-15,3035,21000,38354,0,2085656,1000,-6779,-10083,0,682656,1000,27779,48437,0,1403000,0,-247140.0,-137556.0,-477431.0,-814217.0,0.0,0.0,-1866058.0,-9052342.0,-514725.0,-651880.0
2025-01-16,3035,58442,163984,0,1847339,2000,4228,89580,0,1039339,-79000,54214,74404,0,808000,81000,-120111.0,-109495.0,-310549.0,-1043226.0,0.0,0.0,1174712.0,-6657064.0,-574204.0,-731880.0
2025-01-17,3035,5000,77821,0,637207,214000,-48765,-76758,0,-138930,210000,53765,154579,0,776137,4000,-121620.0,-123621.0,-96207.0,-1022229.0,0.0,0.0,1647652.0,-6287187.0,-343204.0,-516880.0
2025-01-20,3035,15384,150902,0,1110008,212000,5193,51828,0,595054,212000,10191,99074,0,514954,0,-55836.0,-125125.0,-57601.0,-739566.0,0.0,0.0,2573043.0,-5081906.0,-6204.0,-302880.0
2025-01-21,3035,13000,76146,0,978876,217000,-7130,-14854,0,486876,216000,20130,91000,0,492000,1000,-53253.0,-160692.0,39713.0,-888374.0,0.0,0.0,2664995.0,-5151477.0,560000.0,-87880.0
2025-01-22,3035,3000,7080,0,936391,213000,-15641,-209099,0,-34609,138000,18641,216179,0,971000,75000,-62115.0,-149097.0,-159303.0,-1035620.0,0.0,0.0,1947730.0,-4599177.0,697000.0,52120.0
2025-02-03,3035,55648,279340,0,924675,186000,21961,-121179,0,-401479,86000,33687,400519,0,1326154,100000,-44382.0,-118028.0,-370062.0,-1219298.0,0.0,0.0,506912.0,-5696497.0,862000.0,140120.0
2025-02-04,3035,191277,363715,0,2183237,125000,145973,104664,0,1234044,104000,45304,259051,0,949193,21000,150356.0,45821.0,-188640.0,-1022521.0,0.0,0.0,1879886.0,-4241953.0,756000.0,246120.0
2025-02-05,3035,136257,135942,0,2767241,546000,31726,-173592,0,1296981,523000,104531,309534,0,1470260,23000,176889.0,-93018.0,-414060.0,-1240040.0,0.0,0.0,2581813.0,-4780152.0,1067000.0,768120.0
2025-02-06,3035,8356,101541,0,1004401,89000,-156791,-10997,0,-336599,88000,165147,112538,0,1341000,1000,27228.0,-192407.0,-410203.0,-1254421.0,0.0,0.0,1758338.0,-1115513.0,939000.0,860275.0
2025-02-07,3035,53182,157132,0,2100935,100000,30124,34694,0,536935,97842,23058,122438,0,1564000,2158,72993.0,-183109.0,-166410.0,-1225562.0,0.0,0.0,2329882.0,80295.0,898842.0,969117.0
2025-02-10,3035,90777,479934,0,1807000,2000,47667,264621,0,-40748,-1000,43110,215313,0,1847748,3000,98699.0,-94127.0,219390.0,-860374.0,0.0,0.0,2690613.0,1546924.0,811842.0,968117.0
2025-02-11,3035,5299,55377,0,1119079,8000,-91807,-113973,0,220079,6000,97106,169350,0,899000,2000,-139081.0,-178264.0,753.0,-945511.0,0.0,0.0,1676648.0,3020673.0,713842.0,1009117.0
2025-02-12,3035,24953,62453,0,837664,3000,14953,-20548,0,354664,2000,10000,83001,0,483000,1000,-155854.0,-340464.0,153797.0,-925175.0,0.0,0.0,734331.0,1709488.0,192842.0,1080117.0
2025-02-13,3035,122380,177129,0,2031000,7000,99799,-40029,0,210995,6000,22581,217158,0,1820005,1000,100736.0,-144694.0,124765.0,-804935.0,0.0,0.0,1281925.0,1617306.0,110842.0,1089117.0
2025-02-14,3035,233028,449926,0,2807054,146000,138816,171532,0,-69286,145000,94212,278394,0,2876340,1000,209428.0,-26834.0,261603.0,-541541.0,0.0,0.0,675704.0,3087258.0,158000.0,1239117.0
2025-02-17,3035,162298,365557,0,1461862,6000,49296,264494,0,-686138,3000,113002,101063,0,2148000,3000,211057.0,145263.0,261476.0,-199745.0,0.0,0.0,30314.0,4402551.0,162000.0,1261638.0
2025-02-18,3035,178390,369810,0,3438254,554000,109864,204467,0,-1110178,536345,68526,165343,0,4548432,17655,412728.0,302383.0,579916.0,295822.0,0.0,0.0,-1299943.0,3904243.0,692345.0,1818983.0
2025-02-19,3035,140507,440897,0,2304040,119000,5670,273117,0,-484960,119000,134837,167780,0,2789000,0,403445.0,368644.0,873581.0,555717.0,0.0,0.0,-2139567.0,3749620.0,809345.0,2062983.0
2025-02-20,3035,14000,248020,0,2117040,106000,-86124,18497,0,840024,106000,100124,229523,0,1277016,0,217522.0,292233.0,932107.0,686382.0,0.0,0.0,-1510538.0,4194720.0,909345.0,2519187.0
2025-02-21,3035,15320,105000,0,820618,7000,-22163,-8720,0,-176959,7000,37483,113720,0,997577,0,56543.0,276849.0,751855.0,687745.0,0.0,0.0,-1618211.0,3335105.0,771345.0,2525187.0
2025-02-24,3035,73098,171074,0,2537188,207000,-74327,-217419,0,-252814,-3000,147425,388493,0,2790002,210000,-67080.0,198294.0,269942.0,380746.0,0.0,0.0,-1184887.0,2042952.0,765345.0,2601187.0
2025-02-25,3035,22000,97000,0,561000,131000,-106869,-384265,0,-1065000,129000,128869,481265,0,1626000,2000,-283813.0,140190.0,-318790.0,73239.0,0.0,0.0,-1139709.0,1116882.0,358000.0,2520187.0
2025-02-26,3035,22705,94012,0,752919,8000,-7839,-27881,0,-382081,7000,30544,121893,0,1135000,1000,-297322.0,127158.0,-619788.0,-6470.0,0.0,0.0,-1036830.0,139747.0,246000.0,2315187.0
2025-02-27,3035,31000,19000,0,929417,0,-4178,12929,0,107417,-14000,35178,6071,0,822000,14000,-215376.0,130110.0,-625356.0,21313.0,0.0,0.0,-1769437.0,-239712.0,126000.0,2085187.0
2025-03-03,3035,42204,78002,0,1254541,106000,-11739,38242,0,-627327,106000,53943,39760,0,1881868,0,-204952.0,134012.0,-578394.0,268654.0,0.0,0.0,-2219805.0,-832430.0,225000.0,2053187.0
2025-03-04,3035,224447,44000,0,1652000,15000,157655,-115779,0,20997,15000,66792,159779,0,1631003,0,27030.0,269706.0,-476754.0,274054.0,0.0,0.0,-1945994.0,-409954.0,243000.0,1982187.0
2025-03-05,3035,31276,94933,0,1330635,27000,-198898,66167,0,-40357,25000,230174,28766,0,1370992,2000,-64999.0,-75165.0,-26322.0,235557.0,0.0,0.0,-921351.0,-1684355.0,139000.0,1903187.0
2025-03-06,3035,13000,109095,0,576013,24000,-82650,61943,0,-936243,-226000,95650,47152,0,1512256,250000,-139810.0,-189541.0,63502.0,471092.0,0.0,0.0,-1475513.0,-3917579.0,-94000.0,1154187.0
2025-03-07,3035,7000,69790,0,783000,5000,-17906,-11235,0,-255256,5000,24906,81025,0,1038256,0,-153538.0,-50656.0,39338.0,470854.0,0.0,0.0,-1838186.0,-3836236.0,-75000.0,1071187.0
2025-03-10,3035,50000,82000,0,3543000,32000,-12673,-52365,0,-733456,32000,62673,134365,0,4276456,0,-154472.0,-93453.0,-51269.0,383795.0,0.0,0.0,-1944315.0,-5106627.0,-149000.0,1005345.0
2025-03-11,3035,48000,129281,0,1800050,41000,-69058,-20879,0,-1268950,5000,117058,150160,0,3069000,36000,-381185.0,-210178.0,43631.0,98295.0,0.0,0.0,-3234262.0,-6334829.0,-159000.0,1011345.0
2025-03-12,3035,17312,170000,0,1500500,0,-74186,8797,0,-2995963,-148161,91498,161203,0,4496463,148161,-256473.0,-192557.0,-13739.0,221065.0,0.0,0.0,-6189868.0,-9550871.0,-332161.0,857184.0
2025-03-13,3035,16017,161544,0,2104050,0,-37830,42917,0,839687,0,53847,118627,0,1264363,0,-211653.0,-245340.0,-32765.0,284530.0,0.0,0.0,-4413938.0,-9065848.0,-106161.0,855184.0
2025-03-14,3035,120641,237673,0,1167000,3000,83474,130745,0,23356,-86000,37167,106928,0,1143644,89000,-110273.0,-261665.0,109215.0,455304.0,0.0,0.0,-4135326.0,-9253487.0,-197161.0,763184.0
2025-03-17,3035,13074,87133,0,446737,0,-73558,-76165,0,-329449,-45000,86632,163298,0,776186,45000,-171158.0,-474039.0,85415.0,207607.0,0.0,0.0,-3731319.0,-9513650.0,-274161.0,573184.0
2025-03-18,3035,16588,78052,0,476000,11000,298,6944,0,147744,11000,16290,71108,0,328256,0,-101802.0,-523037.0,113238.0,-49943.0,0.0,0.0,-2314625.0,-8679768.0,-268161.0,581184.0
2025-03-19,3035,146822,60617,0,1808055,1000,130322,-13693,0,1124799,1000,16500,74310,0,683256,0,102706.0,-502579.0,90748.0,-268103.0,0.0,0.0,1806137.0,-6444791.0,-119000.0,45839.0
2025-03-20,3035,283129,126766,0,3072056,858000,249543,86766,0,2215589,858000,33586,40000,0,856467,0,390079.0,-258706.0,134597.0,-454454.0,0.0,0.0,3182039.0,-3744242.0,739000.0,784839.0
2025-03-21,3035,244688,42729,0,2687619,3145000,72110,-142271,0,529709,3045000,172578,185000,0,2157910,100000,378715.0,-100472.0,-138419.0,-615222.0,0.0,0.0,3688392.0,-4054557.0,3870000.0,3723839.0
2025-03-24,3035,44000,52283,0,1029000,969000,-276346,-33717,0,-889236,969000,320346,86000,0,1918236,0,175927.0,-354655.0,-95971.0,-640219.0,0.0,0.0,3128605.0,-4766834.0,4884000.0,4685839.0
2025-03-25,3035,140003,60917,0,2543000,1467000,64778,15891,0,195314,1183000,75225,45026,0,2347686,284000,240407.0,-215550.0,-87024.0,-406909.0,0.0,0.0,3176175.0,-4318706.0,6056000.0,5871839.0
2025-03-26,3035,76607,146845,0,839000,0,5303,51844,0,-508000,0,71304,95001,0,1347000,0,115388.0,-103378.0,-21487.0,29200.0,0.0,0.0,1543376.0,-3761706.0,6055000.0,5742839.0
2025-03-27,3035,40099,50332,0,1201500,0,-87520,-11808,0,435500,-61000,127619,62140,0,766000,61000,-221675.0,-183059.0,-120061.0,45273.0,0.0,0.0,-236713.0,-2944125.0,5136000.0,5674839.0
2025-03-28,3035,113356,111198,0,846000,507000,46567,-84228,0,-831632,507000,66789,195426,0,1677632,0,-247218.0,-132314.0,-62018.0,-51884.0,0.0,0.0,-1598054.0,-3883174.0,2598000.0,6195839.0
2025-03-31,3035,26000,273423,0,1316000,63000,-210421,-65168,0,-1611695,-50000,236421,338591,0,2927695,113000,-181293.0,-330996.0,-93469.0,-155294.0,0.0,0.0,-2320513.0,-4867542.0,1579000.0,6039839.0
2025-04-01,3035,125314,152648,0,2525565,9000,56772,-118864,0,-33407,-34000,68542,271512,0,2558972,43000,-189299.0,-431879.0,-228224.0,-158379.0,0.0,0.0,-2549234.0,-4921946.0,362000.0,5990839.0
2025-04-02,3035,205895,156426,0,3999528,1041000,142141,-162621,0,1842278,1041000,63754,319047,0,2157250,0,-52461.0,-90840.0,-442689.0,-387167.0,0.0,0.0,-198956.0,-3039311.0,1403000.0,7006839.0
2025-04-07,3035,0,0,0,57000,6000,-29600,0,0,43000,6000,29600,0,0,14000,0,5459.0,-37790.0,-430881.0,-449110.0,0.0,0.0,-591456.0,-2060068.0,1470000.0,7238839.0
2025-04-08,3035,77084,347232,0,2293005,6000,-201333,47214,0,-1077448,-14000,278417,300018,0,3370453,20000,-242441.0,-221217.0,-299439.0,-390661.0,0.0,0.0,-837272.0,-2882260.0,949000.0,7219839.0
2025-04-09,3035,16339,218283,0,3604861,0,-119079,105016,0,1362542,0,135418,113267,0,2242319,0,-151099.0,-327623.0,-129255.0,-233280.0,0.0,0.0,2136965.0,-786262.0,999000.0,7187839.0
2025-04-10,3035,29000,0,0,151000,36000,28000,-5000,0,60000,35583,1000,5000,0,91000,417,-179871.0,-230565.0,-15391.0,-217401.0,0.0,0.0,2230372.0,542688.0,1068583.0,7218422.0
2025-04-11,3035,244249,366882,0,3885807,1000,217373,-31923,0,276807,-40000,26876,398805,0,3609000,41000,-104639.0,60994.0,115307.0,-258121.0,0.0,0.0,664901.0,3815458.0,-12417.0,7326583.0
2025-04-14,3035,223320,268107,0,2499190,569000,-54739,-20015,0,-154008,557000,278059,288122,0,2653198,12000,-129778.0,44085.0,95292.0,-321053.0,0.0,0.0,467893.0,2821763.0,538583.0,7883583.0
2025-04-15,3035,110856,60763,0,2902632,1057000,13855,-90485,0,1051524,1054000,97001,151248,0,1851108,3000,85410.0,-25534.0,-42407.0,-542283.0,0.0,0.0,2596865.0,3849931.0,1606583.0,9023583.0
2025-04-16,3035,33938,11140,0,1440071,0,-57670,-62231,0,55589,-2000,91608,73371,0,1384482,2000,146819.0,-9646.0,-209654.0,-528349.0,0.0,0.0,1289912.0,4234969.0,1604583.0,9066583.0
2025-04-17,3035,37922,80944,0,3645011,22000,-294717,-82959,0,-465238,-7000,332639,163903,0,4110249,29000,-175898.0,-304661.0,-287613.0,-618252.0,0.0,0.0,764674.0,3621987.0,1562000.0,9048583.0
2025-04-18,3035,36797,37811,0,2984250,150000,-43535,-12046,0,-740759,-99000,80332,49857,0,3725009,249000,-436806.0,-478518.0,-267736.0,-616605.0,0.0,0.0,-252892.0,1756429.0,1503000.0,8948583.0
2025-04-21,3035,40948,67568,0,1734005,0,-80061,23504,0,668005,-248000,121009,44064,0,1066000,248000,-462128.0,-808122.0,-224217.0,-679867.0,0.0,0.0,569121.0,208845.0,698000.0,7842583.0
2025-04-22,3035,167798,93025,0,2732000,0,16069,-10984,0,943995,-1637000,151729,104009,0,1788005,1637000,-459914.0,-864163.0,-144716.0,-548580.0,0.0,0.0,461592.0,623131.0,-1993000.0,3160583.0
2025-04-23,3035,45192,80000,0,5274553,1000,-190853,-45869,0,-2889747,-4845000,236045,125869,0,8164300,4846000,-593097.0,-778670.0,-128354.0,-560732.0,0.0,0.0,-2483744.0,-1377380.0,-6836000.0,-2653417.0
2025-04-24,3035,168127,103478,0,4060082,34000,96089,61874,0,1862082,-2203000,72038,41604,0,2198000,2237000,-202291.0,-747359.0,16479.0,-514749.0,0.0,0.0,-156424.0,289388.0,-9032000.0,-6039417.0
2025-04-25,3035,328525,105232,0,4313004,4000,180284,60498,0,2814205,-2975054,148241,44734,0,1498799,2979054,21528.0,-572378.0,89023.0,-506095.0,0.0,0.0,3398540.0,3611593.0,-11908054.0,-9014471.0
2025-04-28,3035,202120,8306,0,2428120,102000,22982,1313,0,-431881,62000,179138,6993,0,2860001,40000,124571.0,-461876.0,66832.0,-492974.0,0.0,0.0,2298654.0,2744212.0,-11598054.0,-8891471.0
2025-04-29,3035,112210,7120,0,1741000,110000,-2152,-50470,0,578721,110000,114362,57590,0,1162279,0,106350.0,-510595.0,27346.0,-459216.0,0.0,0.0,1933380.0,4154565.0,-9851054.0,-9288471.0
2025-04-30,3035,14600,20000,0,1388738,0,-42823,-235093,0,-379262,0,57423,255093,0,1768000,0,254380.0,-342997.0,-161878.0,-629141.0,0.0,0.0,4443865.0,5386998.0,-5006054.0,-9238471.0
2025-05-02,3035,106322,153468,0,2126350,0,93487,137341,0,-874231,-35000,12835,16127,0,3000581,35000,251778.0,-306282.0,-86411.0,-372936.0,0.0,0.0,1707552.0,4546174.0,-2838054.0,-9239471.0
2025-05-05,3035,41338,105009,0,3089095,1000,-169074,-293707,0,-167905,-14000,210412,398716,0,3257000,15000,-97580.0,-617497.0,-440616.0,-504022.0,0.0,0.0,-1274558.0,2535991.0,123000.0,-10294471.0
2025-05-06,3035,92080,27642,0,3201020,87000,5812,-146634,0,1554980,85000,86268,174276,0,1646040,2000,-114750.0,-582085.0,-588563.0,-650656.0,0.0,0.0,712303.0,4047971.0,146000.0,-10215471.0
2025-05-07,3035,5615,59960,0,1446020,6000,-172326,-76297,0,354000,5000,177941,136257,0,1092020,1000,-284924.0,-553078.0,-614390.0,-774167.0,0.0,0.0,487582.0,5479419.0,41000.0,-10196471.0
2025-05-08,3035,106000,316649,0,2288201,3000,96848,302883,0,1330984,3000,9152,13766,0,957217,0,-145253.0,-337151.0,-76414.0,-576300.0,0.0,0.0,2197828.0,5447861.0,44000.0,-10193471.0
2025-05-09,3035,98972,232000,0,1326006,1000,26941,176705,0,155190,1000,72031,55295,0,1170816,0,-211799.0,-338210.0,-37050.0,-394595.0,0.0,0.0,3227249.0,5543051.0,80000.0,-10228054.0
2025-05-12,3035,123915,189807,0,3007000,0,44881,-109082,0,1959700,-111000,79034,298889,0,1047300,111000,2156.0,-510702.0,147575.0,-471754.0,0.0,0.0,5354854.0,7225944.0,-17000.0,-10299054.0
2025-05-13,3035,7000,43450,0,1636100,0,-200031,-131097,0,441100,-36000,207031,174547,0,1195000,36000,-203687.0,-655994.0,163112.0,-582836.0,0.0,0.0,4240974.0,7821052.0,-138000.0,-10892054.0
2025-05-14,3035,144175,50716,0,1546750,0,128262,49843,0,506750,0,15913,873,0,1040000,0,96901.0,-541587.0,289252.0,-442508.0,0.0,0.0,4393724.0,7276278.0,-143000.0,-11946054.0
2025-05-15,3035,56580,27000,0,387000,5000,-56712,16766,0,-661000,4000,113292,10234,0,1048000,1000,-56659.0,-540629.0,3135.0,-363511.0,0.0,0.0,2401740.0,6559689.0,-142000.0,-11940054.0
2025-05-16,3035,16744,39760,0,584707,4000,4828,-2914,0,4927,-477000,11916,42674,0,579780,481000,-78772.0,-241084.0,-176484.0,-283466.0,0.0,0.0,2251477.0,7029854.0,-620000.0,-12410054.0
2025-05-19,3035,29170,124000,0,538000,6052,-14732,96541,0,-366866,-116948,43902,27459,0,904866,123000,-138385.0,-212281.0,29139.0,-174879.0,0.0,0.0,-75089.0,7403747.0,-625948.0,-12428002.0
2025-05-20,3035,208641,46010,0,1364000,2000,112168,-56121,0,309000,-83000,96473,102131,0,1055000,85000,173814.0,-20052.0,104115.0,-254504.0,0.0,0.0,-207189.0,7044742.0,-672948.0,-12263002.0
2025-05-21,3035,505564,152000,0,1459306,0,491180,70474,0,128719,-68000,14384,81526,0,1330587,68000,536732.0,455059.0,124746.0,-173046.0,0.0,0.0,-585220.0,6229466.0,-740948.0,-10694002.0
2025-05-22,3035,15000,100000,0,538000,0,-90706,79804,0,-548006,-3000,105706,20196,0,1086006,3000,502738.0,555206.0,187784.0,-47373.0,0.0,0.0,-472226.0,8571207.0,-747948.0,-5852002.0
2025-05-23,3035,73395,45127,0,746300,0,40952,704,0,-65444,-8000,32443,44423,0,811744,8000,538862.0,500069.0,191402.0,-108543.0,0.0,0.0,-542597.0,6643681.0,-278948.0,-3657002.0
2025-05-26,3035,7432,57000,0,1210200,0,-101349,-286004,0,-91800,0,108781,343004,0,1302000,0,452245.0,218436.0,-191143.0,-455045.0,0.0,0.0,-267531.0,3737676.0,-162000.0,-681948.0
2025-05-27,3035,4000,27000,0,436000,0,-35263,-195664,0,-798620,-90000,39263,222664,0,1234620,90000,304814.0,160191.0,-330686.0,-652022.0,0.0,0.0,-1375151.0,3370937.0,-169000.0,-833948.0
2025-05-28,3035,214262,8757,0,622300,0,122261,-76613,0,-496728,-39000,92001,85370,0,1119028,39000,-64105.0,284604.0,-477773.0,-678165.0,0.0,0.0,-2000598.0,2295488.0,-140000.0,-982948.0
2025-05-29,3035,121032,25076,0,1059624,0,112798,-43784,0,290108,-2000,8234,68860,0,769516,2000,139399.0,440225.0,-601361.0,-486856.0,0.0,0.0,-1162484.0,2964858.0,-139000.0,-984948.0
2025-06-02,3035,118000,159201,0,1918563,2000,-34662,55263,0,-2003358,-372000,152662,103938,0,3921921,374000,63785.0,312076.0,-546802.0,-568934.0,0.0,0.0,-3100398.0,1835731.0,-503000.0,-1321948.0
2025-06-03,3035,199300,123000,0,1150007,0,192384,87802,0,145007,-107000,6916,35198,0,1005000,107000,357518.0,673534.0,-172996.0,-187425.0,0.0,0.0,-2863591.0,2148643.0,-610000.0,-1414948.0
2025-06-04,3035,427993,342631,0,3904127,0,386993,258423,0,1562127,0,41000,84208,0,2342000,0,779774.0,1054715.0,281091.0,217632.0,0.0,0.0,-502844.0,2155790.0,-520000.0,-1499948.0
2025-06-05,3035,62317,62882,0,918150,0,-84677,59650,0,270027,-57324,146994,3232,0,648123,57324,572836.0,1142364.0,417354.0,353579.0,0.0,0.0,263911.0,2071817.0,-538324.0,-1562272.0
2025-06-06,3035,68199,155000,0,696000,0,20676,155000,0,237000,0,47523,0,0,459000,0,480714.0,1066192.0,616138.0,205696.0,0.0,0.0,210803.0,977833.0,-536324.0,-1565272.0
2025-06-09,3035,20000,46000,0,637000,1000,-38340,35252,0,-220000,1000,58340,10748,0,857000,0,477036.0,1000911.0,596127.0,64243.0,0.0,0.0,1994161.0,602643.0,-163324.0,-1565272.0
2025-06-10,3035,63087,116039,0,1300000,1000,59087,99678,0,328000,1000,4000,16361,0,972000,0,343739.0,1015117.0,608003.0,273003.0,0.0,0.0,2177154.0,-1029057.0,-55324.0,-1453272.0
2025-06-11,3035,24901,71074,0,2044020,0,9112,7885,0,1056820,0,15789,63189,0,987200,0,-34142.0,1224260.0,357465.0,411985.0,0.0,0.0,1671847.0,-413337.0,-55324.0,-1417272.0
2025-06-12,3035,7172,51000,0,408000,0,-15100,26269,0,-162000,-1000,22272,24731,0,570000,1000,35435.0,1080898.0,324084.0,388411.0,0.0,0.0,1239820.0,-1082087.0,1000.0,-1418272.0
2025-06-13,3035,2000,19000,0,395000,1000,-20285,-64852,0,-130000,0,22285,83852,0,525000,1000,-5526.0,1117325.0,104232.0,306793.0,0.0,0.0,872820.0,-551087.0,1000.0,-1422272.0
2025-06-16,3035,252358,198000,0,846000,1000,245358,187503,0,313500,0,7000,10497,0,532500,1000,278172.0,1357855.0,256483.0,497210.0,0.0,0.0,1406320.0,-242514.0,0.0,-945272.0
2025-06-17,3035,16125,43000,0,805094,0,-307096,-147300,0,-527906,-2000,323221,190300,0,1333000,2000,-88011.0,1065491.0,9505.0,253369.0,0.0,0.0,550414.0,-403554.0,-3000.0,-830324.0
2025-06-18,3035,4000,3963,0,411010,0,-165026,-27388,0,-274990,0,169026,31351,0,686000,0,-262149.0,788297.0,-25768.0,282102.0,0.0,0.0,-781396.0,-987544.0,-3000.0,-747324.0
2025-06-19,3035,176629,234676,0,2655940,0,153267,62065,0,45920,-53000,23362,172611,0,2610020,53000,-93782.0,450384.0,10028.0,273693.0,0.0,0.0,-573476.0,-1070343.0,-55000.0,-732324.0
2025-06-20,3035,26052,56000,0,1419050,3000,-75164,-251447,0,-4167076,-2000,101216,307447,0,5586126,5000,-148661.0,465926.0,-176567.0,-57558.0,0.0,0.0,-4610552.0,-4689413.0,-57000.0,-731324.0
2025-06-23,3035,5312,99000,0,653010,0,-25619,50219,0,-724090,-5000,30931,48781,0,1377100,5000,-419638.0,399355.0,-313851.0,-8043.0,0.0,0.0,-5648142.0,-5348059.0,-62000.0,-728324.0
2025-06-24,3035,66360,42919,0,1847066,3000,38446,-454,0,982066,-1000,27914,43373,0,865000,4000,-74096.0,539150.0,-167005.0,277507.0,0.0,0.0,-4138170.0,-4274193.0,-61000.0,-729324.0
2025-06-25,3035,113775,87022,0,2151100,0,80626,25022,0,1098212,-3000,33149,62000,0,1052888,3000,171556.0,655039.0,-114595.0,498193.0,0.0,0.0,-2764968.0,-2377361.0,-64000.0,-642324.0
2025-06-26,3035,13147,34220,0,2066775,0,-106816,-493786,0,321775,-1000,119963,528006,0,1745000,1000,-88527.0,425962.0,-670446.0,81020.0,0.0,0.0,-2489113.0,-1558858.0,-12000.0,-604324.0
2025-06-27,3035,119341,86436,0,3063830,0,89706,-216855,0,-487170,-11000,29635,303291,0,3551000,11000,76343.0,402870.0,-635854.0,-92051.0,0.0,0.0,1190793.0,-2336136.0,-21000.0,-613324.0
2025-06-30,3035,8892,11000,0,1395000,0,-55727,-291317,0,128000,-1000,64619,302317,0,1267000,1000,46235.0,381805.0,-977390.0,-438631.0,0.0,0.0,2042883.0,-204778.0,-17000.0,-242324.0
2025-07-01,3035,111966,66912,0,1725859,1000,96923,912,0,180859,1000,15043,66000,0,1545000,0,104712.0,286344.0,-976024.0,-525521.0,0.0,0.0,1241676.0,-168926.0,-15000.0,-134324.0
2025-07-02,3035,77578,149331,0,1615000,0,-86,136331,0,568930,0,77664,13000,0,1046070,0,24000.0,-100735.0,-864715.0,-647613.0,0.0,0.0,712394.0,-1162123.0,-12000.0,-134324.0
2025-07-03,3035,71890,145382,0,1743230,0,-3951,382,0,-2479852,0,75841,145000,0,4223082,0,126865.0,-20009.0,-370547.0,-706881.0,0.0,0.0,-2089233.0,-3912002.0,-11000.0,-77000.0
2025-07-04,3035,3104,1579,0,860000,2000,-78498,-41976,0,-753000,-1000,81602,43555,0,1613000,3000,-41339.0,-119183.0,-195668.0,-903857.0,0.0,0.0,-2355063.0,-4902002.0,-1000.0,-78000.0
2025-07-07,3035,51283,105445,0,989462,1000,24633,101345,0,120936,1000,26650,4100,0,868526,0,39021.0,-56210.0,196994.0,-837764.0,0.0,0.0,-2362127.0,-4561066.0,1000.0,-78000.0
2025-07-08,3035,45918,98000,0,1096040,4000,34651,2000,0,21040,2000,11267,96000,0,1075000,2000,-23251.0,-80646.0,198082.0,-935442.0,0.0,0.0,-2521946.0,-4868026.0,2000.0,-77000.0
2025-07-09,3035,79009,148000,0,898200,1000,-95112,-96000,0,-1031990,1000,174121,244000,0,1930190,0,-118277.0,-184870.0,-34249.0,-1039327.0,0.0,0.0,-4122866.0,-6956836.0,3000.0,-76000.0
2025-07-10,3035,65000,30000,0,857754,0,-27240,24399,0,-752246,-14000,92240,5601,0,1610000,14000,-141566.0,-197010.0,-10232.0,-1041197.0,0.0,0.0,-2395260.0,-7547082.0,-11000.0,-89000.0
2025-07-11,3035,77861,37000,0,1310000,11000,2291,-35000,0,286082,9000,75570,72000,0,1023918,2000,-60777.0,-174434.0,-3256.0,-1011345.0,0.0,0.0,-1356178.0,-7131000.0,-1000.0,-80000.0
2025-07-14,3035,41000,24000,0,397100,0,-43788,-42000,0,-976910,0,84788,66000,0,1374010,0,-129198.0,-463580.0,-146601.0,-1240848.0,0.0,0.0,-2454024.0,-8421410.0,-2000.0,-80000.0
2025-07-15,3035,17000,37000,0,393095,0,5843,-9000,0,-929182,-2000,11157,46000,0,1322277,2000,-158006.0,-150641.0,-157601.0,-1102548.0,0.0,0.0,-3404246.0,-8822686.0,-6000.0,-80000.0
2025-07-16,3035,100094,7000,0,1033039,146000,79916,-117000,0,-51188,146000,20178,124000,0,1084227,0,17022.0,94301.0,-178601.0,-1192160.0,0.0,0.0,-2423444.0,-8598884.0,139000.0,66000.0
2025-07-17,3035,148659,92000,0,1521015,147000,104343,92000,0,-330105,146000,44316,0,0,1851120,1000,148605.0,45377.0,-111000.0,-1162225.0,0.0,0.0,-2001303.0,-8974909.0,299000.0,265000.0
2025-07-18,3035,29835,60000,0,896000,140000,3533,44000,0,384418,135000,26302,16000,0,511582,5000,149847.0,124074.0,-32000.0,-866778.0,0.0,0.0,-1902967.0,-4423415.0,425000.0,402000.0
2025-07-21,3035,5264,5000,0,382100,138000,-26027,-5266,0,-251500,138000,31291,10266,0,633600,0,167608.0,123666.0,4734.0,-922263.0,0.0,0.0,-1177557.0,-3950825.0,563000.0,545000.0
2025-07-22,3035,34833,75000,0,655050,130000,-52164,-15038,0,-1175950,126000,86997,90038,0,1831000,4000,109601.0,33056.0,-1304.0,-936847.0,0.0,0.0,-1424325.0,-6108841.0,691000.0,672000.0
2025-07-23,3035,48957,79000,0,1535071,6000,42765,3000,0,1059071,5000,6192,76000,0,476000,1000,72450.0,-4805.0,118696.0,-958869.0,0.0,0.0,-314066.0,-6147982.0,550000.0,680000.0
2025-07-24,3035,19340,8000,0,1246000,0,-25263,-8000,0,223575,-1000,44603,16000,0,1022425,1000,-57156.0,76748.0,18696.0,-473083.0,0.0,0.0,239614.0,-6246182.0,403000.0,680000.0
2025-07-25,3035,3684,59000,0,391000,0,-27015,-1000,0,-530000,-30000,30699,60000,0,921000,30000,-87704.0,-39973.0,-26304.0,-257228.0,0.0,0.0,-674804.0,-6289012.0,238000.0,661000.0
2025-07-28,3035,18270,83000,0,433000,1000,-1427,55000,0,-404100,0,19697,28000,0,837100,1000,-63104.0,14327.0,33962.0,89089.0,0.0,0.0,-827404.0,-6821112.0,100000.0,662000.0
2025-07-29,3035,63000,27000,0,387000,0,-41976,-54000,0,-2048000,0,104976,81000,0,2435000,0,-52916.0,-124572.0,-5000.0,34177.0,0.0,0.0,-1699454.0,-9049971.0,-26000.0,661000.0
2025-07-30,3035,199000,23000,0,1904520,0,-79075,-350000,0,-3309656,0,278075,373000,0,5214176,0,-174756.0,-203561.0,-358000.0,-452154.0,0.0,0.0,-6068181.0,-12928557.0,-31000.0,661000.0
2025-07-31,3035,171288,123000,0,1235090,5000,51396,24529,0,-1498110,0,119892,98471,0,2733200,5000,-98097.0,-148214.0,-325471.0,-428007.0,0.0,0.0,-7789866.0,-11946815.0,-30000.0,661000.0
2025-08-01,3035,224512,173674,0,1379700,0,164820,29639,0,-410300,0,59692,144035,0,1790000,0,93738.0,95104.0,-294832.0,-356392.0,0.0,0.0,-7670166.0,-11604115.0,0.0,662000.0
2025-08-04,3035,39884,1000,0,1012016,6000,-71123,-110000,0,-257945,6000,111007,111000,0,1269961,0,24042.0,-652.0,-459832.0,-567737.0,0.0,0.0,-7524011.0,-11982996.0,6000.0,667000.0
2025-08-05,3035,12914,2000,0,1213000,2000,5522,-49000,0,634955,1000,7392,51000,0,578045,1000,71540.0,-29781.0,-454832.0,-618737.0,0.0,0.0,-4841056.0,-11369081.0,7000.0,666000.0
2025-08-06,3035,41247,18000,0,342000,6000,-22873,12000,0,-400000,5000,64120,6000,0,742000,1000,127742.0,42458.0,-92832.0,-510737.0,0.0,0.0,-1931400.0,-10737091.0,12000.0,670000.0
2025-08-07,3035,44749,44270,0,1372000,0,15426,-5730,0,464941,0,29323,50000,0,907059,0,91772.0,85124.0,-123091.0,-540866.0,0.0,0.0,31651.0,-9519904.0,12000.0,684000.0
2025-08-08,3035,16786,1000,0,759513,1000,-22175,-10370,0,65513,0,38961,11370,0,694000,1000,-95223.0,60658.0,-163100.0,-516236.0,0.0,0.0,507464.0,-9740473.0,12000.0,675000.0
2025-08-11,3035,10151,6000,0,746000,0,2700,4000,0,175500,-27000,7451,2000,0,570500,27000,-21400.0,107146.0,-49100.0,-470236.0,0.0,0.0,940909.0,-8588063.0,-21000.0,648000.0
2025-08-12,3035,110516,25918,0,1082000,1420,109171,23786,0,625000,420,1345,2132,0,457000,1000,82249.0,210474.0,23686.0,-437450.0,0.0,0.0,930954.0,-7033881.0,-21580.0,650420.0
2025-08-13,3035,20347,3000,0,1222200,0,-89075,3000,0,-323800,-8000,109422,0,0,1546000,8000,16047.0,41483.0,14686.0,-317450.0,0.0,0.0,1007154.0,-7306493.0,-34580.0,496420.0
2025-08-14,3035,66860,11000,0,1037171,1420,54329,11000,0,-163739,-84580,12531,0,0,1200910,86000,54950.0,-8531.0,31416.0,-398450.0,0.0,0.0,378474.0,-7140127.0,-119160.0,265840.0
2025-08-15,3035,12000,3000,0,476010,0,-14161,3000,0,-10990,-3000,26161,0,0,487000,3000,62964.0,-26225.0,44786.0,-439450.0,0.0,0.0,301971.0,-7535535.0,-122160.0,127840.0
2025-08-18,3035,28071,4000,0,831000,90000,4360,-161000,0,257000,88865,23711,165000,0,574000,1135,64624.0,4162.0,-120214.0,-595184.0,0.0,0.0,383471.0,-7027035.0,-6295.0,78705.0
2025-08-19,3035,29213,12000,0,598000,110000,-22018,-3100,0,-192000,96000,51231,15100,0,790000,14000,-66565.0,34308.0,-147100.0,-583246.0,0.0,0.0,-433529.0,-6043085.0,89285.0,48705.0
2025-08-20,3035,333302,191000,0,3387000,92000,149928,113999,0,-1979618,92000,183374,77001,0,5366618,0,172438.0,141471.0,-36101.0,-472247.0,0.0,0.0,-2089347.0,-9081774.0,189285.0,135705.0
2025-08-21,3035,44000,8000,0,551025,12000,-89256,-41019,0,-1621377,12000,133256,49019,0,2172402,0,28853.0,77478.0,-88120.0,-505266.0,0.0,0.0,-3546985.0,-10926726.0,285865.0,148705.0
2025-08-22,3035,47337,3000,0,637000,1000,-21036,-4702,0,-2181000,1000,68373,7702,0,2818000,0,21978.0,83457.0,-95822.0,-508968.0,0.0,0.0,-5716995.0,-12577726.0,289865.0,179705.0
2025-08-25,3035,232701,34711,0,2306618,1000,228843,27711,0,831573,1000,3858,7000,0,1475045,0,246461.0,313727.0,92889.0,-536257.0,0.0,0.0,-5142422.0,-11342053.0,202000.0,180705.0
2025-08-26,3035,166962,78021,0,1752953,0,140948,78021,0,145630,0,26014,0,0,1607323,0,409427.0,496651.0,174010.0,-404236.0,0.0,0.0,-4804792.0,-9148423.0,106000.0,180705.0
2025-08-27,3035,282773,27850,0,2889000,1000,255750,-59150,0,1069000,0,27023,87000,0,1820000,1000,515249.0,831476.0,861.0,-113386.0,0.0,0.0,-1756174.0,-4769767.0,14000.0,180705.0
2025-08-28,3035,40998,9074,0,1395000,0,-43426,-91924,0,730216,-8000,84424,100998,0,664784,8000,561079.0,736654.0,-50044.0,-229839.0,0.0,0.0,595419.0,-2541441.0,-6000.0,172705.0
2025-08-29,3035,8000,9000,0,974030,0,-175041,-10909,0,-1535970,-4000,183041,19909,0,2510000,4000,407074.0,396793.0,-56251.0,-270387.0,0.0,0.0,1240449.0,-3667111.0,-11000.0,168705.0
2025-09-01,3035,12628,42000,0,671000,0,-145135,-1327,0,-6000,-4000,157763,43327,0,677000,4000,33096.0,322781.0,-85289.0,-161714.0,0.0,0.0,402876.0,-3415166.0,-16000.0,158705.0
2025-09-02,3035,18164,29000,0,702090,0,-49070,2548,0,-389910,-5000,67234,26452,0,1092000,5000,-156922.0,268189.0,-160762.0,-110166.0,0.0,0.0,-132664.0,-4440031.0,-21000.0,152705.0
2025-09-03,3035,41555,28187,0,527160,0,37730,28187,0,11160,0,3825,0,0,516000,0,-374942.0,328792.0,-73425.0,-93979.0,0.0,0.0,-1190504.0,-4028871.0,-21000.0,147705.0
2025-09-04,3035,43118,28023,0,1007021,0,39874,5105,0,610403,-3000,3244,22918,0,396618,3000,-291642.0,353240.0,23604.0,-83144.0,0.0,0.0,-1310317.0,-3883409.0,-16000.0,144705.0
2025-09-05,3035,70345,122000,0,933000,0,66317,94000,0,531000,-4000,4028,28000,0,402000,4000,-50284.0,441732.0,128513.0,21226.0,0.0,0.0,756653.0,-3417922.0,-16000.0,140705.0
2025-09-08,3035,32047,2000,0,976250,2000,5510,2000,0,460250,-6000,26537,0,0,516000,8000,100361.0,444542.0,131840.0,19226.0,0.0,0.0,1222903.0,-3133172.0,-18000.0,161705.0
2025-09-09,3035,45453,11998,0,688000,0,-21187,3998,0,-75000,-10356,66640,8000,0,763000,10356,128244.0,314184.0,133290.0,-562.0,0.0,0.0,1537813.0,-3833172.0,-23356.0,150929.0
2025-09-10,3035,7000,6000,0,365000,0,803,2551,0,-98000,-4000,6197,3449,0,463000,4000,91317.0,404062.0,107654.0,-1011.0,0.0,0.0,1428653.0,-3607372.0,-27356.0,154929.0
2025-09-11,3035,55000,11000,0,275000,0,-38665,-17765,0,-1078000,-5000,93665,28765,0,1353000,5000,12778.0,311068.0,84784.0,-29776.0,0.0,0.0,-259750.0,-4521633.0,-29356.0,234509.0
2025-09-12,3035,106522,46000,0,1463025,0,85935,46000,0,29246,-6000,20587,0,0,1433779,6000,32396.0,411164.0,36784.0,13224.0,0.0,0.0,-761504.0,-4481397.0,-31356.0,231509.0
2025-09-15,3035,57022,45000,0,416150,0,-31269,45000,0,-756850,-3908,88291,0,0,1173000,3908,-4383.0,375535.0,79784.0,219224.0,0.0,0.0,-1978604.0,-5495247.0,-29264.0,138736.0
2025-09-16,3035,10000,3000,0,235000,1000,672,-29000,0,-137000,-79702,9328,32000,0,372000,80702,17476.0,398225.0,46786.0,193324.0,0.0,0.0,-2040604.0,-5440247.0,-98610.0,-36966.0
2025-09-17,3035,170236,63989,0,367000,0,151404,58989,0,-764550,-27000,18832,5000,0,1131550,27000,168077.0,399701.0,103224.0,138314.0,0.0,0.0,-2707154.0,-4225179.0,-121610.0,-155966.0
2025-09-18,3035,130082,35000,0,1473274,0,119088,35000,0,620274,-13000,10994,0,0,853000,13000,325830.0,608045.0,155989.0,214333.0,0.0,0.0,-1008880.0,-1983528.0,-129610.0,-180966.0
2025-09-19,3035,622644,25000,0,562000,0,111644,25000,0,-298977,-132660,511000,0,0,860977,132660,351539.0,740725.0,134989.0,244035.0,0.0,0.0,-1337103.0,-101505.0,-256270.0,-314626.0
2024-09-23,3293,108994,32880,0,1187514,25000,43885,7060,0,258414,-24000,65109,25820,0,929100,49000,43885.0,43885.0,7060.0,7060.0,0.0,0.0,258414.0,258414.0,-24000.0,-24000.0
2024-09-24,3293,98222,27287,0,1213806,14000,33088,19086,0,700956,14000,65134,8201,0,512850,0,76973.0,76973.0,26146.0,26146.0,0.0,0.0,959370.0,959370.0,-10000.0,-10000.0
2024-09-25,3293,243041,64773,0,2544628,95000,12987,35923,0,1274442,84000,230054,28850,0,1270186,11000,89960.0,89960.0,62069.0,62069.0,0.0,0.0,2233812.0,2233812.0,74000.0,74000.0
2024-09-26,3293,183154,89424,0,2956239,213000,72403,51494,0,500948,169000,110751,37930,0,2455291,44000,162363.0,162363.0,113563.0,113563.0,0.0,0.0,2734760.0,2734760.0,243000.0,243000.0
2024-09-27,3293,139472,89000,0,2168803,98000,-72056,-61346,0,-173562,91000,211528,150346,0,2342365,7000,90307.0,90307.0,52217.0,52217.0,0.0,0.0,2561198.0,2561198.0,334000.0,334000.0
2024-09-30,3293,48791,20000,0,1691606,46000,2974,-5100,0,299615,-24000,45817,25100,0,1391991,70000,49396.0,93281.0,40057.0,47117.0,0.0,0.0,2602399.0,2860813.0,334000.0,310000.0
2024-10-01,3293,109122,28197,0,1161247,522000,48406,11529,0,-189521,521000,60716,16668,0,1350768,1000,64714.0,141687.0,32500.0,58646.0,0.0,0.0,1711922.0,2671292.0,841000.0,831000.0
2024-10-04,3293,470000,78000,0,1447846,173000,-68417,5894,0,-2253049,128000,538417,72106,0,3700895,45000,-16690.0,73270.0,2471.0,64540.0,0.0,0.0,-1815569.0,418243.0,885000.0,959000.0
2024-10-07,3293,77760,40305,0,827199,8000,28417,13483,0,-307001,-214000,49343,26822,0,1134200,222000,-60676.0,101687.0,-35540.0,78023.0,0.0,0.0,-2623518.0,111242.0,502000.0,745000.0
2024-10-08,3293,10863,5000,0,1017938,6000,-10773,-22101,0,-3910,0,21636,27101,0,1021848,6000,607.0,90914.0,3705.0,55922.0,0.0,0.0,-2453866.0,107332.0,411000.0,745000.0
2024-10-09,3293,66714,17075,0,970348,4000,59572,-955,0,330346,2000,7142,18030,0,640002,2000,57205.0,150486.0,7850.0,54967.0,0.0,0.0,-2423135.0,437678.0,437000.0,747000.0
2024-10-11,3293,380377,25153,0,3278217,8000,111582,-8847,0,2272565,-230000,268795,34000,0,1005652,238000,120381.0,262068.0,-12526.0,46120.0,0.0,0.0,38951.0,2710243.0,-314000.0,517000.0
2024-10-14,3293,66371,21536,0,1026707,526000,-24075,10114,0,-316052,486000,90446,11422,0,1342759,40000,164723.0,237993.0,-8306.0,56234.0,0.0,0.0,1975948.0,2394191.0,44000.0,1003000.0
2024-10-15,3293,128527,70238,0,746752,4000,-57,41582,0,-952172,-84000,128584,28656,0,1698924,88000,136249.0,237936.0,19793.0,97816.0,0.0,0.0,1330777.0,1442019.0,174000.0,919000.0
2024-10-16,3293,102010,86986,0,1471701,80000,74231,77510,0,507889,-314000,27779,9476,0,963812,394000,221253.0,312167.0,119404.0,175326.0,0.0,0.0,1842576.0,1949908.0,-140000.0,605000.0
2024-10-17,3293,52474,19313,0,1007425,0,32349,18013,0,-130900,-1000,20125,1300,0,1138325,1000,194030.0,344516.0,138372.0,193339.0,0.0,0.0,1381330.0,1819008.0,-143000.0,604000.0
2024-10-18,3293,65300,28613,0,984612,115000,-23585,12701,0,-33388,63600,88885,15912,0,1018000,51400,58863.0,320931.0,159920.0,206040.0,0.0,0.0,-924623.0,1785620.0,150600.0,667600.0
2024-10-21,3293,73763,55265,0,1473144,90000,45662,51265,0,486230,24000,28101,4000,0,986914,66000,128600.0,366593.0,201071.0,257305.0,0.0,0.0,-122341.0,2271850.0,-311400.0,691600.0
2024-10-22,3293,106100,11000,0,930631,265000,-16485,-5438,0,-197030,261000,122585,16438,0,1127661,4000,112172.0,350108.0,154051.0,251867.0,0.0,0.0,632801.0,2074820.0,33600.0,952600.0
2024-10-23,3293,137796,7000,0,533137,4000,-288,-2604,0,-675363,-51000,138084,9604,0,1208500,55000,37653.0,349820.0,73937.0,249263.0,0.0,0.0,-550451.0,1399457.0,296600.0,901600.0
2024-10-24,3293,107859,11000,0,1048284,0,-14337,-15116,0,559099,-106000,122196,26116,0,489185,106000,-9033.0,291598.0,40808.0,227087.0,0.0,0.0,139548.0,1700142.0,191600.0,819600.0
2024-10-25,3293,47145,21792,0,867255,7000,11615,-13208,0,-414850,-54000,35530,35000,0,1282105,61000,26167.0,270125.0,14899.0,194793.0,0.0,0.0,-241914.0,584336.0,74000.0,751600.0
2024-10-28,3293,113968,23080,0,1007474,17000,78682,20080,0,589447,-369000,35286,3000,0,418027,386000,59187.0,335820.0,-16286.0,178950.0,0.0,0.0,-138697.0,-100659.0,-319000.0,298600.0
2024-10-29,3293,44350,11003,0,961022,2000,-50640,-29100,0,359912,-17000,94990,40103,0,601110,19000,25032.0,212777.0,-39948.0,98356.0,0.0,0.0,418245.0,-241695.0,-597000.0,112600.0
2024-10-30,3293,66196,12000,0,571037,7500,-8875,-5098,0,-480605,-23500,75071,17098,0,1051642,31000,16445.0,275958.0,-42442.0,154604.0,0.0,0.0,613003.0,-548738.0,-569500.0,-1900.0
2024-11-01,3293,121710,20080,0,1091776,384000,34468,-11809,0,-169506,289000,87242,31889,0,1261282,95000,65250.0,307452.0,-39135.0,147895.0,0.0,0.0,-115602.0,-1017859.0,-174500.0,311100.0
2024-11-04,3293,70755,33000,0,327610,3000,-48567,20832,0,-435246,-106000,119322,12168,0,762856,109000,5068.0,210479.0,-5095.0,157198.0,0.0,0.0,-135998.0,-1263584.0,-226500.0,-315900.0
2024-11-05,3293,13020,9000,0,435906,2000,708,2900,0,84406,-4000,12312,6100,0,351500,6000,-72906.0,279604.0,-22275.0,154204.0,0.0,0.0,-641039.0,1073871.0,138500.0,-447900.0
2024-11-06,3293,78504,63000,0,1272204,1000,46449,45000,0,92346,-26000,32055,18000,0,1179858,27000,24183.0,297636.0,51825.0,185721.0,0.0,0.0,-908605.0,1473218.0,129500.0,-259900.0
2024-11-07,3293,159700,70000,0,943037,39000,-21299,62499,0,-1462966,0,180999,7501,0,2406003,39000,11759.0,287110.0,119422.0,270321.0,0.0,0.0,-1890966.0,14162.0,153000.0,-259900.0
2024-11-08,3293,50603,23000,0,986387,0,15778,6976,0,62645,-112000,34825,16024,0,923742,112000,-6931.0,243316.0,138207.0,278252.0,0.0,0.0,-1658815.0,-253539.0,-248000.0,-373900.0
2024-11-11,3293,28908,9000,0,1073002,5000,10424,5900,0,360002,-105000,18484,3100,0,713000,110000,52060.0,142158.0,123275.0,292999.0,0.0,0.0,-863567.0,-2166102.0,-247000.0,-248900.0
2024-11-12,3293,118100,0,0,978650,4000,-55738,-50922,0,-181439,4000,173838,50922,0,1160089,0,-4386.0,110495.0,69453.0,231963.0,0.0,0.0,-1129412.0,-2031489.0,-239000.0,-730900.0
2024-11-13,3293,36170,14109,0,779039,1000,14327,-14074,0,318539,-89000,21843,28183,0,460500,90000,-36508.0,124879.0,10379.0,176307.0,0.0,0.0,-903219.0,-760778.0,-302000.0,-735900.0
2024-11-14,3293,15100,4000,0,863380,49520,-2924,-9700,0,295680,-223480,18024,13700,0,567700,273000,-18133.0,47724.0,-61820.0,89097.0,0.0,0.0,855427.0,-972987.0,-525480.0,-645380.0
2024-11-15,3293,959000,92000,0,1176807,17000,-65543,-68653,0,-1998320,-958000,1024543,160653,0,3175127,975000,-99454.0,-50168.0,-137449.0,2431.0,0.0,0.0,-1205538.0,-2840407.0,-1371480.0,-1602380.0
2024-11-18,3293,291708,70437,0,2673622,113000,-39494,-92354,0,240301,-612000,331202,162791,0,2433321,725000,-149372.0,-66077.0,-235703.0,-102624.0,0.0,0.0,-1325239.0,-2566718.0,-1878480.0,-2277980.0
2024-11-19,3293,292110,101684,0,2336043,248000,154490,12273,0,985593,-1732294,137620,89411,0,1350450,1980294,60856.0,42751.0,-172508.0,-141616.0,0.0,0.0,-158207.0,-2067355.0,-3614774.0,-4034274.0
2024-11-20,3293,313000,89000,0,1334120,26000,-78879,-6298,0,-217338,-1054000,391879,95298,0,1551458,1080000,-32350.0,-19643.0,-164732.0,-142476.0,0.0,0.0,-694084.0,-2087663.0,-4579774.0,-5349274.0
2024-11-21,3293,57100,34000,0,2206041,96500,-3488,7132,0,1132993,-1155500,60588,26868,0,1073048,1252000,-32914.0,-22843.0,-147900.0,-132740.0,0.0,0.0,143229.0,-279307.0,-5511794.0,-6453774.0
2024-11-22,3293,83999,22868,0,2372997,8350,61814,-13452,0,951775,8350,22185,36320,0,1421222,0,94443.0,53308.0,-92699.0,-131076.0,0.0,0.0,3093324.0,113369.0,-4545444.0,-6339424.0
2024-11-25,3293,97000,48000,0,22885107,87035,-24576,34753,0,-183243,87035,121576,13247,0,23068350,0,109361.0,17117.0,34408.0,-83115.0,0.0,0.0,2669780.0,344976.0,-3846409.0,-6198389.0
2024-11-26,3293,485100,50000,0,759978,140000,-50341,1347,0,-1889835,139000,535441,48653,0,2649813,1000,-95470.0,-111906.0,23482.0,-101848.0,0.0,0.0,-205648.0,-2134306.0,-1975115.0,-5690389.0
2024-11-27,3293,13000,10000,0,945014,90000,3787,-67099,0,198454,46000,9213,77099,0,746560,44000,-12804.0,-57479.0,-37319.0,-139847.0,0.0,0.0,210144.0,-2295764.0,-875115.0,-5627389.0
2024-11-28,3293,146943,28060,0,676533,8499,-17745,-17179,0,-23093,8499,164688,45239,0,699626,0,-27061.0,-66349.0,-61630.0,-151928.0,0.0,0.0,-945942.0,-1838252.0,288884.0,-5595390.0
2024-11-29,3293,46687,14761,0,805589,136000,41487,-59022,0,227106,109000,5200,73783,0,578483,27000,-47388.0,-59330.0,-107200.0,-199141.0,0.0,0.0,-1670611.0,-1441640.0,389534.0,-5775390.0
2024-12-02,3293,56350,19246,0,954028,11000,22375,-900,0,204084,-60000,33975,20146,0,749944,71000,-437.0,11612.0,-142853.0,-220873.0,0.0,0.0,-1283284.0,-802310.0,242499.0,-5729390.0
2024-12-03,3293,37232,12068,0,805716,74000,-10843,-13700,0,-751920,-20000,48075,25768,0,1557636,94000,39061.0,61.0,-157900.0,-237473.0,0.0,0.0,-145369.0,-1638636.0,83499.0,-5745390.0
2024-12-04,3293,50062,48855,0,1090967,7000,29434,21100,0,17922,-116000,20628,27755,0,1073045,123000,64708.0,-16954.0,-69701.0,-261373.0,0.0,0.0,-325901.0,-1713060.0,-78501.0,-5835390.0
2024-12-05,3293,40839,34867,0,942318,6000,13435,12867,0,26637,-39000,27404,22000,0,915681,45000,95888.0,17780.0,-39655.0,-311005.0,0.0,0.0,-276171.0,-223457.0,-126000.0,-5874390.0
2024-12-06,3293,49082,15284,0,747560,0,488,11000,0,-383512,-18000,48594,4284,0,1131072,18000,54889.0,2490.0,30367.0,-306981.0,0.0,0.0,-886789.0,-669614.0,-253000.0,-5780390.0
2024-12-09,3293,88053,10998,0,1874115,2000,22813,-18002,0,1024478,-5400,65240,29000,0,849637,7400,55327.0,14879.0,13265.0,-330883.0,0.0,0.0,-66395.0,-5138.0,-198400.0,-5680790.0
2024-12-10,3293,132644,19209,0,844756,60000,-42195,-10800,0,-1214564,-27000,174839,30009,0,2059320,87000,23975.0,28422.0,16165.0,-290761.0,0.0,0.0,-529039.0,-1038263.0,-205400.0,-5711790.0
2024-12-11,3293,35993,4000,0,640844,0,25296,-15000,0,-114256,-45000,10697,19000,0,755100,45000,19837.0,39391.0,-19935.0,-291687.0,0.0,0.0,-661217.0,-1471058.0,-134400.0,-5667790.0
2024-12-12,3293,9478,4000,0,488553,11000,-10022,-10000,0,-262858,-49000,19500,14000,0,751411,60000,-3620.0,32293.0,-42802.0,-291987.0,0.0,0.0,-950712.0,-2029596.0,-144400.0,-5493310.0
2024-12-13,3293,28248,7998,0,681792,25000,11848,-3002,0,427839,-79000,16400,11000,0,253953,104000,7740.0,109684.0,-56804.0,-226336.0,0.0,0.0,-139361.0,396563.0,-205400.0,-4614310.0
2024-12-16,3293,42833,16039,0,339254,0,-38835,-26565,0,-885976,-155000,81668,42604,0,1225230,155000,-53908.0,110343.0,-65367.0,-160547.0,0.0,0.0,-2049815.0,-729714.0,-355000.0,-4157310.0
2024-12-17,3293,40133,5005,0,990744,11000,29133,-8095,0,137542,-15000,11000,13100,0,853202,26000,17420.0,-15014.0,-62662.0,-180915.0,0.0,0.0,-697709.0,-1577765.0,-343000.0,-2440016.0
2024-12-18,3293,7775,0,0,441185,0,-7225,-51000,0,183185,-26000,15000,51000,0,258000,26000,-15101.0,56640.0,-98662.0,-225617.0,0.0,0.0,-400268.0,-1177242.0,-324000.0,-1412016.0
2024-12-19,3293,27666,49100,0,443665,0,-14550,32400,0,-270335,-5000,42216,16700,0,714000,5000,-19629.0,45578.0,-56262.0,-200349.0,0.0,0.0,-407745.0,-2580570.0,-280000.0,-261516.0
2024-12-20,3293,16000,22000,0,599886,35000,-10793,10500,0,-898275,-164000,26793,11500,0,1498161,199000,-42270.0,-27029.0,-42760.0,-176397.0,0.0,0.0,-1733859.0,-4430620.0,-365000.0,-433866.0
2024-12-23,3293,24591,8000,0,493481,0,7345,2340,0,-6519,-35000,17246,5660,0,500000,35000,3910.0,4892.0,-13855.0,-208810.0,0.0,0.0,-854402.0,-4253896.0,-245000.0,-555901.0
2024-12-24,3293,43699,10000,0,92109,0,-22186,7000,0,-146251,-188000,65885,3000,0,238360,188000,-47409.0,33047.0,1240.0,-203157.0,0.0,0.0,-1138195.0,-2510312.0,-418000.0,-882901.0
2024-12-25,3293,105100,5000,0,91142,0,-22879,-727,0,-275443,-163000,127979,5727,0,366585,163000,-63063.0,6381.0,51513.0,-136785.0,0.0,0.0,-1596823.0,-2984209.0,-555000.0,-1091901.0
2024-12-26,3293,91567,16100,0,140069,17000,-2587,8494,0,-105047,-99000,94154,7606,0,245116,116000,-51100.0,21539.0,27607.0,-111112.0,0.0,0.0,-1431535.0,-3066163.0,-649000.0,-1199400.0
2024-12-27,3293,40290,10438,0,162740,0,14043,9500,0,-9063,-26000,26247,938,0,171803,26000,-26264.0,-5905.0,26607.0,-42590.0,0.0,0.0,-542323.0,-3302332.0,-511000.0,-1334400.0
2024-12-30,3293,114000,6000,0,172103,0,-34130,-4478,0,-328198,-95000,148130,10478,0,500301,95000,-67739.0,-62410.0,19789.0,-46168.0,0.0,0.0,-864002.0,-3834614.0,-571000.0,-1369400.0
2024-12-31,3293,92430,9000,0,460150,25000,9247,-3338,0,-150462,-12000,83183,12338,0,610612,37000,-36306.0,-42320.0,9451.0,-35806.0,0.0,0.0,-868213.0,-3233156.0,-395000.0,-1361400.0
2025-01-02,3293,34000,9374,0,282278,20000,-20676,-12328,0,-100722,19000,54676,21702,0,383000,1000,-34103.0,-92430.0,-2150.0,-69234.0,0.0,0.0,-693492.0,-3351800.0,-213000.0,-1226400.0
2025-01-03,3293,47383,16128,0,621467,40000,41465,7774,0,284392,24000,5918,8354,0,337075,16000,9949.0,-64400.0,-2870.0,-74327.0,0.0,0.0,-304053.0,-3094045.0,-90000.0,-1163400.0
2025-01-06,3293,47892,14178,0,417516,19000,854,6895,0,-148880,-16000,47038,7283,0,566396,35000,-3240.0,-64034.0,-5475.0,-78432.0,0.0,0.0,-443870.0,-2859413.0,-80000.0,-1161400.0
2025-01-07,3293,13000,11129,0,419212,0,-14410,-5995,0,-50264,-30000,27410,17124,0,469476,30000,16480.0,-101257.0,-6992.0,-66425.0,0.0,0.0,-165936.0,-3934155.0,-15000.0,-1186000.0
2025-01-08,3293,56000,4266,0,375736,16000,-6852,-31392,0,-152501,-78000,62852,35658,0,528237,94000,381.0,-65914.0,-35046.0,-87017.0,0.0,0.0,-167975.0,-2872092.0,-81000.0,-1237000.0
2025-01-09,3293,35488,68,0,254120,0,-26916,-10849,0,-99880,-113000,62404,10917,0,354000,113000,-5859.0,-118126.0,-33567.0,-82866.0,0.0,0.0,-167133.0,-2857716.0,-213000.0,-1305000.0
2025-01-10,3293,117000,5000,0,85143,0,-13371,-9422,0,-521430,-112000,130371,14422,0,606573,112000,-60695.0,-121475.0,-50763.0,-82288.0,0.0,0.0,-972955.0,-3116288.0,-349000.0,-1368000.0
2025-01-13,3293,98101,29000,0,437700,0,-47771,-5156,0,-72325,-38000,145872,34156,0,510025,38000,-109320.0,-181094.0,-62814.0,-84442.0,0.0,0.0,-896400.0,-3616452.0,-371000.0,-1327000.0
2025-01-14,3293,23370,10000,0,453686,0,260,-6302,0,-139955,-90000,23110,16302,0,593641,90000,-94650.0,-141999.0,-63121.0,-64179.0,0.0,0.0,-986091.0,-2870431.0,-431000.0,-1262000.0
2025-01-15,3293,185331,75000,0,156369,0,-125039,-255859,0,-498631,-31000,310370,330859,0,655000,31000,-212837.0,-296171.0,-287588.0,-311943.0,0.0,0.0,-1332221.0,-3506604.0,-384000.0,-1278000.0
2025-01-16,3293,124014,49000,0,1187319,0,65662,21656,0,560275,-274000,58352,27344,0,627044,274000,-120259.0,-223284.0,-255083.0,-239287.0,0.0,0.0,-672066.0,-3129514.0,-545000.0,-1526000.0
2025-01-17,3293,27171,10000,0,335776,353000,-32596,-15241,0,-284244,267140,59767,25241,0,620020,85860,-139484.0,-241330.0,-260902.0,-286928.0,0.0,0.0,-434880.0,-3143423.0,-165860.0,-1253860.0
2025-01-20,3293,24698,10383,0,466750,8000,6439,-5700,0,208948,-7000,18259,16083,0,257802,15000,-85274.0,-224098.0,-261446.0,-303128.0,0.0,0.0,-153607.0,-2036200.0,-134860.0,-1096860.0
2025-01-21,3293,27200,9000,0,218023,1000,-24593,4600,0,-88329,-196000,51793,4400,0,306352,197000,-110127.0,-256036.0,-250544.0,-300868.0,0.0,0.0,-101981.0,-2118010.0,-240860.0,-1257860.0
2025-01-22,3293,20437,49000,0,596654,0,-10393,34449,0,71577,-77000,30830,14551,0,525077,77000,4519.0,-244243.0,39764.0,-273419.0,0.0,0.0,468227.0,-1900182.0,-286860.0,-1146860.0
2025-02-03,3293,224000,28000,0,432106,2200,-12989,-4593,0,-537267,-104550,236989,32593,0,969373,106750,-74132.0,-234353.0,13515.0,-277285.0,0.0,0.0,-629315.0,-2162006.0,-117410.0,-1088410.0
2025-02-04,3293,123200,44000,0,372288,16500,4313,25012,0,-359012,-81000,118887,18988,0,731300,97500,-37223.0,-227453.0,53768.0,-260767.0,0.0,0.0,-704083.0,-2415971.0,-465550.0,-1070410.0
2025-02-05,3293,42182,35000,0,479201,28680,9088,19488,0,-45960,-297320,33094,15512,0,525161,326000,-34574.0,-232408.0,78956.0,-250779.0,0.0,0.0,-958991.0,-2452868.0,-755870.0,-1341730.0
2025-02-06,3293,89000,24000,0,271761,0,40,2028,0,-405192,-177000,88960,21972,0,676953,177000,-9941.0,-198238.0,76384.0,-244273.0,0.0,0.0,-1275854.0,-2529862.0,-736870.0,-1423730.0
2025-02-07,3293,19012,14000,0,458650,38000,-1543,-973,0,-219808,-137000,20555,14973,0,678458,175000,-1091.0,-209028.0,40962.0,-241908.0,0.0,0.0,-1567239.0,-2599208.0,-796870.0,-1548730.0
2025-02-10,3293,50271,25000,0,303230,3000,-6511,659,0,-187439,-94000,56782,24341,0,490669,97000,5387.0,-194863.0,46214.0,-228921.0,0.0,0.0,-1217411.0,-2685925.0,-786320.0,-1661730.0
2025-02-11,3293,37871,16000,0,572139,0,6476,2505,0,184939,-329000,31395,13495,0,387200,329000,7550.0,-229852.0,23707.0,-234190.0,0.0,0.0,-673460.0,-2785378.0,-1034320.0,-2014730.0
2025-02-12,3293,75652,14000,0,264189,5000,3542,-1680,0,-323692,-152000,72110,15680,0,587881,157000,2004.0,-227164.0,2539.0,-242765.0,0.0,0.0,-951192.0,-2960190.0,-889000.0,-2150730.0
2025-02-13,3293,18544,10000,0,360252,3900,12173,1105,0,55916,-8100,6371,8895,0,304336,12000,14137.0,-200581.0,1616.0,-235665.0,0.0,0.0,-490084.0,-2854010.0,-720100.0,-2128830.0
2025-02-14,3293,14656,10000,0,474135,2000,-3979,-3211,0,164680,-53000,18635,13211,0,309455,55000,11701.0,-197708.0,-622.0,-207484.0,0.0,0.0,-105596.0,-2536829.0,-636100.0,-2103830.0
2025-02-17,3293,74197,22000,0,926090,1000,70074,2867,0,355887,-24000,4123,19133,0,570203,25000,88286.0,-100718.0,1586.0,-193768.0,0.0,0.0,437730.0,-2081062.0,-566100.0,-2014830.0
2025-02-18,3293,10124,34057,0,364752,0,-42698,18337,0,-199225,-32000,52822,15720,0,563977,32000,39112.0,-130045.0,17418.0,-166009.0,0.0,0.0,53566.0,-1758857.0,-269100.0,-1934830.0
2025-02-19,3293,11924,5000,0,252426,1000,-31842,-73613,0,-58606,-41000,43766,78613,0,311032,42000,3728.0,-114116.0,-54515.0,-234466.0,0.0,0.0,318652.0,-1745138.0,-158100.0,-1937830.0
2025-02-20,3293,12242,51000,0,733069,0,6705,42955,0,59648,-31000,5537,8045,0,673421,31000,-1740.0,-107671.0,-12665.0,-185209.0,0.0,0.0,322384.0,-1545535.0,-181000.0,-1878830.0
2025-02-21,3293,20638,44400,0,356374,1000,3826,39096,0,-864,-26000,16812,5304,0,357238,27000,6065.0,21194.0,29642.0,109746.0,0.0,0.0,156840.0,-1047768.0,-154000.0,-1873830.0
2025-02-24,3293,282625,164409,0,1237201,27000,186902,148337,0,76920,-8000,95723,16072,0,1160281,35000,122893.0,142434.0,175112.0,236427.0,0.0,0.0,-122127.0,-1531123.0,-138000.0,-1607830.0
2025-02-25,3293,129688,129444,0,923445,91000,25849,80677,0,-439735,81000,103839,48767,0,1363180,10000,191440.0,200879.0,237452.0,332345.0,0.0,0.0,-362637.0,-1686614.0,-25000.0,-1793970.0
2025-02-26,3293,54407,28564,0,689918,25000,-58097,21933,0,-70528,6000,112504,6631,0,760446,19000,165185.0,136343.0,332998.0,359978.0,0.0,0.0,-374559.0,-1966090.0,22000.0,-1780970.0
2025-02-27,3293,34115,27200,0,2721701,101064,-2452,-8800,0,205532,75064,36567,36000,0,2516169,26000,156028.0,158484.0,281243.0,346578.0,0.0,0.0,-228675.0,-1672229.0,128064.0,-1509906.0
2025-03-03,3293,183459,75200,0,1147559,124000,-7627,32364,0,-921946,114000,191086,42836,0,2069505,10000,144575.0,161250.0,274511.0,344493.0,0.0,0.0,-1149757.0,-2665752.0,268064.0,-1318906.0
2025-03-04,3293,171309,59000,0,525651,67000,-16450,-47792,0,-526606,34000,187759,106792,0,1052257,33000,-58777.0,157789.0,78382.0,301294.0,0.0,0.0,-1753283.0,-2655091.0,310064.0,-1180356.0
2025-03-05,3293,76910,8726,0,924114,69000,58398,-20274,0,343534,54000,18512,29000,0,580580,15000,-26228.0,211874.0,-22569.0,256008.0,0.0,0.0,-970014.0,-1952545.0,283064.0,-1045356.0
2025-03-06,3293,324056,110880,0,1657549,83000,75464,52880,0,944981,52000,248592,58000,0,712568,31000,107333.0,278250.0,8378.0,289400.0,0.0,0.0,45495.0,-961604.0,329064.0,-696036.0
2025-03-07,3293,385962,96000,0,1020605,140000,-92125,-42419,0,-1804215,51000,478087,138419,0,2824820,89000,17660.0,186085.0,-25241.0,244953.0,0.0,0.0,-1964252.0,-2360627.0,305000.0,-468036.0
2025-03-10,3293,171515,39000,0,401446,35000,-63039,6666,0,-485407,-27000,234554,32334,0,886853,62000,-37752.0,124589.0,-50939.0,252592.0,0.0,0.0,-1527713.0,-2626226.0,164000.0,-358036.0
2025-03-11,3293,458206,114000,0,915455,18000,-85860,-121510,0,-540080,0,544066,235510,0,1455535,18000,-107162.0,45240.0,-124657.0,130423.0,0.0,0.0,-1541187.0,-2978867.0,130000.0,-264036.0
2025-03-12,3293,423341,54000,0,648741,0,-79132,-175825,0,-418811,-19000,502473,229825,0,1067552,19000,-244692.0,-40368.0,-280208.0,-47907.0,0.0,0.0,-2303532.0,-3582617.0,57000.0,45964.0
2025-03-13,3293,368578,41000,0,1003365,0,-43187,-254144,0,-275690,-11000,411765,295144,0,1279055,11000,-363343.0,-87097.0,-587232.0,-300371.0,0.0,0.0,-3524203.0,-3534615.0,-6000.0,186964.0
2025-03-14,3293,180615,37000,0,1098864,5000,-2221,-14377,0,42658,-131000,182836,51377,0,1056206,136000,-273439.0,-101491.0,-559190.0,-315853.0,0.0,0.0,-1677330.0,-3547873.0,-188000.0,64064.0
2025-03-17,3293,60239,21000,0,544245,6000,-14953,-4627,0,-225940,-93000,75192,25627,0,770185,99000,-225353.0,-112465.0,-570483.0,-317269.0,0.0,0.0,-1417863.0,-3938493.0,-254000.0,24064.0
2025-03-18,3293,55385,47301,0,920256,0,24624,25739,0,426251,-10000,30761,21562,0,494005,10000,-114869.0,-157915.0,-423234.0,-294397.0,0.0,0.0,-451532.0,-3868129.0,-264000.0,38064.0
2025-03-19,3293,27920,46300,0,658242,1000,-137742,-8247,0,-77085,-2000,165662,54547,0,735327,3000,-173479.0,-252959.0,-255656.0,-320981.0,0.0,0.0,-109806.0,-3745989.0,-247000.0,68064.0
2025-03-20,3293,24156,19225,0,762936,1000,21547,15490,0,62396,-48000,2609,3735,0,700540,49000,-108745.0,-199570.0,13978.0,-231878.0,0.0,0.0,228280.0,-3624987.0,-284000.0,61064.0
2025-03-21,3293,67839,18000,0,751311,0,-12531,17513,0,-368049,-64000,80370,487,0,1119360,64000,-119055.0,-218806.0,45868.0,-257320.0,0.0,0.0,-182427.0,-4052684.0,-217000.0,28064.0
2025-03-24,3293,55746,16000,0,342225,0,-13659,10811,0,-126061,-121000,69405,5189,0,468286,121000,-117761.0,-236291.0,61306.0,-285605.0,0.0,0.0,-82548.0,-4177881.0,-245000.0,-66936.0
2025-03-25,3293,23994,15000,0,356027,0,3977,10376,0,-30963,-78000,20017,4624,0,386990,78000,-138408.0,-419216.0,45943.0,-423566.0,0.0,0.0,-539762.0,-4285764.0,-313000.0,-136936.0
2025-03-26,3293,250060,73000,0,763311,47000,-6909,28100,0,-907167,-355000,256969,44900,0,1670478,402000,-7575.0,-451974.0,82290.0,-476143.0,0.0,0.0,-1369844.0,-4753196.0,-666000.0,-572936.0
2025-03-27,3293,68076,14000,0,1071591,7000,-81,2049,0,163070,-71000,68157,11951,0,908521,78000,-29203.0,-393958.0,68849.0,-496027.0,0.0,0.0,-1269170.0,-4519598.0,-689000.0,-649936.0
2025-03-28,3293,35132,9000,0,428229,2000,-4466,-26100,0,40404,-110000,39598,35100,0,387825,112000,-21138.0,-395972.0,25236.0,-513327.0,0.0,0.0,-860717.0,-4684726.0,-735000.0,-835000.0
2025-03-31,3293,155815,42000,0,1135675,206000,-34495,-73611,0,549444,191000,190310,115611,0,586231,15000,-41974.0,-422840.0,-59186.0,-619302.0,0.0,0.0,-185212.0,-3213336.0,-423000.0,-758000.0
2025-04-01,3293,32389,7600,0,651004,3000,25783,-16773,0,371504,3000,6606,24373,0,279500,0,-20168.0,-380607.0,-86335.0,-588283.0,0.0,0.0,217255.0,-2315226.0,-342000.0,-789000.0
2025-04-02,3293,18073,47000,0,472314,0,-5277,7110,0,-41613,0,23350,39890,0,513927,0,-18536.0,-444282.0,-107325.0,-560899.0,0.0,0.0,1082809.0,-2700373.0,13000.0,-843000.0
2025-04-07,3293,212,0,0,206430,3000,-39467,-2000,0,204046,3000,39679,2000,0,2384,0,-57922.0,-559213.0,-111374.0,-615779.0,0.0,0.0,1123785.0,-3441308.0,87000.0,-892000.0
2025-04-08,3293,144917,87944,0,1913081,18000,-26748,35012,0,459957,0,171665,52932,0,1453124,18000,-80204.0,-493836.0,-50262.0,-538348.0,0.0,0.0,1543338.0,-1177136.0,197000.0,-943000.0
2025-04-09,3293,199092,34537,0,2192237,248000,7227,-142337,0,209563,228700,191865,176874,0,1982674,19300,-38482.0,-423570.0,-118988.0,-687351.0,0.0,0.0,1203457.0,-482166.0,234700.0,-687300.0
2025-04-10,3293,46000,0,0,120141,0,45882,0,0,44360,0,118,0,0,75781,0,-18383.0,-291828.0,-102215.0,-565841.0,0.0,0.0,876313.0,102274.0,231700.0,-687300.0
2025-04-11,3293,121916,26219,0,1927853,89000,65868,-14128,0,628961,73000,56048,40347,0,1298892,16000,52762.0,-146828.0,-123453.0,-404144.0,0.0,0.0,1546887.0,1150046.0,304700.0,-595300.0
2025-04-14,3293,204564,17236,0,811291,48000,1109,-4623,0,-1247542,37000,203455,21859,0,2058833,11000,93338.0,-102532.0,-126076.0,-154623.0,0.0,0.0,95299.0,178194.0,338700.0,-547300.0
2025-04-15,3293,43658,7000,0,1068422,57000,-2699,4000,0,-15585,53000,46357,3000,0,1084007,4000,117387.0,-103010.0,-157088.0,-136246.0,0.0,0.0,-380243.0,119951.0,391700.0,-363300.0
2025-04-16,3293,148807,10897,0,2019295,36000,-24531,-40184,0,1205764,30000,173338,51081,0,813531,6000,85629.0,-112588.0,-54935.0,-171803.0,0.0,0.0,615958.0,1551655.0,193000.0,-240300.0
2025-04-17,3293,77606,9060,0,1180159,129000,14114,320,0,553499,128216,63492,8740,0,626660,784,53861.0,-123098.0,-54615.0,-197222.0,0.0,0.0,1125097.0,1678903.0,321216.0,-102084.0
2025-04-18,3293,28526,25000,0,563300,116000,-5653,17705,0,-156930,72587,34179,7295,0,720230,43413,-17660.0,8991.0,-22782.0,-171270.0,0.0,0.0,339206.0,1599058.0,320803.0,-27497.0
2025-04-21,3293,21108,5000,0,1032670,54000,-44130,-27131,0,372447,-250000,65238,32131,0,660223,304000,-62899.0,-56686.0,-45290.0,-213891.0,0.0,0.0,1959195.0,1909109.0,33803.0,-229497.0
2025-04-22,3293,49983,12000,0,1036029,21000,-29047,2811,0,30611,-345000,79030,9189,0,1005418,366000,-89247.0,-73202.0,-46479.0,-228593.0,0.0,0.0,2005391.0,2307769.0,-364197.0,-510497.0
2025-04-23,3293,23772,5000,0,811492,24000,-1502,-8226,0,29328,-74000,25274,13226,0,782164,98000,-66218.0,-61045.0,-14521.0,-247630.0,0.0,0.0,828955.0,2463158.0,-468197.0,-463497.0
2025-04-24,3293,32885,5000,0,930634,7000,18987,-1000,0,303181,6000,13898,6000,0,627453,1000,-61345.0,-46035.0,-15841.0,-259006.0,0.0,0.0,578637.0,2797302.0,-590413.0,-379497.0
2025-04-25,3293,28722,6072,0,531684,12000,4729,-6928,0,307384,12000,23993,13000,0,224300,0,-50963.0,-34397.0,-40474.0,-294034.0,0.0,0.0,1042951.0,4011853.0,-651000.0,-12497.0
2025-04-28,3293,11824,4058,0,519420,0,6796,-1942,0,-66864,0,5028,6000,0,586284,0,-37.0,-27520.0,-15285.0,-298025.0,0.0,0.0,603640.0,3781919.0,-401000.0,58503.0
2025-04-29,3293,82866,4000,0,1405612,21000,27439,-2252,0,886422,20000,55427,6252,0,519190,1000,56449.0,4385.0,-20348.0,-274177.0,0.0,0.0,1459451.0,4627937.0,-36000.0,188503.0
2025-04-30,3293,14429,1011,0,688210,9000,-17349,-2035,0,302306,-189000,31778,3046,0,385904,198000,40602.0,21531.0,-14157.0,-202601.0,0.0,0.0,1732429.0,4380799.0,-151000.0,-191497.0
2025-05-02,3293,77275,11007,0,887989,9000,37643,-993,0,734787,-2000,39632,12000,0,153202,11000,59258.0,33391.0,-14150.0,-186821.0,0.0,0.0,2164035.0,4744082.0,-159000.0,-196497.0
2025-05-05,3293,43194,4000,0,742164,0,-93669,-1029,0,87261,-37000,136863,5029,0,654903,37000,-39140.0,-55001.0,-8251.0,-194960.0,0.0,0.0,1943912.0,4872956.0,-208000.0,-233497.0
2025-05-06,3293,107902,7100,0,1323536,100000,55902,-1190,0,1020876,93000,52000,8290,0,302660,7000,9966.0,40368.0,-7499.0,-194150.0,0.0,0.0,3031652.0,5689786.0,-115000.0,-143497.0
2025-05-07,3293,62406,5007,0,846945,52000,-32416,787,0,-140974,50000,94822,4220,0,987919,2000,-49889.0,34700.0,-4460.0,-228375.0,0.0,0.0,2004256.0,5088855.0,-85000.0,-93497.0
2025-05-08,3293,25141,7000,0,887857,12000,16812,2000,0,524855,12000,8329,5000,0,363002,0,-15728.0,44285.0,-425.0,-84038.0,0.0,0.0,2226805.0,5404147.0,116000.0,-310197.0
2025-05-09,3293,195734,36400,0,726174,90000,132243,24396,0,-353413,78000,63491,12004,0,1079587,12000,78872.0,130646.0,24964.0,-59642.0,0.0,0.0,1138605.0,5006374.0,196000.0,-232197.0
2025-05-12,3293,40832,7000,0,506654,134000,-20932,4924,0,-166443,122000,61764,2076,0,673097,12000,151609.0,43846.0,30917.0,-40590.0,0.0,0.0,884901.0,4210970.0,355000.0,-183197.0
2025-05-13,3293,121913,40810,0,1521623,186000,37779,24780,0,837734,172000,84134,16030,0,683889,14000,133486.0,80516.0,56887.0,-11187.0,0.0,0.0,701759.0,6296246.0,434000.0,-48197.0
2025-05-14,3293,57630,64000,0,484339,92000,-21674,58467,0,-804915,79000,79304,5533,0,1289254,13000,144228.0,61541.0,114567.0,43280.0,0.0,0.0,37818.0,5506916.0,463000.0,-22197.0
2025-05-15,3293,27772,6000,0,399069,69000,-21808,-12059,0,-537863,-19000,49580,18059,0,936932,88000,105608.0,64264.0,100508.0,71405.0,0.0,0.0,-1024900.0,3763289.0,432000.0,-71197.0
2025-05-16,3293,71383,7000,0,808888,136000,57416,-6500,0,553234,126000,13967,13500,0,255654,10000,30781.0,107566.0,69612.0,64585.0,0.0,0.0,-118253.0,3763024.0,480000.0,-73413.0
2025-05-19,3293,47065,21000,0,507378,0,-76918,4503,0,-54884,-23000,123983,16497,0,562262,23000,-25205.0,36301.0,69191.0,51383.0,0.0,0.0,-6694.0,3865070.0,335000.0,-169000.0
2025-05-20,3293,31535,1000,0,795063,6000,18313,-18000,0,407533,-39000,13222,19000,0,387530,45000,-44671.0,98744.0,26411.0,60514.0,0.0,0.0,-436895.0,3900156.0,124000.0,42000.0
2025-05-21,3293,52981,5000,0,509019,30000,-45879,-6569,0,-61632,18000,98860,11569,0,570651,12000,-68876.0,81912.0,-38625.0,51134.0,0.0,0.0,306388.0,3807913.0,63000.0,405000.0
2025-05-22,3293,59085,6000,0,539739,0,-11358,5058,0,93649,-223000,70443,942,0,446090,223000,-58426.0,72056.0,-21508.0,64418.0,0.0,0.0,937900.0,3872234.0,-141000.0,256000.0
2025-05-23,3293,45274,3000,0,632894,0,-29070,-7039,0,114534,-51000,74344,10039,0,518360,51000,-144912.0,23999.0,-22047.0,58379.0,0.0,0.0,499200.0,3683587.0,-318000.0,199000.0
2025-05-26,3293,4002,0,0,367505,27000,-50905,-207,0,69386,0,54907,207,0,298119,27000,-118899.0,-31635.0,-26757.0,65100.0,0.0,0.0,623470.0,3445589.0,-295000.0,187000.0
2025-05-27,3293,20097,9000,0,239703,0,-13344,3999,0,35343,-49000,33441,5001,0,204360,49000,-150556.0,-51775.0,-4758.0,71041.0,0.0,0.0,251280.0,3547796.0,-305000.0,138000.0
2025-05-28,3293,4065,2000,0,511541,4000,-15053,-4010,0,183323,-107000,19118,6010,0,328218,111000,-119730.0,-94267.0,-2199.0,69283.0,0.0,0.0,496235.0,2844697.0,-430000.0,11000.0
2025-05-29,3293,48281,7000,0,1117999,18,23260,2000,0,-17034,-109982,25021,5000,0,1135033,110000,-85112.0,-53658.0,-5257.0,73318.0,0.0,0.0,385552.0,2525357.0,-316982.0,90018.0
2025-06-02,3293,57173,0,0,617474,0,-56194,-3178,0,-58202,-279000,113367,3178,0,675676,279000,-112236.0,-147495.0,-1396.0,71133.0,0.0,0.0,212816.0,1732368.0,-544982.0,-186982.0
2025-06-03,3293,39822,2000,0,1885089,0,8586,-3098,0,1496473,-1522000,31236,5098,0,388616,1522000,-52745.0,-45240.0,-4287.0,69064.0,0.0,0.0,1639903.0,3141580.0,-2066982.0,-1671982.0
2025-06-04,3293,25000,8000,0,697614,0,11042,-1000,0,303131,-480000,13958,9000,0,394483,480000,-28359.0,-90100.0,-9286.0,69254.0,0.0,0.0,1907691.0,2423835.0,-2497982.0,-2244982.0
2025-06-05,3293,122046,6000,0,1706071,8000,111793,-4000,0,1374827,-40000,10253,10000,0,331244,48000,98487.0,54109.0,-9276.0,64467.0,0.0,0.0,3099195.0,3939636.0,-2430982.0,-2334982.0
2025-06-06,3293,46075,8000,0,380554,23500,-72221,-2000,0,-545181,14500,118296,10000,0,925735,9000,3006.0,-34924.0,-13276.0,60467.0,0.0,0.0,2571048.0,2869600.0,-2306500.0,-2332482.0
2025-06-09,3293,24019,2000,0,380259,1000,12590,0,0,-149859,-7000,11429,2000,0,530118,8000,71790.0,-154577.0,-10098.0,36071.0,0.0,0.0,2479391.0,3073154.0,-2034500.0,-2417482.0
2025-06-10,3293,41027,8000,0,733363,0,34813,4000,0,472765,-49000,6214,4000,0,260598,49000,98017.0,-98832.0,-3000.0,35147.0,0.0,0.0,1455683.0,3712362.0,-561500.0,-2588482.0
2025-06-11,3293,104340,19713,0,1197318,11000,77266,15713,0,959469,-45000,27074,4000,0,237849,56000,164241.0,-59345.0,13713.0,26080.0,0.0,0.0,2112021.0,3834097.0,-126500.0,-2805482.0
2025-06-12,3293,26359,0,0,634754,28000,-28210,-12000,0,521697,23000,54569,12000,0,113057,5000,24238.0,-65881.0,5713.0,-44387.0,0.0,0.0,1258891.0,5160709.0,-63500.0,-2861482.0
2025-06-13,3293,30856,3000,0,1058533,4000,-38724,-2146,0,802533,1000,69580,5146,0,256000,3000,57735.0,-82797.0,5567.0,-34474.0,0.0,0.0,2606605.0,6501105.0,-77000.0,-2841482.0
2025-06-16,3293,187177,49041,0,1493394,3000,71092,36041,0,1195314,1000,116085,13000,0,298080,2000,116237.0,-69121.0,41608.0,8067.0,0.0,0.0,3951778.0,7143185.0,-69000.0,-2966482.0
2025-06-17,3293,28844,13807,0,752217,15000,-71590,6407,0,299040,8000,100434,7400,0,453177,7000,9834.0,-63793.0,44015.0,9971.0,0.0,0.0,3778053.0,7497109.0,-12000.0,-2935482.0
2025-06-18,3293,25511,6731,0,857573,7000,-33651,-1446,0,117348,-24000,59162,8177,0,740225,31000,-101083.0,-115757.0,26856.0,26525.0,0.0,0.0,2935932.0,7206924.0,9000.0,-2920482.0
2025-06-19,3293,13129,21022,0,873108,2000,-37413,15501,0,286312,-102000,50542,5521,0,586796,104000,-110286.0,-107291.0,54357.0,48595.0,0.0,0.0,2700547.0,7554868.0,-116000.0,-3040482.0
2025-06-20,3293,5581,26000,0,4125626,3000,-6059,13000,0,514346,3000,11640,13000,0,3611280,0,-77621.0,-101992.0,69503.0,56537.0,0.0,0.0,2412360.0,7975565.0,-114000.0,-2814482.0
2025-06-23,3293,20362,2000,0,664536,2000,-3548,1000,0,-387147,-19000,23910,1000,0,1051683,21000,-152261.0,-76470.0,34462.0,64576.0,0.0,0.0,829899.0,7473884.0,-134000.0,-2782482.0
2025-06-24,3293,41136,1000,0,575651,0,4204,0,0,-160518,-33000,36932,1000,0,736169,33000,-76467.0,-21361.0,28055.0,64783.0,0.0,0.0,370341.0,7243980.0,-175000.0,-2815482.0
2025-06-25,3293,16874,3000,0,517169,2050,16037,-1000,0,-13711,-12950,837,4000,0,530880,15000,-26779.0,8020.0,28501.0,59784.0,0.0,0.0,239282.0,7194926.0,-163950.0,-2779432.0
2025-06-26,3293,3144,2000,0,396337,0,-58937,-30025,0,105024,-1000,62081,32025,0,291313,1000,-48303.0,-35864.0,-17025.0,33769.0,0.0,0.0,57994.0,7116627.0,-62950.0,-2673432.0
2025-06-27,3293,15133,0,0,515420,2000,2267,-64373,0,121046,-3000,12866,64373,0,394374,5000,-39977.0,-56857.0,-94398.0,-32604.0,0.0,0.0,-335306.0,7254707.0,-68950.0,-2566450.0
2025-06-30,3293,34411,3000,0,326144,0,-23109,-26689,0,-401344,-33000,57520,29689,0,727488,33000,-59538.0,-23772.0,-122087.0,-56115.0,0.0,0.0,-349503.0,6911565.0,-82950.0,-2320450.0
2025-07-01,3293,33233,5000,0,341401,0,8268,-637,0,-35621,-106000,24965,5637,0,377022,106000,-55474.0,-24090.0,-122724.0,-53654.0,0.0,0.0,-224606.0,5379471.0,-155950.0,-904450.0
2025-07-02,3293,52498,6000,0,326919,0,46307,5000,0,49819,-23000,6191,1000,0,277100,23000,-25204.0,11175.0,-116724.0,-47654.0,0.0,0.0,-161076.0,5126159.0,-166000.0,-447450.0
2025-07-03,3293,3409,2000,0,203502,0,-60849,738,0,-158498,-23000,64258,1262,0,362000,23000,-27116.0,-161467.0,-85961.0,-42916.0,0.0,0.0,-424598.0,3592834.0,-188000.0,-430450.0
2025-07-04,3293,18061,20000,0,192505,0,-31351,7123,0,-123495,-28000,49412,12877,0,316000,28000,-60734.0,-120597.0,-14465.0,-33793.0,0.0,0.0,-669139.0,4014520.0,-213000.0,-472950.0
2025-07-07,3293,30443,4000,0,123422,5000,-17862,-7447,0,-190638,-75000,48305,11447,0,314060,80000,-55487.0,-151049.0,4777.0,-41240.0,0.0,0.0,-458433.0,3973741.0,-255000.0,-540950.0
2025-07-08,3293,40165,12000,0,300313,0,-14175,-4200,0,20229,-6000,54340,16200,0,280084,6000,-77930.0,-200037.0,1214.0,-49440.0,0.0,0.0,-402583.0,3521205.0,-155000.0,-497950.0
2025-07-09,3293,25275,15000,0,395693,0,-15360,7321,0,-423809,-3000,40635,7679,0,819502,3000,-139597.0,-292663.0,3535.0,-57832.0,0.0,0.0,-876211.0,2137927.0,-135000.0,-455950.0
2025-07-10,3293,20000,11000,0,190262,3000,-2422,-83,0,-671798,-66000,22422,11083,0,862060,69000,-81170.0,-266875.0,2714.0,-45915.0,0.0,0.0,-1389511.0,944432.0,-178000.0,-544950.0
2025-07-11,3293,89100,17000,0,545680,0,14096,3684,0,-122751,-193000,75004,13316,0,668431,193000,-35723.0,-214055.0,-725.0,-40085.0,0.0,0.0,-1388767.0,19148.0,-343000.0,-738950.0
2025-07-14,3293,67000,1000,0,214184,0,1247,800,0,-480214,-70000,65753,200,0,694398,70000,-16614.0,-283900.0,7522.0,-75326.0,0.0,0.0,-1678343.0,-1656380.0,-338000.0,-809950.0
2025-07-15,3293,79000,8000,0,344798,17000,-5552,-6232,0,-386431,-26000,84552,14232,0,731229,43000,-7991.0,-217862.0,5490.0,-87965.0,0.0,0.0,-2085003.0,-2341851.0,-358000.0,-843950.0
2025-07-16,3293,126465,44000,0,351805,1000,71607,14955,0,-463459,-70000,54858,29045,0,815264,71000,78976.0,-112604.0,13124.0,-71564.0,0.0,0.0,-2124653.0,-2922658.0,-425000.0,-889950.0
2025-07-17,3293,202560,52000,0,367309,12000,47986,39748,0,-361690,-12000,154574,12252,0,728999,24000,129384.0,-27205.0,52955.0,-47317.0,0.0,0.0,-1814545.0,-3570660.0,-371000.0,-799950.0
2025-07-18,3293,94000,10000,0,130201,11000,-91884,-7049,0,-591099,-61000,185884,17049,0,721300,72000,23404.0,-113030.0,42222.0,-67366.0,0.0,0.0,-2282893.0,-4676105.0,-239000.0,-863950.0
2025-07-21,3293,119000,11000,0,98513,29000,-12154,-3036,0,-503224,-46000,131154,14036,0,601737,75000,10003.0,-121636.0,38386.0,-71402.0,0.0,0.0,-2305903.0,-4792182.0,-215000.0,-890950.0
2025-07-22,3293,257477,19000,0,268839,129000,21708,-21429,0,-887851,101000,235769,40429,0,1156690,28000,37263.0,-104132.0,23189.0,-92831.0,0.0,0.0,-2807323.0,-5519515.0,-88000.0,-756950.0
2025-07-23,3293,82702,62100,0,658684,104000,65082,56601,0,28653,104000,17620,5499,0,630031,0,30738.0,-55087.0,64835.0,-35230.0,0.0,0.0,-2315211.0,-5477151.0,86000.0,-640000.0
2025-07-24,3293,54000,11000,0,196364,15000,-66891,6686,0,-877344,11000,120891,4314,0,1073708,4000,-84139.0,-63041.0,31773.0,1481.0,0.0,0.0,-2830865.0,-6459519.0,109000.0,-628000.0
2025-07-25,3293,7300,1000,0,171613,0,-5311,-5100,0,-108381,-2000,12611,6100,0,279994,2000,2434.0,-70619.0,33722.0,60754.0,0.0,0.0,-2348147.0,-6688946.0,168000.0,-627000.0
2025-07-28,3293,37223,0,0,216294,0,6023,0,0,-244932,-127000,31200,0,0,461226,127000,20611.0,-41487.0,36758.0,87443.0,0.0,0.0,-2089855.0,-6532534.0,87000.0,-721000.0
2025-07-29,3293,125000,11000,0,112179,20000,-674,-18115,0,-779791,14000,125674,29115,0,891970,6000,-1771.0,-50429.0,40072.0,69965.0,0.0,0.0,-1981795.0,-7276704.0,0.0,-601000.0
2025-07-30,3293,100000,5000,0,462434,0,28709,-6122,0,-194711,-10000,71291,11122,0,657145,10000,-38144.0,-68027.0,-22651.0,58843.0,0.0,0.0,-2205159.0,-7521234.0,-114000.0,-588000.0
2025-07-31,3293,60432,1000,0,318055,3000,36429,657,0,-44174,-13000,24003,343,0,362229,16000,65176.0,29251.0,-28680.0,58762.0,0.0,0.0,-1371989.0,-7406910.0,-138000.0,-578000.0
2025-08-01,3293,97000,13000,0,248740,0,766,6006,0,-452676,-41000,96234,6994,0,701416,41000,71253.0,61368.0,-17574.0,57645.0,0.0,0.0,-1716284.0,-7736091.0,-177000.0,-591000.0
2025-08-04,3293,59387,10000,0,298411,0,36352,3815,0,-64319,0,23035,6185,0,362730,0,101582.0,115582.0,-13759.0,68907.0,0.0,0.0,-1535671.0,-7609772.0,-50000.0,-516000.0
2025-08-05,3293,96238,44000,0,564840,1000,66609,43000,0,66339,-2000,29629,1000,0,498501,3000,168865.0,196366.0,47356.0,116107.0,0.0,0.0,-689541.0,-7563662.0,-66000.0,-512000.0
2025-08-06,3293,27000,3000,0,159623,10000,-48294,-13000,0,-447369,7000,75294,16000,0,606992,3000,91862.0,163432.0,40478.0,95786.0,0.0,0.0,-942199.0,-7587222.0,-49000.0,-502000.0
2025-08-07,3293,59000,3000,0,300096,4000,11786,-33836,0,-157024,1000,47214,36836,0,457120,3000,67219.0,177640.0,5985.0,62033.0,0.0,0.0,-1055049.0,-7072448.0,-35000.0,-435000.0
2025-08-08,3293,123886,0,0,262891,2000,63542,-82,0,-408394,-100000,60344,82,0,671285,102000,129995.0,227086.0,-103.0,58267.0,0.0,0.0,-1010767.0,-7358091.0,-94000.0,-342000.0
2025-08-11,3293,94000,11000,0,149661,2000,4488,-9555,0,-423396,-25000,89512,20555,0,573057,27000,98131.0,230327.0,-13473.0,47912.0,0.0,0.0,-1369844.0,-7301273.0,-119000.0,-297000.0
2025-08-12,3293,120000,17000,0,282204,0,-1888,-26992,0,-358834,-212000,121888,43992,0,641038,212000,29634.0,233991.0,-83465.0,27152.0,0.0,0.0,-1795017.0,-7273676.0,-329000.0,-483000.0
2025-08-13,3293,247000,13000,0,382139,0,-24023,-76601,0,-508180,-19000,271023,89601,0,890319,19000,53905.0,138361.0,-147066.0,-64404.0,0.0,0.0,-1855828.0,-7318397.0,-355000.0,-432000.0
2025-08-14,3293,50863,2100,0,536001,0,27268,-10002,0,81902,-5700,23595,12102,0,454099,5700,69387.0,117643.0,-123232.0,-114154.0,0.0,0.0,-1616902.0,-6874805.0,-361700.0,-425700.0
2025-08-15,3293,86000,4000,0,237135,2000,-20168,-1649,0,-209004,-12000,106168,5649,0,446139,14000,-14323.0,189359.0,-124799.0,-108754.0,0.0,0.0,-1417512.0,-6492710.0,-273700.0,-376700.0
2025-08-18,3293,48365,18668,0,1719463,62000,-685,15347,0,791183,35000,49050,3321,0,928280,27000,-19496.0,200828.0,-99897.0,-90371.0,0.0,0.0,-202933.0,-5198303.0,-213700.0,-295700.0
2025-08-19,3293,45000,1000,0,493470,19000,-20644,-152,0,-311028,8000,65644,1152,0,804498,11000,-38252.0,158476.0,-73057.0,-69094.0,0.0,0.0,-155127.0,-4621480.0,6300.0,-388700.0
2025-08-20,3293,89000,3000,0,758587,10000,-9376,2755,0,-396248,10000,98376,245,0,1154835,0,-23605.0,84018.0,6299.0,-122940.0,0.0,0.0,-43195.0,-5046381.0,35300.0,-482700.0
2025-08-21,3293,52321,11000,0,592889,4000,45290,8985,0,73543,4000,7031,2015,0,519346,0,-5583.0,196199.0,25286.0,-120641.0,0.0,0.0,-51554.0,-4095494.0,45000.0,-489700.0
2025-08-22,3293,103000,10000,0,430339,97000,15915,-2001,0,-959115,91000,87085,12001,0,1389454,6000,30500.0,217425.0,24934.0,-117542.0,0.0,0.0,-801665.0,-4946228.0,148000.0,-396700.0
2025-08-25,3293,125000,5000,0,294288,0,4914,-1556,0,-797866,-12000,120086,6556,0,1092154,12000,36099.0,216316.0,8031.0,-119098.0,0.0,0.0,-2390714.0,-5499162.0,101000.0,-281700.0
2025-08-26,3293,33681,0,0,2573649,20000,20233,0,0,-1836,18886,13448,0,0,2575485,1114,76976.0,237223.0,8183.0,-100983.0,0.0,0.0,-2081522.0,-4721207.0,111886.0,-276814.0
2025-08-27,3293,21000,0,0,279085,102000,-14451,-6089,0,-288097,95000,35451,6089,0,567182,7000,71901.0,194063.0,-661.0,-100950.0,0.0,0.0,-1973371.0,-4814593.0,196886.0,-171814.0
2025-08-28,3293,21000,3000,0,256520,0,-6291,970,0,-97544,-66000,27291,2030,0,354064,66000,20320.0,151343.0,-8676.0,-100637.0,0.0,0.0,-2144458.0,-4867963.0,126886.0,-224814.0
2025-08-29,3293,90000,11000,0,256267,11000,-376,662,0,-540744,-48000,90376,10338,0,797011,59000,4029.0,150201.0,-6013.0,-105981.0,0.0,0.0,-1726087.0,-4956031.0,-12114.0,-231814.0
2025-09-01,3293,41604,2000,0,738705,14000,21296,-7162,0,248152,-60100,20308,9162,0,490553,74100,20411.0,135145.0,-11619.0,-116958.0,0.0,0.0,-680069.0,-4643560.0,-60214.0,-291914.0
2025-09-02,3293,28496,12000,0,433690,15000,6649,12000,0,198638,-211000,21847,0,0,235052,226000,6827.0,75185.0,381.0,-147958.0,0.0,0.0,-479595.0,-4511261.0,-290100.0,-500914.0
2025-09-03,3293,6322,0,0,622443,25000,2188,-196,0,393297,25000,4134,196,0,229146,0,23466.0,125667.0,6274.0,-135154.0,0.0,0.0,201799.0,-3670595.0,-360100.0,-482914.0
2025-09-04,3293,49884,33000,0,884032,0,43471,33000,0,280978,-1000,6413,0,0,603054,1000,73228.0,157352.0,38304.0,-68318.0,0.0,0.0,580321.0,-3232593.0,-295100.0,-484914.0
2025-09-05,3293,30000,7000,0,426362,10000,-13936,5002,0,-261101,-45000,43936,1998,0,687463,55000,59668.0,79874.0,42644.0,-63234.0,0.0,0.0,859964.0,-3085300.0,-292100.0,-429914.0
2025-09-08,3293,13041,4000,0,395201,10000,-10489,-36000,0,203900,0,23530,40000,0,191301,10000,27883.0,64897.0,13806.0,-89679.0,0.0,0.0,815712.0,-2458004.0,-232000.0,-404914.0
2025-09-09,3293,17000,0,0,361278,13000,61,-30000,0,-99914,-76200,16939,30000,0,461192,89200,21295.0,66846.0,-28194.0,-92687.0,0.0,0.0,517160.0,-2199084.0,-97200.0,-269114.0
2025-09-10,3293,35304,0,0,691396,15000,34304,-50000,0,454278,-2000,1000,50000,0,237118,17000,53411.0,125173.0,-77998.0,-66086.0,0.0,0.0,578141.0,-1236626.0,-124200.0,-252114.0
2025-09-11,3293,113262,44516,0,758796,15000,66315,41516,0,353726,-15500,46947,3000,0,405070,30500,76255.0,164220.0,-69482.0,-14568.0,0.0,0.0,650889.0,-964802.0,-138700.0,-261914.0
2025-09-12,3293,465454,82144,0,2792217,15000,188691,56844,0,1746264,500,276763,25300,0,1045953,14500,278882.0,373079.0,-17640.0,43925.0,0.0,0.0,2658254.0,990466.0,-93200.0,-249414.0
2025-09-15,3293,20267,42530,0,543041,35000,-137340,18730,0,-290305,24000,157607,23800,0,833346,11000,152031.0,236424.0,37090.0,47308.0,0.0,0.0,2164049.0,-91022.0,-69200.0,-260414.0
2025-09-16,3293,17939,49500,0,585679,66001,5735,4800,0,-176971,45501,12204,44700,0,762650,20500,157705.0,262803.0,71890.0,52260.0,0.0,0.0,2086992.0,43035.0,52501.0,-222913.0
2025-09-17,3293,95000,16000,0,655436,40000,-16868,-23975,0,-105449,27300,111868,39975,0,760885,12700,106533.0,255311.0,97915.0,25530.0,0.0,0.0,1527265.0,333834.0,81801.0,-205613.0
2025-09-18,3293,35306,11000,0,344531,12000,5760,-4900,0,-175476,-8000,29546,15900,0,520007,20000,45978.0,215781.0,51499.0,11645.0,0.0,0.0,998063.0,84815.0,89301.0,-217613.0
2025-09-19,3293,27373,2000,0,1273457,16000,12197,-4117,0,39809,-7000,15176,6117,0,1233648,23000,-130516.0,212063.0,-9462.0,9529.0,0.0,0.0,-708392.0,1083739.0,81801.0,-315613.0
2024-09-23,3535,0,8000,0,596000,0,0,1590,0,26000,0,0,6410,0,570000,0,0.0,0.0,1590.0,1590.0,0.0,0.0,26000.0,26000.0,0.0,0.0
2024-09-24,3535,0,11001,0,827000,0,0,-65235,0,356000,0,0,76236,0,471000,0,0.0,0.0,-63645.0,-63645.0,0.0,0.0,382000.0,382000.0,0.0,0.0
2024-09-25,3535,0,3000,0,822000,0,0,2776,0,574000,0,0,224,0,248000,0,0.0,0.0,-60869.0,-60869.0,0.0,0.0,956000.0,956000.0,0.0,0.0
2024-09-26,3535,0,5919,0,1594000,0,0,3115,0,100000,0,0,2804,0,1494000,0,0.0,0.0,-57754.0,-57754.0,0.0,0.0,1056000.0,1056000.0,0.0,0.0
2024-09-27,3535,0,8000,0,1261000,0,0,463,0,-465000,0,0,7537,0,1726000,0,0.0,0.0,-57291.0,-57291.0,0.0,0.0,591000.0,591000.0,0.0,0.0
2024-09-30,3535,0,0,0,464000,0,0,-2000,0,71000,0,0,2000,0,393000,0,0.0,0.0,-60881.0,-59291.0,0.0,0.0,636000.0,662000.0,0.0,0.0
2024-10-01,3535,0,2000,0,408000,0,0,-739,0,-222000,0,0,2739,0,630000,0,0.0,0.0,3615.0,-60030.0,0.0,0.0,58000.0,440000.0,0.0,0.0
2024-10-04,3535,0,9000,0,2326000,0,0,-15827,0,1196000,0,0,24827,0,1130000,0,0.0,0.0,-14988.0,-75857.0,0.0,0.0,680000.0,1636000.0,0.0,0.0
2024-10-07,3535,0,4000,0,1213000,0,0,1651,0,310000,0,0,2349,0,903000,0,0.0,0.0,-16452.0,-74206.0,0.0,0.0,890000.0,1946000.0,0.0,0.0
2024-10-08,3535,0,1000,0,514025,0,0,-10050,0,77025,0,0,11050,0,437000,0,0.0,0.0,-26965.0,-84256.0,0.0,0.0,1432025.0,2023025.0,0.0,0.0
2024-10-09,3535,0,29000,0,1196000,0,0,19094,0,568950,0,0,9906,0,627050,0,0.0,0.0,-5871.0,-65162.0,0.0,0.0,1929975.0,2591975.0,0.0,0.0
2024-10-11,3535,0,7000,0,2974000,0,0,510,0,1454000,0,0,6490,0,1520000,0,0.0,0.0,-4622.0,-64652.0,0.0,0.0,3605975.0,4045975.0,0.0,0.0
2024-10-14,3535,0,1000,0,1462000,0,0,-1000,0,558000,0,0,2000,0,904000,0,0.0,0.0,10205.0,-65652.0,0.0,0.0,2967975.0,4603975.0,0.0,0.0
2024-10-15,3535,0,8000,0,411000,0,0,1293,0,-439000,0,0,6707,0,850000,0,0.0,0.0,9847.0,-64359.0,0.0,0.0,2218975.0,4164975.0,0.0,0.0
2024-10-16,3535,0,4000,0,490054,0,0,-308,0,-182946,0,0,4308,0,673000,0,0.0,0.0,19589.0,-64667.0,0.0,0.0,1959004.0,3982029.0,0.0,0.0
2024-10-17,3535,0,0,0,736190,0,0,-2153,0,59190,0,0,2153,0,677000,0,0.0,0.0,-1658.0,-66820.0,0.0,0.0,1449244.0,4041219.0,0.0,0.0
2024-10-18,3535,0,9000,0,612000,0,0,5687,0,-437000,0,0,3313,0,1049000,0,0.0,0.0,3519.0,-61133.0,0.0,0.0,-441756.0,3604219.0,0.0,0.0
2024-10-21,3535,0,14001,0,1144000,0,0,13873,0,7000,0,0,128,0,1137000,0,0.0,0.0,18392.0,-47260.0,0.0,0.0,-992756.0,3611219.0,0.0,0.0
2024-10-22,3535,0,22000,0,3742000,0,0,-12412,0,-2446001,0,0,34412,0,6188001,0,0.0,0.0,4687.0,-59672.0,0.0,0.0,-2999757.0,1165218.0,0.0,0.0
2024-10-23,3535,0,12822,0,4818000,0,0,-4690,0,-475000,0,0,17512,0,5293000,0,0.0,0.0,305.0,-64362.0,0.0,0.0,-3291811.0,690218.0,0.0,0.0
2024-10-24,3535,0,9000,0,2104000,0,0,-20008,0,154000,0,0,29008,0,1950000,0,0.0,0.0,-17550.0,-85960.0,0.0,0.0,-3197001.0,818218.0,0.0,0.0
2024-10-25,3535,0,3000,0,1165120,0,0,2806,0,29120,0,0,194,0,1136000,0,0.0,0.0,-20431.0,-17919.0,0.0,0.0,-2730881.0,491338.0,0.0,0.0
2024-10-28,3535,0,6000,0,1474046,0,0,5310,0,498046,0,0,690,0,976000,0,0.0,0.0,-28994.0,-15385.0,0.0,0.0,-2239835.0,415384.0,0.0,0.0
2024-10-29,3535,0,2000,0,751000,0,0,-3413,0,-426000,0,0,5413,0,1177000,0,0.0,0.0,-19995.0,-21913.0,0.0,0.0,-219834.0,-110616.0,0.0,0.0
2024-10-30,3535,0,5000,0,704000,0,0,-2848,0,209000,0,0,7848,0,495000,0,0.0,0.0,-18153.0,-25224.0,0.0,0.0,464166.0,563384.0,0.0,0.0
2024-11-01,3535,0,5000,0,1053000,0,0,220,0,281000,0,0,4780,0,772000,0,0.0,0.0,2075.0,-23004.0,0.0,0.0,591166.0,773384.0,0.0,0.0
2024-11-04,3535,0,1000,0,217000,0,0,-2300,0,-448000,0,0,3300,0,665000,0,0.0,0.0,-3031.0,-24565.0,0.0,0.0,114046.0,547384.0,0.0,0.0
2024-11-05,3535,0,3000,0,1494000,0,0,-2479,0,609000,0,0,5479,0,885000,0,0.0,0.0,-10820.0,-11217.0,0.0,0.0,225000.0,-39616.0,0.0,0.0
2024-11-06,3535,0,4000,0,293000,0,0,640,0,-403000,0,0,3360,0,696000,0,0.0,0.0,-6767.0,-12228.0,0.0,0.0,248000.0,-752616.0,0.0,0.0
2024-11-07,3535,0,941,0,1077016,0,0,-662,0,398016,0,0,1603,0,679000,0,0.0,0.0,-4581.0,-2840.0,0.0,0.0,437016.0,-431625.0,0.0,0.0
2024-11-08,3535,0,4000,0,506000,0,0,475,0,-391000,0,0,3525,0,897000,0,0.0,0.0,-4326.0,-21459.0,0.0,0.0,-234984.0,-1391575.0,0.0,0.0
2024-11-11,3535,0,6000,0,373000,0,0,-309,0,-105000,0,0,6309,0,478000,0,0.0,0.0,-2335.0,-22278.0,0.0,0.0,108016.0,-2950575.0,0.0,0.0
2024-11-12,3535,0,9000,0,771000,0,0,196,0,459000,0,0,8804,0,312000,0,0.0,0.0,340.0,-21082.0,0.0,0.0,-41984.0,-3049575.0,0.0,0.0
2024-11-13,3535,0,9000,0,254000,0,0,-984,0,-183016,0,0,9984,0,437016,0,0.0,0.0,-1284.0,-23359.0,0.0,0.0,178000.0,-2793591.0,0.0,0.0
2024-11-14,3535,0,3000,0,630000,0,0,-1516,0,-797000,0,0,4516,0,1427000,0,0.0,0.0,-2138.0,-24567.0,0.0,0.0,-1017016.0,-3407645.0,0.0,0.0
2024-11-15,3535,0,0,0,878000,0,0,-445,0,423000,0,0,445,0,455000,0,0.0,0.0,-3058.0,-22859.0,0.0,0.0,-203016.0,-3043835.0,0.0,0.0
2024-11-18,3535,0,4000,0,129000,0,0,141,0,-647008,0,0,3859,0,776008,0,0.0,0.0,-2608.0,-28405.0,0.0,0.0,-745024.0,-3253843.0,0.0,0.0
2024-11-19,3535,0,1000,0,427009,0,0,1000,0,145009,0,0,0,0,282000,0,0.0,0.0,-1804.0,-41278.0,0.0,0.0,-1059015.0,-3115834.0,0.0,0.0
2024-11-20,3535,0,0,0,183000,0,0,-159,0,-183000,0,0,159,0,366000,0,0.0,0.0,-979.0,-29025.0,0.0,0.0,-1058999.0,-852833.0,0.0,0.0
2024-11-21,3535,0,1000,0,231000,0,0,184,0,12000,0,0,816,0,219000,0,0.0,0.0,721.0,-24151.0,0.0,0.0,-249999.0,-365833.0,0.0,0.0
2024-11-22,3535,0,2000,0,911000,0,0,1565,0,480000,0,0,435,0,431000,0,0.0,0.0,2731.0,-2578.0,0.0,0.0,-192999.0,-39833.0,0.0,0.0
2024-11-25,3535,0,1000,0,814000,0,0,1000,0,189000,0,0,0,0,625000,0,0.0,0.0,3590.0,-4384.0,0.0,0.0,643009.0,120047.0,0.0,0.0
2024-11-26,3535,0,0,0,186000,0,0,-2000,0,-86000,0,0,2000,0,272000,0,0.0,0.0,590.0,-11694.0,0.0,0.0,412000.0,-463999.0,0.0,0.0
2024-11-27,3535,0,8000,0,156000,0,0,734,0,-397000,0,0,7266,0,553000,0,0.0,0.0,1483.0,-7547.0,0.0,0.0,198000.0,-434999.0,0.0,0.0
2024-11-28,3535,0,2000,0,587000,0,0,-366,0,376000,0,0,2366,0,211000,0,0.0,0.0,933.0,-5065.0,0.0,0.0,562000.0,-267999.0,0.0,0.0
2024-11-29,3535,0,1000,0,394000,0,0,0,0,216000,0,0,1000,0,178000,0,0.0,0.0,-632.0,-5285.0,0.0,0.0,298000.0,-332999.0,0.0,0.0
2024-12-02,3535,0,654,0,126000,0,0,236,0,-53000,0,0,418,0,179000,0,0.0,0.0,-1396.0,-2749.0,0.0,0.0,56000.0,62001.0,0.0,0.0
2024-12-03,3535,0,0,0,329000,0,0,0,0,-7000,0,0,0,0,336000,0,0.0,0.0,604.0,-270.0,0.0,0.0,135000.0,-553999.0,0.0,0.0
2024-12-04,3535,0,0,0,189027,0,0,0,0,107027,0,0,0,0,82000,0,0.0,0.0,-130.0,-910.0,0.0,0.0,639027.0,-43972.0,0.0,0.0
2024-12-05,3535,0,2000,0,258000,0,0,-72,0,90000,0,0,2072,0,168000,0,0.0,0.0,164.0,-320.0,0.0,0.0,353027.0,-351988.0,0.0,0.0
2024-12-06,3535,0,3422,0,623000,0,0,16,0,-92000,0,0,3406,0,715000,0,0.0,0.0,180.0,-779.0,0.0,0.0,45027.0,-52988.0,0.0,0.0
2024-12-09,3535,0,2000,0,224000,0,0,308,0,-105000,0,0,1692,0,329000,0,0.0,0.0,252.0,-162.0,0.0,0.0,-6973.0,-52988.0,0.0,0.0
2024-12-10,3535,0,10000,0,1963000,0,0,-311,0,-5000,0,0,10311,0,1968000,0,0.0,0.0,-59.0,-669.0,0.0,0.0,-4973.0,-516988.0,0.0,0.0
2024-12-11,3535,0,0,0,712000,0,0,0,0,208000,0,0,0,0,504000,0,0.0,0.0,-59.0,315.0,0.0,0.0,96000.0,-125972.0,0.0,0.0
2024-12-12,3535,0,0,0,324000,0,0,0,0,-197000,0,0,0,0,521000,0,0.0,0.0,13.0,1831.0,0.0,0.0,-191000.0,474028.0,0.0,0.0
2024-12-13,3535,0,1000,0,140200,0,0,219,0,-227800,0,0,781,0,368000,0,0.0,0.0,216.0,2495.0,0.0,0.0,-326800.0,-176772.0,0.0,0.0
2024-12-16,3535,0,0,0,342060,0,0,-853,0,114060,0,0,853,0,228000,0,0.0,0.0,-945.0,1501.0,0.0,0.0,-107740.0,584296.0,0.0,0.0
2024-12-17,3535,0,0,0,438000,0,0,0,0,225000,0,0,0,0,213000,0,0.0,0.0,-634.0,501.0,0.0,0.0,122260.0,664287.0,0.0,0.0
2024-12-18,3535,0,0,0,347000,0,0,0,0,191800,0,0,0,0,155200,0,0.0,0.0,-634.0,660.0,0.0,0.0,106060.0,1039087.0,0.0,0.0
2024-12-19,3535,0,0,0,286000,0,0,-1000,0,86000,0,0,1000,0,200000,0,0.0,0.0,-1634.0,-524.0,0.0,0.0,389060.0,1113087.0,0.0,0.0
2024-12-20,3535,0,0,0,339000,0,0,-1001,0,73000,0,0,1001,0,266000,0,0.0,0.0,-2854.0,-3090.0,0.0,0.0,689860.0,706087.0,0.0,0.0
2024-12-23,3535,0,2000,0,719000,0,0,1780,0,334825,0,0,220,0,384175,0,0.0,0.0,-221.0,-2310.0,0.0,0.0,910625.0,851912.0,0.0,0.0
2024-12-24,3535,0,0,0,258000,0,0,-715,0,-148000,0,0,715,0,406000,0,0.0,0.0,-936.0,-1025.0,0.0,0.0,537625.0,789912.0,0.0,0.0
2024-12-25,3535,0,2000,0,855000,0,0,834,0,496000,0,0,1166,0,359000,0,0.0,0.0,-102.0,-925.0,0.0,0.0,841825.0,1682912.0,0.0,0.0
2024-12-26,3535,0,0,0,114000,0,0,-545,0,-183000,0,0,545,0,297000,0,0.0,0.0,353.0,-1104.0,0.0,0.0,572825.0,1123912.0,0.0,0.0
2024-12-27,3535,0,0,0,100000,0,0,-352,0,-208000,0,0,352,0,308000,0,0.0,0.0,1002.0,-1456.0,0.0,0.0,291825.0,699912.0,0.0,0.0
2024-12-30,3535,0,4000,0,83000,0,0,404,0,-229000,0,0,3596,0,312000,0,0.0,0.0,-374.0,-1288.0,0.0,0.0,-272000.0,523912.0,0.0,0.0
2024-12-31,3535,0,0,0,122000,0,0,-408,0,-157000,0,0,408,0,279000,0,0.0,0.0,-67.0,-1696.0,0.0,0.0,-281000.0,373912.0,0.0,0.0
2025-01-02,3535,0,93000,0,1012000,0,0,52691,0,651000,0,0,40309,0,361000,0,0.0,0.0,51790.0,50995.0,0.0,0.0,-126000.0,917885.0,0.0,0.0
2025-01-03,3535,0,12000,0,1756000,0,0,-55838,0,-1704000,0,0,67838,0,3460000,0,0.0,0.0,-3503.0,-4771.0,0.0,0.0,-1647000.0,-876115.0,0.0,0.0
2025-01-06,3535,0,0,0,621000,0,0,-1000,0,190000,0,0,1000,0,431000,0,0.0,0.0,-4151.0,-5787.0,0.0,0.0,-1249000.0,-594115.0,0.0,0.0
2025-01-07,3535,0,3000,0,268000,0,0,110,0,8000,0,0,2890,0,260000,0,0.0,0.0,-4445.0,-5985.0,0.0,0.0,-1012000.0,-481115.0,0.0,0.0
2025-01-08,3535,0,0,0,222000,0,0,-797,0,58000,0,0,797,0,164000,0,0.0,0.0,-4834.0,-6471.0,0.0,0.0,-797000.0,-418115.0,0.0,0.0
2025-01-09,3535,0,1000,0,121000,0,0,79,0,-128000,0,0,921,0,249000,0,0.0,0.0,-57446.0,-6392.0,0.0,0.0,-1576000.0,-754115.0,0.0,0.0
2025-01-10,3535,0,13000,0,923000,0,0,719,0,-23000,0,0,12281,0,946000,0,0.0,0.0,-889.0,-5673.0,0.0,0.0,105000.0,-580115.0,0.0,0.0
2025-01-13,3535,0,7000,0,1196000,0,0,-807,0,654999,0,0,7807,0,541001,0,0.0,0.0,-696.0,-6699.0,0.0,0.0,569999.0,302684.0,0.0,0.0
2025-01-14,3535,0,0,0,349000,0,0,-1,0,-15000,0,0,1,0,364000,0,0.0,0.0,-807.0,-5847.0,0.0,0.0,546999.0,173624.0,0.0,0.0
2025-01-15,3535,0,1000,0,338000,0,0,-8000,0,44000,0,0,9000,0,294000,0,0.0,0.0,-8010.0,-13847.0,0.0,0.0,532999.0,-7376.0,0.0,0.0
2025-01-16,3535,0,135,0,537000,0,0,-11865,0,206000,0,0,12000,0,331000,0,0.0,0.0,-19954.0,-25712.0,0.0,0.0,866999.0,6824.0,0.0,0.0
2025-01-17,3535,0,1000,0,505000,0,0,1000,0,-236000,0,0,0,0,741000,0,0.0,0.0,-19673.0,-23712.0,0.0,0.0,653999.0,-315176.0,0.0,0.0
2025-01-20,3535,0,6334,0,1540000,0,0,4334,0,968000,0,0,2000,0,572000,0,0.0,0.0,-14532.0,-18377.0,0.0,0.0,967000.0,579824.0,0.0,0.0
2025-01-21,3535,0,1000,0,892000,0,0,-2369,0,-393057,0,0,3369,0,1285057,0,0.0,0.0,-16900.0,-22526.0,0.0,0.0,588943.0,-148058.0,0.0,0.0
2025-01-22,3535,0,0,0,281000,0,0,-3000,0,-175000,0,0,3000,0,456000,0,0.0,0.0,-11900.0,-24811.0,0.0,0.0,369943.0,-175058.0,0.0,0.0
2025-02-03,3535,0,2000,0,262000,0,0,-1187,0,-126000,0,0,3187,0,388000,0,0.0,0.0,-1222.0,-26832.0,0.0,0.0,37943.0,-797058.0,0.0,0.0
2025-02-04,3535,0,0,0,164000,0,0,-2000,0,-241000,0,0,2000,0,405000,0,0.0,0.0,-4222.0,-28287.0,0.0,0.0,32943.0,-855058.0,0.0,0.0
2025-02-05,3535,0,1000,0,167000,0,0,697,0,11000,0,0,303,0,156000,0,0.0,0.0,-7859.0,-27238.0,0.0,0.0,-924057.0,-636058.0,0.0,0.0
2025-02-06,3535,0,0,0,154000,0,0,-114,0,-46000,0,0,114,0,200000,0,0.0,0.0,-5604.0,-27756.0,0.0,0.0,-577000.0,-453058.0,0.0,0.0
2025-02-07,3535,0,2000,0,167000,0,0,174,0,-40000,0,0,1826,0,207000,0,0.0,0.0,-2430.0,-27174.0,0.0,0.0,-442000.0,-336058.0,0.0,0.0
2025-02-10,3535,0,3000,0,578000,0,0,-213,0,5000,0,0,3213,0,573000,0,0.0,0.0,-1456.0,-80078.0,0.0,0.0,-311000.0,-982058.0,0.0,0.0
2025-02-11,3535,0,5000,0,513000,0,0,3606,0,256000,0,0,1394,0,257000,0,0.0,0.0,4150.0,-20634.0,0.0,0.0,186000.0,977942.0,0.0,0.0
2025-02-12,3535,0,1000,0,199000,0,0,598,0,-131000,0,0,402,0,330000,0,0.0,0.0,4051.0,-19036.0,0.0,0.0,44000.0,656942.0,0.0,0.0
2025-02-13,3535,0,0,0,220000,0,0,-4031,0,53000,0,0,4031,0,167000,0,0.0,0.0,134.0,-23177.0,0.0,0.0,143000.0,701942.0,0.0,0.0
2025-02-14,3535,0,0,0,167000,0,0,0,0,56000,0,0,0,0,111000,0,0.0,0.0,-40.0,-22380.0,0.0,0.0,239000.0,699942.0,0.0,0.0
2025-02-17,3535,0,2000,0,230000,0,0,-686,0,-101000,0,0,2686,0,331000,0,0.0,0.0,-513.0,-23145.0,0.0,0.0,133000.0,726942.0,0.0,0.0
2025-02-18,3535,0,1000,0,393000,0,0,1000,0,248000,0,0,0,0,145000,0,0.0,0.0,-3119.0,-22864.0,0.0,0.0,125000.0,997942.0,0.0,0.0
2025-02-19,3535,0,7000,0,1305000,0,0,-4408,0,-423000,0,0,11408,0,1728000,0,0.0,0.0,-8125.0,-26465.0,0.0,0.0,-167000.0,-80057.0,0.0,0.0
2025-02-20,3535,0,0,0,556000,0,0,-1811,0,-1010000,0,0,1811,0,1566000,0,0.0,0.0,-5905.0,-28275.0,0.0,0.0,-1230000.0,-1075057.0,0.0,0.0
2025-02-21,3535,0,0,0,331000,0,0,-1000,0,179000,0,0,1000,0,152000,0,0.0,0.0,-6905.0,-21275.0,0.0,0.0,-1107000.0,-940057.0,0.0,0.0
2025-02-24,3535,0,3000,0,55000,0,0,2871,0,-156000,0,0,129,0,211000,0,0.0,0.0,-3348.0,-6539.0,0.0,0.0,-1162000.0,-1302057.0,0.0,0.0
2025-02-25,3535,0,0,0,124000,0,0,-4547,0,-165000,0,0,4547,0,289000,0,0.0,0.0,-8895.0,-12086.0,0.0,0.0,-1575000.0,-1231057.0,0.0,0.0
2025-02-26,3535,0,2000,0,90001,0,0,-368,0,-72999,0,0,2368,0,163000,0,0.0,0.0,-4855.0,-16788.0,0.0,0.0,-1224999.0,-2272056.0,0.0,0.0
2025-02-27,3535,0,6000,0,158000,0,0,869,0,-37000,0,0,5131,0,195000,0,0.0,0.0,-2175.0,-13550.0,0.0,0.0,-251999.0,-1915999.0,0.0,0.0
2025-03-03,3535,0,2000,0,273000,0,0,-306,0,-368000,0,0,2306,0,641000,0,0.0,0.0,-1481.0,-10856.0,0.0,0.0,-798999.0,-2108999.0,0.0,0.0
2025-03-04,3535,0,4000,0,200000,0,0,-2649,0,-135000,0,0,6649,0,335000,0,0.0,0.0,-7001.0,-12318.0,0.0,0.0,-777999.0,-2117999.0,0.0,0.0
2025-03-05,3535,0,0,0,429000,0,0,-5001,0,263000,0,0,5001,0,166000,0,0.0,0.0,-7455.0,-15319.0,0.0,0.0,-349999.0,-1613999.0,0.0,0.0
2025-03-06,3535,0,1000,0,48000,0,0,-22,0,-186000,0,0,1022,0,234000,0,0.0,0.0,-7109.0,-16038.0,0.0,0.0,-463000.0,-1810999.0,0.0,0.0
2025-03-07,3535,0,5000,0,69000,0,0,3954,0,-103000,0,0,1046,0,172000,0,0.0,0.0,-4024.0,-11970.0,0.0,0.0,-529000.0,-1867999.0,0.0,0.0
2025-03-10,3535,0,0,0,123000,0,0,-5000,0,5000,0,0,5000,0,118000,0,0.0,0.0,-8718.0,-17144.0,0.0,0.0,-156000.0,-1822999.0,0.0,0.0
2025-03-11,3535,0,2000,0,313000,0,0,-99,0,87000,0,0,2099,0,226000,0,0.0,0.0,-6168.0,-17030.0,0.0,0.0,66000.0,-1740999.0,0.0,0.0
2025-03-12,3535,0,5000,0,72000,0,0,1640,0,-81000,0,0,3360,0,153000,0,0.0,0.0,473.0,-18996.0,0.0,0.0,-278000.0,-2077999.0,0.0,0.0
2025-03-13,3535,0,3000,0,154000,0,0,808,0,-35000,0,0,2192,0,189000,0,0.0,0.0,1303.0,-18786.0,0.0,0.0,-127000.0,-1981999.0,0.0,0.0
2025-03-14,3535,0,0,0,589000,0,0,-175,0,400000,0,0,175,0,189000,0,0.0,0.0,-2826.0,-14930.0,0.0,0.0,376000.0,-1634999.0,0.0,0.0
2025-03-17,3535,0,10000,0,574000,0,0,10000,0,341000,0,0,0,0,233000,0,0.0,0.0,12174.0,-4930.0,0.0,0.0,712000.0,-1349999.0,0.0,0.0
2025-03-18,3535,0,34000,0,92000,0,0,34000,0,-126000,0,0,0,0,218000,0,0.0,0.0,46273.0,29756.0,0.0,0.0,499000.0,-1374999.0,0.0,0.0
2025-03-19,3535,0,0,0,127000,0,0,0,0,-94000,0,0,0,0,221000,0,0.0,0.0,44633.0,28756.0,0.0,0.0,486000.0,-1716999.0,0.0,0.0
2025-03-20,3535,0,5000,0,257000,0,0,5000,0,142000,0,0,0,0,115000,0,0.0,0.0,48825.0,38164.0,0.0,0.0,663000.0,-1151999.0,0.0,0.0
2025-03-21,3535,0,0,0,290000,0,0,-5000,0,97000,0,0,5000,0,193000,0,0.0,0.0,44000.0,34975.0,0.0,0.0,360000.0,-44999.0,0.0,0.0
2025-03-24,3535,0,0,0,99000,0,0,0,0,-196000,0,0,0,0,295000,0,0.0,0.0,34000.0,35975.0,0.0,0.0,-177000.0,-419999.0,0.0,0.0
2025-03-25,3535,0,0,0,723000,0,0,0,0,474000,0,0,0,0,249000,0,0.0,0.0,0.0,33104.0,0.0,0.0,423000.0,210001.0,0.0,0.0
2025-03-26,3535,0,0,0,265001,0,0,0,0,146001,0,0,0,0,119000,0,0.0,0.0,0.0,37651.0,0.0,0.0,663001.0,521002.0,0.0,0.0
2025-03-27,3535,0,0,0,527000,0,0,0,0,350000,0,0,0,0,177000,0,0.0,0.0,-5000.0,38019.0,0.0,0.0,871001.0,944001.0,0.0,0.0
2025-03-28,3535,0,1000,0,1080000,0,0,0,0,857455,0,0,1000,0,222545,0,0.0,0.0,0.0,37150.0,0.0,0.0,1631456.0,1838456.0,0.0,0.0
2025-03-31,3535,0,2000,0,1811000,0,0,1000,0,1192000,0,0,1000,0,619000,0,0.0,0.0,1000.0,38456.0,0.0,0.0,3019456.0,3398456.0,0.0,0.0
2025-04-01,3535,0,0,0,594000,0,0,-27000,0,207000,0,0,27000,0,387000,0,0.0,0.0,-26000.0,14105.0,0.0,0.0,2752456.0,3740456.0,0.0,0.0
2025-04-02,3535,0,0,0,633000,0,0,-8000,0,221000,0,0,8000,0,412000,0,0.0,0.0,-34000.0,11106.0,0.0,0.0,2827455.0,3698456.0,0.0,0.0
2025-04-07,3535,0,0,0,45000,0,0,0,0,28000,0,0,0,0,17000,0,0.0,0.0,-34000.0,11128.0,0.0,0.0,2505455.0,3912456.0,0.0,0.0
2025-04-08,3535,0,0,0,13000,0,0,0,0,12000,0,0,0,0,1000,0,0.0,0.0,-34000.0,7174.0,0.0,0.0,1660000.0,4027456.0,0.0,0.0
2025-04-09,3535,0,0,0,3000,0,0,0,0,3000,0,0,0,0,0,0,0.0,0.0,-35000.0,12174.0,0.0,0.0,471000.0,4025456.0,0.0,0.0
2025-04-10,3535,0,33000,0,343000,0,0,33000,0,-572000,0,0,0,0,915000,0,0.0,0.0,25000.0,45273.0,0.0,0.0,-308000.0,3366456.0,0.0,0.0
2025-04-11,3535,0,2000,0,759483,0,0,-23639,0,263483,0,0,25639,0,496000,0,0.0,0.0,9361.0,19994.0,0.0,0.0,-265517.0,3710939.0,0.0,0.0
2025-04-14,3535,0,0,0,781091,0,0,-2000,0,272608,0,0,2000,0,508483,0,0.0,0.0,7361.0,17186.0,0.0,0.0,-20909.0,4018547.0,0.0,0.0
2025-04-15,3535,0,5005,0,404000,0,0,5005,0,119909,0,0,0,0,284091,0,0.0,0.0,12366.0,22366.0,0.0,0.0,87000.0,3738456.0,0.0,0.0
2025-04-16,3535,0,0,0,411008,0,0,-3001,0,71008,0,0,3001,0,340000,0,0.0,0.0,9365.0,9365.0,0.0,0.0,155008.0,3468464.0,0.0,0.0
2025-04-17,3535,0,0,0,303123,0,0,-1000,0,108115,0,0,1000,0,195008,0,0.0,0.0,-24635.0,-25635.0,0.0,0.0,835123.0,3702579.0,0.0,0.0
2025-04-18,3535,0,0,0,199893,0,0,-3000,0,-74230,0,0,3000,0,274123,0,0.0,0.0,-3996.0,-28635.0,0.0,0.0,497410.0,3722349.0,0.0,0.0
2025-04-21,3535,0,0,0,290214,0,0,0,0,105705,0,0,0,0,184509,0,0.0,0.0,-1996.0,-33635.0,0.0,0.0,330507.0,3686054.0,0.0,0.0
2025-04-22,3535,0,1000,0,380153,0,0,-6359,0,-374445,0,0,7359,0,754598,0,0.0,0.0,-13360.0,-34994.0,0.0,0.0,-163847.0,3214609.0,0.0,0.0
2025-04-23,3535,0,15171,0,963353,0,0,13509,0,-205800,0,0,1662,0,1169153,0,0.0,0.0,3150.0,-21485.0,0.0,0.0,-440655.0,3204809.0,0.0,0.0
2025-04-24,3535,0,0,0,429005,0,0,-15000,0,-180995,0,0,15000,0,610000,0,0.0,0.0,-10850.0,-36485.0,0.0,0.0,-729765.0,2549814.0,0.0,0.0
2025-04-25,3535,0,3000,0,294455,0,0,2829,0,98097,0,0,171,0,196358,0,0.0,0.0,-5021.0,-33656.0,0.0,0.0,-557438.0,2501910.0,0.0,0.0
2025-04-28,3535,0,4000,0,157052,0,0,4000,0,44913,0,0,0,0,112139,0,0.0,0.0,-1021.0,-29656.0,0.0,0.0,-618230.0,2196823.0,0.0,0.0
2025-04-29,3535,0,1020,0,1022140,0,0,1020,0,404772,0,0,0,0,617368,0,0.0,0.0,6358.0,-28636.0,0.0,0.0,160987.0,1744140.0,0.0,0.0
2025-04-30,3535,0,1000,0,749799,0,0,980,0,-328341,0,0,20,0,1078140,0,0.0,0.0,-6171.0,-28656.0,0.0,0.0,38446.0,223799.0,0.0,0.0
2025-05-02,3535,0,3000,0,120000,0,0,3000,0,-237529,0,0,0,0,357529,0,0.0,0.0,11829.0,1344.0,0.0,0.0,-18088.0,-220730.0,0.0,0.0
2025-05-05,3535,0,0,0,367278,0,0,-5000,0,9008,0,0,5000,0,358270,0,0.0,0.0,4000.0,4344.0,0.0,0.0,-107177.0,-432722.0,0.0,0.0
2025-05-06,3535,0,2000,0,543415,0,0,1000,0,169137,0,0,1000,0,374278,0,0.0,0.0,1000.0,5344.0,0.0,0.0,17047.0,-291585.0,0.0,0.0
2025-05-07,3535,0,1000,0,126011,0,0,0,0,-139404,0,0,1000,0,265415,0,0.0,0.0,-20.0,5344.0,0.0,0.0,-527129.0,-442989.0,0.0,0.0
2025-05-08,3535,0,4000,0,559427,0,0,4000,0,-17584,0,0,0,0,577011,0,0.0,0.0,3000.0,9344.0,0.0,0.0,-216372.0,-463573.0,0.0,0.0
2025-05-09,3535,0,6000,0,235613,0,0,6000,0,61186,0,0,0,0,174427,0,0.0,0.0,6000.0,-17656.0,0.0,0.0,82343.0,169613.0,0.0,0.0
2025-05-12,3535,0,6000,0,447001,0,0,6000,0,232388,0,0,0,0,214613,0,0.0,0.0,17000.0,11983.0,0.0,0.0,305723.0,138518.0,0.0,0.0
2025-05-13,3535,0,4000,0,534309,0,0,4000,0,182308,0,0,0,0,352001,0,0.0,0.0,20000.0,17983.0,0.0,0.0,318894.0,48218.0,0.0,0.0
2025-05-14,3535,0,6000,0,401731,0,0,5000,0,142422,0,0,1000,0,259309,0,0.0,0.0,25000.0,17978.0,0.0,0.0,600720.0,70731.0,0.0,0.0
2025-05-15,3535,0,0,0,133252,0,0,0,0,-143329,0,0,0,0,276581,0,0.0,0.0,21000.0,20979.0,0.0,0.0,474975.0,-143606.0,0.0,0.0
2025-05-16,3535,0,0,0,168300,0,0,0,0,-261952,0,0,0,0,430252,0,0.0,0.0,15000.0,21979.0,0.0,0.0,151837.0,-513673.0,0.0,0.0
2025-05-19,3535,0,0,0,212457,0,0,-1000,0,51457,0,0,1000,0,161000,0,0.0,0.0,8000.0,23979.0,0.0,0.0,-29094.0,-387986.0,0.0,0.0
2025-05-20,3535,0,0,0,56596,0,0,0,0,-89861,0,0,0,0,146457,0,0.0,0.0,4000.0,23979.0,0.0,0.0,-301263.0,-583552.0,0.0,0.0
2025-05-21,3535,0,1000,0,121402,0,0,1000,0,20247,0,0,0,0,101155,0,0.0,0.0,0.0,31338.0,0.0,0.0,-423438.0,-188860.0,0.0,0.0
2025-05-22,3535,0,0,0,105660,0,0,0,0,-54127,0,0,0,0,159787,0,0.0,0.0,0.0,17829.0,0.0,0.0,-334236.0,-37187.0,0.0,0.0
2025-05-23,3535,0,0,0,182486,0,0,0,0,44117,0,0,0,0,138369,0,0.0,0.0,0.0,32829.0,0.0,0.0,-28167.0,187925.0,0.0,0.0
2025-05-26,3535,0,0,0,147023,0,0,-1000,0,48175,0,0,1000,0,98848,0,0.0,0.0,0.0,29000.0,0.0,0.0,-31449.0,138003.0,0.0,0.0
2025-05-27,3535,0,0,0,93000,0,0,-1000,0,-119189,0,0,1000,0,212189,0,0.0,0.0,-1000.0,24000.0,0.0,0.0,-60777.0,-26099.0,0.0,0.0
2025-05-28,3535,0,0,0,120000,0,0,-1000,0,12881,0,0,1000,0,107119,0,0.0,0.0,-3000.0,21980.0,0.0,0.0,-68143.0,-417990.0,0.0,0.0
2025-05-29,3535,0,0,0,84000,0,0,-1000,0,9000,0,0,1000,0,75000,0,0.0,0.0,-4000.0,20000.0,0.0,0.0,-5016.0,-80649.0,0.0,0.0
2025-06-02,3535,0,0,0,152000,0,0,-4170,0,-40000,0,0,4170,0,192000,0,0.0,0.0,-8170.0,12830.0,0.0,0.0,-89133.0,116880.0,0.0,0.0
2025-06-03,3535,0,0,0,190167,0,0,-7000,0,86167,0,0,7000,0,104000,0,0.0,0.0,-14170.0,10830.0,0.0,0.0,-51141.0,194039.0,0.0,0.0
2025-06-04,3535,0,0,0,384413,0,0,-1000,0,235413,0,0,1000,0,149000,0,0.0,0.0,-14170.0,8830.0,0.0,0.0,303461.0,260315.0,0.0,0.0
2025-06-05,3535,0,10181,0,1046000,0,0,10181,0,163420,0,0,0,0,882580,0,0.0,0.0,-2989.0,19011.0,0.0,0.0,454000.0,563139.0,0.0,0.0
2025-06-06,3535,0,1000,0,3321177,0,0,-15181,0,-2687823,0,0,16181,0,6009000,0,0.0,0.0,-17170.0,-170.0,0.0,0.0,-2242823.0,-2107100.0,0.0,0.0
2025-06-09,3535,0,165487,0,2212453,0,0,153487,0,-4624,0,0,12000,0,2217077,0,0.0,0.0,140487.0,147317.0,0.0,0.0,-2207447.0,-2172910.0,0.0,0.0
2025-06-10,3535,0,96000,0,6380136,0,0,-48487,0,-1303417,0,0,144487,0,7683553,0,0.0,0.0,99000.0,92830.0,0.0,0.0,-3597031.0,-3708715.0,0.0,0.0
2025-06-11,3535,0,1000,0,1323000,0,0,-27014,0,139114,0,0,28014,0,1183886,0,0.0,0.0,72986.0,61816.0,0.0,0.0,-3693330.0,-3751909.0,0.0,0.0
2025-06-12,3535,0,2000,0,657000,0,0,2000,0,-268000,0,0,0,0,925000,0,0.0,0.0,64805.0,58816.0,0.0,0.0,-4124750.0,-4162331.0,0.0,0.0
2025-06-13,3535,0,0,0,750000,0,0,-1919,0,-13000,0,0,1919,0,763000,0,0.0,0.0,78067.0,56897.0,0.0,0.0,-1449927.0,-4032002.0,0.0,0.0
2025-06-16,3535,0,0,0,518000,0,0,-1,0,-1017000,0,0,1,0,1535000,0,0.0,0.0,-75421.0,56896.0,0.0,0.0,-2462303.0,-4787050.0,0.0,0.0
2025-06-17,3535,0,1000,0,409000,0,0,-2101,0,85000,0,0,3101,0,324000,0,0.0,0.0,-29035.0,55795.0,0.0,0.0,-1073886.0,-4753507.0,0.0,0.0
2025-06-18,3535,0,3000,0,183000,0,0,-1231,0,-194000,0,0,4231,0,377000,0,0.0,0.0,-3252.0,54564.0,0.0,0.0,-1407000.0,-4857646.0,0.0,0.0
2025-06-19,3535,0,2000,0,329000,0,0,-67429,0,141000,0,0,69429,0,188000,0,0.0,0.0,-72681.0,-13865.0,0.0,0.0,-998000.0,-4736893.0,0.0,0.0
2025-06-20,3535,0,1000,0,890000,0,0,750,0,241000,0,0,250,0,649000,0,0.0,0.0,-70012.0,-13115.0,0.0,0.0,-744000.0,-4441766.0,0.0,0.0
2025-06-23,3535,0,1533,0,927000,0,0,532,0,-65250,0,0,1001,0,992250,0,0.0,0.0,-69479.0,-12583.0,0.0,0.0,207750.0,-4551133.0,0.0,0.0
2025-06-24,3535,24000,0,0,2085000,0,24000,-4211,0,-334000,0,0,4211,0,2419000,0,24000.0,24000.0,-71589.0,-15794.0,0.0,0.0,-211250.0,-4933308.0,0.0,0.0
2025-06-25,3535,23000,0,0,488000,0,23000,-1,0,-73000,0,0,1,0,561000,0,47000.0,47000.0,-70359.0,-14795.0,0.0,0.0,-90250.0,-4887119.0,0.0,0.0
2025-06-26,3535,0,1000,0,466000,0,-24000,0,0,-121000,0,24000,1000,0,587000,0,23000.0,23000.0,-2930.0,-13795.0,0.0,0.0,-352250.0,-5021000.0,0.0,0.0
2025-06-27,3535,153000,47027,0,1318000,0,153000,43027,0,194000,0,0,4000,0,1124000,0,176000.0,176000.0,39347.0,30232.0,0.0,0.0,-399250.0,-4836000.0,0.0,0.0
2025-06-30,3535,0,50140,0,3090018,0,0,8139,0,376018,0,0,42001,0,2714000,0,176000.0,176000.0,46954.0,42541.0,0.0,0.0,42018.0,-4419982.0,0.0,0.0
2025-07-01,3535,0,10948,0,5427080,0,-176000,-54271,0,-72938,0,176000,65219,0,5500018,0,-24000.0,0.0,-3106.0,-4730.0,0.0,0.0,303080.0,-4579087.0,0.0,0.0
2025-07-02,3535,0,756,0,2802000,0,0,-1246,0,783000,0,0,2002,0,2019000,0,-47000.0,0.0,-4351.0,-4976.0,0.0,0.0,1159080.0,-4031500.0,0.0,0.0
2025-07-03,3535,0,2018,0,982000,0,0,-2095,0,-212000,0,0,4113,0,1194000,0,-23000.0,0.0,-6446.0,-17252.0,0.0,0.0,1068080.0,-4406920.0,0.0,0.0
2025-07-04,3535,268000,1007,0,2292000,0,268000,7,0,-95080,0,0,1000,0,2387080,0,92000.0,268000.0,-49466.0,-2064.0,0.0,0.0,779000.0,-1814177.0,0.0,0.0
2025-07-07,3535,188000,4000,0,1689000,0,188000,-5000,0,-336000,0,0,9000,0,2025000,0,280000.0,456000.0,-62605.0,-160551.0,0.0,0.0,66982.0,-2145553.0,0.0,0.0
2025-07-08,3535,0,14794,0,1969500,0,0,9794,0,770250,0,0,5000,0,1199250,0,456000.0,456000.0,1460.0,-102270.0,0.0,0.0,910170.0,-71886.0,0.0,0.0
2025-07-09,3535,120000,1728,0,1260000,0,120000,-1272,0,179000,0,0,3000,0,1081000,0,576000.0,576000.0,1434.0,-76528.0,0.0,0.0,306170.0,-32000.0,0.0,0.0
2025-07-10,3535,240000,262,0,1142000,0,240000,-738,0,-84000,0,0,1000,0,1226000,0,816000.0,816000.0,2791.0,-79266.0,0.0,0.0,434170.0,152000.0,0.0,0.0
2025-07-11,3535,110000,35113,0,1705000,0,110000,33113,0,247000,0,0,2000,0,1458000,0,658000.0,926000.0,35897.0,-44234.0,0.0,0.0,776250.0,412000.0,0.0,0.0
2025-07-14,3535,0,2519,0,4410000,0,-200000,-39379,0,-700000,0,200000,41898,0,5110000,0,270000.0,726000.0,1518.0,-83612.0,0.0,0.0,412250.0,729000.0,0.0,0.0
2025-07-15,3535,0,40440,0,2877000,0,0,2440,0,50000,0,0,38000,0,2827000,0,270000.0,726000.0,-5836.0,-79071.0,0.0,0.0,-308000.0,694000.0,0.0,0.0
2025-07-16,3535,0,8372,0,3450000,0,0,1372,0,638000,0,0,7000,0,2812000,0,150000.0,726000.0,-3192.0,-76468.0,0.0,0.0,151000.0,1526000.0,0.0,0.0
2025-07-17,3535,0,16893,0,2002000,0,0,15893,0,471000,0,0,1000,0,1531000,0,-90000.0,726000.0,13439.0,6854.0,0.0,0.0,706000.0,1856000.0,0.0,0.0
2025-07-18,3535,0,6350,0,1304000,0,0,-8651,0,171000,0,0,15001,0,1133000,0,-200000.0,726000.0,-28325.0,-2547.0,0.0,0.0,630000.0,1786000.0,0.0,0.0
2025-07-21,3535,28000,13606,0,1282000,0,28000,11606,0,-132000,0,0,2000,0,1414000,0,28000.0,754000.0,22660.0,8527.0,0.0,0.0,1198000.0,1719250.0,0.0,0.0
2025-07-22,3535,0,8000,0,3138000,0,-460000,8000,0,1238000,0,460000,0,0,1900000,0,-432000.0,270000.0,28220.0,20738.0,0.0,0.0,2386000.0,3291250.0,0.0,0.0
2025-07-23,3535,0,3000,0,1002000,0,0,2967,0,-510000,0,0,33,0,1512000,0,-432000.0,247000.0,29815.0,23706.0,0.0,0.0,1238000.0,2854250.0,0.0,0.0
2025-07-24,3535,0,6000,0,2430021,0,0,-209,0,1178021,0,0,6209,0,1252000,0,-432000.0,271000.0,13713.0,23497.0,0.0,0.0,1945021.0,4153271.0,0.0,0.0
2025-07-25,3535,0,0,0,971025,0,0,0,0,-2975,0,0,0,0,974000,0,-432000.0,118000.0,22364.0,-19530.0,0.0,0.0,1771046.0,3956296.0,0.0,0.0
2025-07-28,3535,297000,177000,0,4796000,0,297000,176216,0,-777046,0,0,784,0,5573046,0,-163000.0,415000.0,186974.0,148547.0,0.0,0.0,1126000.0,2803232.0,0.0,0.0
2025-07-29,3535,0,179000,0,4354200,0,0,15734,0,-315897,0,0,163266,0,4670097,0,297000.0,591000.0,194708.0,218552.0,0.0,0.0,-427897.0,2560273.0,0.0,0.0
2025-07-30,3535,0,31000,0,668000,0,0,-21428,0,-553000,0,0,52428,0,1221000,0,297000.0,591000.0,170313.0,198370.0,0.0,0.0,-470897.0,1224273.0,0.0,0.0
2025-07-31,3535,0,1000,0,3887000,0,0,-45278,0,2707000,0,0,46278,0,1180000,0,297000.0,591000.0,125244.0,155187.0,0.0,0.0,1058082.0,4143273.0,0.0,0.0
2025-08-01,3535,0,116000,0,1433000,0,0,114591,0,-463000,0,0,1409,0,1896000,0,297000.0,323000.0,239835.0,269771.0,0.0,0.0,598057.0,3775353.0,0.0,0.0
2025-08-04,3535,0,17000,0,1342000,0,0,14334,0,-872000,0,0,2666,0,2214000,0,0.0,135000.0,77953.0,289105.0,0.0,0.0,503103.0,3239353.0,0.0,0.0
2025-08-05,3535,0,17000,0,1082000,0,0,-46852,0,224800,0,0,63852,0,857200,0,0.0,135000.0,15367.0,232459.0,0.0,0.0,1043800.0,2693903.0,0.0,0.0
2025-08-06,3535,0,33000,0,1484000,0,0,33000,0,165000,0,0,0,0,1319000,0,0.0,15000.0,69795.0,266731.0,0.0,0.0,1761800.0,2679903.0,0.0,0.0
2025-08-07,3535,0,2000,0,1884000,0,0,1000,0,-1000,0,0,1000,0,1885000,0,0.0,-225000.0,116073.0,268469.0,0.0,0.0,-946200.0,2762903.0,0.0,0.0
2025-08-08,3535,0,0,0,298000,0,0,0,0,-958000,0,0,0,0,1256000,0,0.0,-335000.0,1482.0,235356.0,0.0,0.0,-1441200.0,1557903.0,0.0,0.0
2025-08-11,3535,0,20000,0,1297000,0,0,-224000,0,-1128000,0,0,244000,0,2425000,0,0.0,-135000.0,-236852.0,50735.0,0.0,0.0,-1697200.0,1129903.0,0.0,0.0
2025-08-12,3535,0,0,0,4679000,0,0,0,0,3955000,0,0,0,0,724000,0,0.0,-135000.0,-190000.0,48295.0,0.0,0.0,2033000.0,5034903.0,0.0,0.0
2025-08-13,3535,0,0,0,1255000,0,-60000,0,0,-287000,0,60000,0,0,1542000,0,-60000.0,-195000.0,-223000.0,46923.0,0.0,0.0,1581000.0,4109903.0,0.0,0.0
2025-08-14,3535,0,1000,0,293000,0,0,1000,0,-569000,0,0,0,0,862000,0,-60000.0,-195000.0,-223000.0,32030.0,0.0,0.0,1013000.0,3069903.0,0.0,0.0
2025-08-15,3535,0,0,0,367000,0,0,-1000,0,-493000,0,0,1000,0,860000,0,-60000.0,-195000.0,-224000.0,39681.0,0.0,0.0,1478000.0,2405903.0,0.0,0.0
2025-08-18,3535,0,0,0,1011000,0,0,0,0,-120000,0,0,0,0,1131000,0,-60000.0,-223000.0,0.0,28075.0,0.0,0.0,2486000.0,2417903.0,0.0,0.0
2025-08-19,3535,0,4198,0,3159500,0,0,4198,0,-55500,0,0,0,0,3215000,0,-60000.0,237000.0,4198.0,24273.0,0.0,0.0,-1524500.0,1124403.0,0.0,0.0
2025-08-20,3535,0,0,0,2197000,0,-140000,-11198,0,-473500,0,140000,11198,0,2670500,0,-140000.0,97000.0,-7000.0,10108.0,0.0,0.0,-1711000.0,1160903.0,0.0,0.0
2025-08-21,3535,10000,0,0,1234300,0,10000,-25000,0,-10700,0,0,25000,0,1245000,0,-130000.0,107000.0,-33000.0,-14683.0,0.0,0.0,-1152700.0,-27818.0,0.0,0.0
2025-08-22,3535,5000,50379,0,3877000,0,-10000,50379,0,2390000,0,15000,0,0,1487000,0,-140000.0,97000.0,18379.0,35696.0,0.0,0.0,1730300.0,2365157.0,0.0,0.0
2025-08-25,3535,10000,146169,0,6694000,0,10000,28790,0,648533,0,0,117379,0,6045467,0,-130000.0,-190000.0,47169.0,-111730.0,0.0,0.0,2498833.0,3790736.0,0.0,0.0
2025-08-26,3535,0,62000,0,5714007,0,-391000,-69169,0,-1426244,0,391000,131169,0,7140251,0,-521000.0,-581000.0,-26198.0,-196633.0,0.0,0.0,1128089.0,2680389.0,0.0,0.0
2025-08-27,3535,0,13000,0,1980505,0,-10000,2000,0,-1733795,0,10000,11000,0,3714300,0,-391000.0,-591000.0,-13000.0,-173205.0,0.0,0.0,-132206.0,1499594.0,0.0,0.0
2025-08-28,3535,0,10168,0,1081250,0,0,168,0,-448750,0,0,10000,0,1530000,0,-401000.0,-591000.0,12168.0,-127759.0,0.0,0.0,-570256.0,-1656156.0,0.0,0.0
2025-08-29,3535,0,10000,0,1916010,0,0,-1000,0,474710,0,0,11000,0,1441300,0,-391000.0,-591000.0,-39211.0,-243350.0,0.0,0.0,-2485546.0,-718446.0,0.0,0.0
2025-09-01,3535,0,10000,0,1610000,0,0,-7000,0,337000,0,0,17000,0,1273000,0,-401000.0,-591000.0,-75001.0,-264684.0,0.0,0.0,-2797079.0,490554.0,0.0,0.0
2025-09-02,3535,0,3000,0,735200,0,0,-939,0,-209800,0,0,3939,0,945000,0,-10000.0,-591000.0,-6771.0,-218771.0,0.0,0.0,-1580635.0,55954.0,0.0,0.0
2025-09-03,3535,0,2000,0,586260,0,0,-821,0,-225740,0,0,2821,0,812000,0,0.0,-591000.0,-9592.0,-252592.0,0.0,0.0,-72580.0,-334786.0,0.0,0.0
2025-09-04,3535,0,7000,0,354020,0,0,-2716,0,-261180,0,0,9716,0,615200,0,0.0,-591000.0,-12476.0,-256308.0,0.0,0.0,114990.0,-594966.0,0.0,0.0
2025-09-05,3535,0,101145,0,1201000,0,0,29145,0,33000,0,0,72000,0,1168000,0,0.0,-591000.0,17669.0,-227163.0,0.0,0.0,-326720.0,396034.0,0.0,0.0
2025-09-08,3535,0,11128,0,3081005,0,0,-27541,0,-884995,0,0,38669,0,3966000,0,0.0,-591000.0,-2872.0,-30704.0,0.0,0.0,-1548715.0,639039.0,0.0,0.0
2025-09-09,3535,0,150619,0,6565200,0,0,138619,0,2956200,0,0,12000,0,3609000,0,0.0,-591000.0,136686.0,107915.0,0.0,0.0,1617285.0,-359761.0,0.0,0.0
2025-09-10,3535,0,92604,0,4698000,0,0,-55015,0,1156000,0,0,147619,0,3542000,0,0.0,-531000.0,82492.0,52900.0,0.0,0.0,2999025.0,1083239.0,0.0,0.0
2025-09-11,3535,0,5210,0,2416116,0,0,-82818,0,18866,0,0,88028,0,2397250,0,0.0,-531000.0,2390.0,-30918.0,0.0,0.0,3279071.0,1671105.0,0.0,0.0
2025-09-12,3535,0,212389,0,7965150,0,0,102603,0,-42218,0,0,109786,0,8007368,0,0.0,-531000.0,75848.0,72685.0,0.0,0.0,3203853.0,2121887.0,0.0,0.0
2025-09-15,3535,0,10028,0,1742050,0,0,-102361,0,-1170950,0,0,112389,0,2913000,0,0.0,-531000.0,1028.0,-29676.0,0.0,0.0,2917898.0,1070937.0,0.0,0.0
2025-09-16,3535,0,2000,0,1462000,0,0,386,0,277850,0,0,1614,0,1184150,0,0.0,-531000.0,-137205.0,-33488.0,0.0,0.0,239548.0,1404287.0,0.0,0.0
2025-09-17,3535,0,324,0,1194000,0,0,324,0,-181150,0,0,0,0,1375150,0,0.0,-391000.0,-81866.0,-21966.0,0.0,0.0,-1097602.0,1696637.0,0.0,0.0
2025-09-18,3535,44000,13848,0,5194026,0,44000,12843,0,2550026,0,0,1005,0,2644000,0,44000.0,-357000.0,13795.0,15877.0,0.0,0.0,1433558.0,4257363.0,0.0,0.0
2025-09-19,3535,0,4000,0,3161650,0,0,-12786,0,-2902350,0,0,16786,0,6064000,0,44000.0,-347000.0,-101594.0,-47288.0,0.0,0.0,-1426574.0,-1034987.0,0.0,0.0
2024-09-23,6231,0,0,0,155000,0,-6000,0,0,155000,0,6000,0,0,0,0,-6000.0,-6000.0,0.0,0.0,0.0,0.0,155000.0,155000.0,0.0,0.0
2024-09-24,6231,0,1,0,30000,0,-14000,-4999,0,11000,0,14000,5000,0,19000,0,-20000.0,-20000.0,-4999.0,-4999.0,0.0,0.0,166000.0,166000.0,0.0,0.0
2024-09-25,6231,1000,0,0,43000,0,-3000,-15000,0,-17000,-3000,4000,15000,0,60000,3000,-23000.0,-23000.0,-19999.0,-19999.0,0.0,0.0,149000.0,149000.0,-3000.0,-3000.0
2024-09-26,6231,0,0,0,116000,0,-200,-9000,0,38000,0,200,9000,0,78000,0,-23200.0,-23200.0,-28999.0,-28999.0,0.0,0.0,187000.0,187000.0,-3000.0,-3000.0
2024-09-27,6231,0,0,0,76000,0,-8000,-1,0,64000,-14000,8000,1,0,12000,14000,-31200.0,-31200.0,-29000.0,-29000.0,0.0,0.0,251000.0,251000.0,-17000.0,-17000.0
2024-09-30,6231,0,5000,0,93800,0,-11000,5000,0,46800,-14000,11000,0,0,47000,14000,-36200.0,-42200.0,-24000.0,-24000.0,0.0,0.0,142800.0,297800.0,-31000.0,-31000.0
2024-10-01,6231,28416,20000,0,349010,130000,-1501,8000,0,-216990,130000,29917,12000,0,566000,0,-23701.0,-43701.0,-11001.0,-16000.0,0.0,0.0,-85190.0,80810.0,99000.0,99000.0
2024-10-04,6231,28769,33000,0,473010,1000,-1722,-22000,0,-298790,-27000,30491,55000,0,771800,28000,-22423.0,-45423.0,-18001.0,-38000.0,0.0,0.0,-366980.0,-217980.0,75000.0,72000.0
2024-10-07,6231,28404,30000,0,1046000,12000,3108,4000,0,639970,12000,25296,26000,0,406030,0,-19115.0,-42315.0,-5001.0,-34000.0,0.0,0.0,234990.0,421990.0,87000.0,84000.0
2024-10-08,6231,42564,9000,0,509000,27000,6764,-5000,0,-665000,27000,35800,14000,0,1174000,0,-4351.0,-35551.0,-10000.0,-39000.0,0.0,0.0,-494010.0,-243010.0,128000.0,111000.0
2024-10-09,6231,17093,5000,0,622005,71000,-10110,-28000,0,-59995,71000,27203,33000,0,682000,0,-3461.0,-45661.0,-43000.0,-67000.0,0.0,0.0,-600805.0,-303005.0,213000.0,182000.0
2024-10-11,6231,10531,4000,0,429000,0,-2609,-16000,0,67000,-125000,13140,20000,0,362000,125000,-4569.0,-48270.0,-67000.0,-83000.0,0.0,0.0,-316815.0,-236005.0,-42000.0,57000.0
2024-10-14,6231,5072,4000,0,393010,5000,-2924,4000,0,11010,5000,7996,0,0,382000,0,-5771.0,-51194.0,-41000.0,-79000.0,0.0,0.0,-7015.0,-224995.0,-10000.0,62000.0
2024-10-15,6231,32342,15000,0,1334020,77000,3392,9000,0,959015,67000,28950,6000,0,375005,10000,-5487.0,-47802.0,-36000.0,-70000.0,0.0,0.0,312030.0,734020.0,45000.0,129000.0
2024-10-16,6231,26870,16000,0,694000,94000,-6432,11000,0,185617,64000,33302,5000,0,508383,30000,-18683.0,-54234.0,-20000.0,-59000.0,0.0,0.0,1162647.0,919637.0,82000.0,193000.0
2024-10-17,6231,19775,13000,0,1085000,82000,-924,7000,0,76000,82000,20699,6000,0,1009000,0,-9497.0,-55158.0,15000.0,-52000.0,0.0,0.0,1298642.0,995637.0,93000.0,275000.0
2024-10-18,6231,12899,6000,0,715000,5322,-786,-6000,0,148000,5322,13685,12000,0,567000,0,-7674.0,-55944.0,25000.0,-58000.0,0.0,0.0,1379642.0,1143637.0,223322.0,280322.0
2024-10-21,6231,23817,20000,0,876030,3000,1243,14000,0,15010,-89000,22574,6000,0,861020,92000,-3507.0,-54701.0,35000.0,-44000.0,0.0,0.0,1383642.0,1158647.0,129322.0,191322.0
2024-10-22,6231,8978,6000,0,398000,0,1993,0,0,86000,-11000,6985,6000,0,312000,11000,-4906.0,-52708.0,26000.0,-44000.0,0.0,0.0,510627.0,1244647.0,51322.0,180322.0
2024-10-23,6231,2549,0,0,211000,10000,-185,0,0,-155000,-14000,2734,0,0,366000,24000,1341.0,-52893.0,15000.0,-44000.0,0.0,0.0,170010.0,1089647.0,-26678.0,166322.0
2024-10-24,6231,15079,11000,0,495000,0,533,-2000,0,91200,-67000,14546,13000,0,403800,67000,2798.0,-46360.0,6000.0,-46000.0,0.0,0.0,185210.0,1025847.0,-175678.0,99322.0
2024-10-25,6231,16621,4000,0,356010,0,-2046,-7000,0,-161990,-16000,18667,11000,0,518000,16000,1538.0,-34406.0,5000.0,-48001.0,0.0,0.0,-124780.0,852857.0,-197000.0,83322.0
2024-10-28,6231,12098,4000,0,267000,0,-431,-3000,0,6970,0,12529,7000,0,260030,0,-136.0,-31837.0,-12000.0,-36001.0,0.0,0.0,-132820.0,876827.0,-108000.0,86322.0
2024-10-29,6231,7911,7000,0,186000,0,-20795,-13000,0,-47800,-5000,28706,20000,0,233800,5000,-22924.0,-52432.0,-25000.0,-40001.0,0.0,0.0,-266620.0,791027.0,-102000.0,81322.0
2024-10-30,6231,11982,5000,0,375000,0,-16352,-5000,0,-104400,0,28334,10000,0,479400,0,-39091.0,-60784.0,-30000.0,-45000.0,0.0,0.0,-216020.0,622627.0,-88000.0,95322.0
2024-11-01,6231,10524,5000,0,585000,0,242,-1000,0,316000,-13000,10282,6000,0,269000,13000,-39382.0,-49542.0,-29000.0,-51000.0,0.0,0.0,8780.0,891827.0,-34000.0,96322.0
2024-11-04,6231,10650,8000,0,286000,0,403,5000,0,10200,-6000,10247,3000,0,275800,6000,-36933.0,-47638.0,-17000.0,-54000.0,0.0,0.0,180970.0,1119017.0,-24000.0,-39678.0
2024-11-05,6231,6265,14000,0,172200,20000,1289,14000,0,-2800,15000,4976,0,0,175000,5000,-35213.0,-44627.0,0.0,-18000.0,0.0,0.0,171200.0,1415007.0,-9000.0,2322.0
2024-11-06,6231,8165,11000,0,650000,20000,-5302,6000,0,243000,-30000,13467,5000,0,407000,50000,-19720.0,-53037.0,19000.0,-16000.0,0.0,0.0,462000.0,1018037.0,-34000.0,-39678.0
2024-11-07,6231,14175,13000,0,422000,0,-1907,6000,0,-156400,0,16082,7000,0,578400,0,-5275.0,-61708.0,30000.0,-5000.0,0.0,0.0,410000.0,1526637.0,-34000.0,-66678.0
2024-11-08,6231,8482,20000,0,223807,0,-1309,17000,0,-107213,-23000,9791,3000,0,331020,23000,-6826.0,-52907.0,48000.0,40000.0,0.0,0.0,-13213.0,1479419.0,-44000.0,-160678.0
2024-11-11,6231,18892,12000,0,148010,0,-2891,-10000,0,-104000,-82000,21783,22000,0,252010,82000,-10120.0,-53189.0,33000.0,46000.0,0.0,0.0,-127413.0,1308419.0,-120000.0,-117678.0
2024-11-12,6231,7124,1000,0,200000,0,-15922,-4000,0,83744,-20000,23046,5000,0,116256,20000,-27331.0,-66187.0,15000.0,38000.0,0.0,0.0,-40869.0,1381153.0,-155000.0,-142678.0
2024-11-13,6231,11113,8000,0,98000,0,-12858,7000,0,-103000,0,23971,1000,0,201000,0,-34887.0,-82437.0,16000.0,36000.0,0.0,0.0,-386869.0,319138.0,-125000.0,-209678.0
2024-11-14,6231,5283,4000,0,295000,74,-23411,4000,0,97000,-45926,28694,0,0,198000,46000,-56391.0,-99416.0,14000.0,29000.0,0.0,0.0,-133469.0,230521.0,-170926.0,-319604.0
2024-11-15,6231,20501,8000,0,287000,0,-2633,-2000,0,-86000,-48000,23134,10000,0,373000,48000,-57715.0,-101125.0,-5000.0,20000.0,0.0,0.0,-112256.0,68521.0,-195926.0,-449604.0
2024-11-18,6231,74219,21000,0,453000,6000,56570,9000,0,194000,-49000,17649,12000,0,259000,55000,1746.0,-43769.0,14000.0,35000.0,0.0,0.0,185744.0,114521.0,-162926.0,-503926.0
2024-11-19,6231,4668,9000,0,511000,16000,561,-9000,0,180525,-3000,4107,18000,0,330475,19000,18229.0,-44451.0,9000.0,12000.0,0.0,0.0,282525.0,280036.0,-145926.0,-417926.0
2024-11-20,6231,3683,0,0,303524,0,311,-8000,0,-49476,0,3372,8000,0,353000,0,31398.0,-46133.0,-6000.0,4000.0,0.0,0.0,336049.0,144560.0,-145926.0,-406926.0
2024-11-21,6231,3343,1000,0,158000,0,-114,1000,0,-33000,-16000,3457,0,0,191000,16000,54695.0,-46062.0,-9000.0,5000.0,0.0,0.0,206049.0,266560.0,-116000.0,-408926.0
2024-11-22,6231,3149,0,0,215000,250,1154,0,0,83000,-5750,1995,0,0,132000,6000,58482.0,-45441.0,-7000.0,7000.0,0.0,0.0,375049.0,258360.0,-73750.0,-347676.0
2024-11-25,6231,8000,1000,0,840799,10000,-7527,0,0,-204201,10000,15527,1000,0,1045000,0,-5615.0,-50922.0,-16000.0,14000.0,0.0,0.0,-23152.0,216149.0,-14750.0,-321676.0
2024-11-26,6231,72134,4000,0,210000,12000,50092,4000,0,-106320,-35000,22042,0,0,316320,47000,43916.0,-399.0,-3000.0,21000.0,0.0,0.0,-309997.0,102859.0,-46750.0,-356676.0
2024-11-27,6231,3772,3000,0,135000,0,263,3000,0,88666,-52000,3509,0,0,46334,52000,43868.0,20659.0,8000.0,37000.0,0.0,0.0,-171855.0,239325.0,-98750.0,-403676.0
2024-11-28,6231,2978,0,0,145000,0,8,0,0,21666,-13000,2970,0,0,123334,13000,43990.0,37019.0,7000.0,42000.0,0.0,0.0,-117189.0,365391.0,-95750.0,-416676.0
2024-11-29,6231,1473,0,0,205000,1000,109,0,0,116666,-76000,1364,0,0,88334,77000,42945.0,36886.0,7000.0,43000.0,0.0,0.0,-83523.0,166057.0,-166000.0,-479676.0
2024-12-02,6231,13000,5000,0,65000,0,-613,5000,0,-144000,-33000,13613,0,0,209000,33000,49859.0,35870.0,12000.0,43000.0,0.0,0.0,-23322.0,11857.0,-209000.0,-506676.0
2024-12-03,6231,32817,48000,0,804000,0,-1923,14000,0,263466,-361000,34740,34000,0,540534,361000,-2156.0,32658.0,22000.0,43000.0,0.0,0.0,346464.0,278123.0,-535000.0,-882676.0
2024-12-04,6231,6993,0,0,346200,0,1721,-4000,0,104200,0,5272,4000,0,242000,0,-698.0,39681.0,15000.0,33000.0,0.0,0.0,361998.0,139323.0,-483000.0,-852676.0
2024-12-05,6231,13351,10000,0,259010,0,-1643,10000,0,-15324,-118000,14994,0,0,274334,118000,-2349.0,39945.0,25000.0,37000.0,0.0,0.0,325008.0,280399.0,-588000.0,-970676.0
2024-12-06,6231,19267,4000,0,182410,0,-803,3000,0,-137924,-149000,20070,1000,0,320334,149000,-3261.0,40451.0,28000.0,23000.0,0.0,0.0,70418.0,249688.0,-661000.0,-1096676.0
2024-12-09,6231,10262,10000,0,574000,0,1895,1000,0,387265,-369000,8367,9000,0,186735,369000,-753.0,45237.0,24000.0,34000.0,0.0,0.0,601683.0,740953.0,-997000.0,-1383676.0
2024-12-10,6231,10862,4000,0,256000,2000,1793,-26000,0,60600,-80000,9069,30000,0,195400,82000,2963.0,62952.0,-16000.0,12000.0,0.0,0.0,398817.0,717809.0,-716000.0,-1443676.0
2024-12-11,6231,10787,20000,0,390000,0,1987,11000,0,110000,0,8800,9000,0,280000,0,3229.0,77797.0,-1000.0,16000.0,0.0,0.0,404617.0,930809.0,-716000.0,-1443676.0
2024-12-12,6231,5311,0,0,147020,2000,-5120,-13000,0,-19980,2000,10431,13000,0,167000,0,-248.0,96088.0,-24000.0,-1000.0,0.0,0.0,399961.0,813829.0,-596000.0,-1395750.0
2024-12-13,6231,6704,3000,0,176000,0,169,3000,0,-1080,-33000,6535,0,0,177080,33000,724.0,98890.0,-24000.0,4000.0,0.0,0.0,536805.0,898749.0,-480000.0,-1380750.0
2024-12-16,6231,8165,0,0,237000,0,955,-3000,0,85904,-92400,7210,3000,0,151096,92400,-216.0,43275.0,-28000.0,-8000.0,0.0,0.0,235444.0,790653.0,-203400.0,-1424150.0
2024-12-17,6231,1596,0,0,213000,0,-600,0,0,100000,-35000,2196,0,0,113000,35000,-2609.0,42114.0,-2000.0,1000.0,0.0,0.0,274844.0,710128.0,-158400.0,-1456150.0
2024-12-18,6231,2299,0,0,126000,0,932,-4000,0,11000,0,1367,4000,0,115000,0,-3664.0,42735.0,-17000.0,5000.0,0.0,0.0,175844.0,770604.0,-158400.0,-1456150.0
2024-12-19,6231,2085,0,0,95000,0,624,-1000,0,24000,0,1461,1000,0,71000,0,2080.0,43473.0,-5000.0,3000.0,0.0,0.0,219824.0,827604.0,-160400.0,-1440150.0
2024-12-20,6231,31019,3000,0,225000,0,22929,0,0,-152979,0,8090,3000,0,377979,0,24840.0,65248.0,-8000.0,3000.0,0.0,0.0,67925.0,591625.0,-127400.0,-1434400.0
2024-12-23,6231,10107,0,0,203000,0,2362,-8000,0,-80000,0,7745,8000,0,283000,0,26247.0,75137.0,-13000.0,-5000.0,0.0,0.0,-97979.0,715826.0,-35000.0,-1444400.0
2024-12-24,6231,2111,0,0,214000,0,-13088,-1000,0,132000,0,15199,1000,0,82000,0,13759.0,11957.0,-14000.0,-10000.0,0.0,0.0,-65979.0,954146.0,0.0,-1409400.0
2024-12-25,6231,10000,0,0,76000,0,-1530,0,0,-120678,-38000,11530,0,0,196678,38000,11297.0,10164.0,-10000.0,-13000.0,0.0,0.0,-197657.0,744802.0,-38000.0,-1395400.0
2024-12-26,6231,4958,0,0,230000,0,1080,0,0,49000,-89000,3878,0,0,181000,89000,11753.0,11236.0,-9000.0,-13000.0,0.0,0.0,-172657.0,772136.0,-127000.0,-1471400.0
2024-12-27,6231,17321,0,0,174000,0,21,0,0,21000,-48000,17300,0,0,153000,48000,-11155.0,11148.0,-9000.0,-13000.0,0.0,0.0,1322.0,676470.0,-175000.0,-1443400.0
2024-12-30,6231,6674,7000,0,332000,0,-7818,7000,0,218000,-160000,14492,0,0,114000,160000,-21335.0,3943.0,6000.0,-11000.0,0.0,0.0,299322.0,1038470.0,-335000.0,-1570400.0
2024-12-31,6231,5646,0,0,283000,0,2167,-5000,0,122000,-139000,3479,5000,0,161000,139000,-6080.0,8033.0,2000.0,-30000.0,0.0,0.0,289322.0,897004.0,-474000.0,-1348400.0
2025-01-02,6231,9315,0,0,95000,0,4755,0,0,-39800,-15000,4560,0,0,134800,15000,205.0,11067.0,2000.0,-26000.0,0.0,0.0,370200.0,753004.0,-451000.0,-1363400.0
2025-01-03,6231,10856,30000,0,241000,0,1042,30000,0,-16421,0,9814,0,0,257421,0,167.0,13752.0,32000.0,-6000.0,0.0,0.0,304779.0,751907.0,-362000.0,-1245400.0
2025-01-06,6231,20424,0,0,879000,0,6113,-114000,0,106400,-53000,14311,114000,0,772600,53000,6259.0,20668.0,-82000.0,-123000.0,0.0,0.0,390179.0,996231.0,-367000.0,-1149400.0
2025-01-07,6231,8000,15000,0,390000,4000,-4825,15000,0,9800,-88000,12825,0,0,380200,92000,9252.0,13948.0,-74000.0,-109000.0,0.0,0.0,181979.0,618766.0,-295000.0,-868400.0
2025-01-08,6231,13240,1000,0,358000,0,-2760,1000,0,-365000,0,16000,0,0,723000,0,4325.0,9395.0,-68000.0,-82000.0,0.0,0.0,-305021.0,193166.0,-156000.0,-788400.0
2025-01-09,6231,34059,17000,0,522000,13067,21805,17000,0,37000,13067,12254,0,0,485000,0,21375.0,29213.0,-51000.0,-76000.0,0.0,0.0,-228221.0,120166.0,-127933.0,-775333.0
2025-01-10,6231,32279,12000,0,837630,133000,-8476,-21000,0,-1522970,133000,40755,33000,0,2360600,0,11857.0,25857.0,-102000.0,-84000.0,0.0,0.0,-1734770.0,-1382824.0,5067.0,-644333.0
2025-01-13,6231,13528,11000,0,549000,40000,-1400,11000,0,-305600,40000,14928,0,0,854600,0,4344.0,24288.0,23000.0,-76000.0,0.0,0.0,-2146770.0,-1687344.0,98067.0,-571333.0
2025-01-14,6231,82376,26000,0,1062001,55000,56942,26000,0,-96019,55000,25434,0,0,1158020,0,66111.0,80275.0,34000.0,-47000.0,0.0,0.0,-2252589.0,-1869267.0,241067.0,-423933.0
2025-01-15,6231,59909,8000,0,496000,78000,-29415,-26000,0,-1231000,78000,89324,34000,0,1727000,0,39456.0,51460.0,7000.0,-73000.0,0.0,0.0,-3118589.0,-3200267.0,319067.0,-310933.0
2025-01-16,6231,38901,45000,0,596000,24000,29319,45000,0,-43010,24000,9582,0,0,639010,0,46970.0,79847.0,35000.0,-24000.0,0.0,0.0,-3198599.0,-3254277.0,330000.0,-286933.0
2025-01-17,6231,65039,0,0,296100,18000,-9272,0,0,-868900,17700,74311,0,0,1165000,300,46174.0,69951.0,56000.0,-23000.0,0.0,0.0,-2544529.0,-4147177.0,214700.0,-269233.0
2025-01-20,6231,35931,4000,0,606002,31000,24687,4000,0,289002,31000,11244,0,0,317000,0,72261.0,71709.0,49000.0,-19000.0,0.0,0.0,-1949927.0,-3705196.0,205700.0,-238233.0
2025-01-21,6231,20270,1000,0,331000,9000,45,1000,0,-16000,9000,20225,0,0,347000,0,15364.0,69392.0,24000.0,-10000.0,0.0,0.0,-1869908.0,-3641196.0,159700.0,-229233.0
2025-01-22,6231,8726,0,0,200000,3000,-26469,-17000,0,-247000,3000,35195,17000,0,447000,0,18310.0,56011.0,33000.0,-26000.0,0.0,0.0,-885908.0,-4020196.0,84700.0,-226233.0
2025-02-03,6231,41885,1000,0,231000,3000,2719,-45000,0,-279100,2900,39166,46000,0,510100,100,-8290.0,60260.0,-57000.0,-71000.0,0.0,0.0,-1121998.0,-4178618.0,63600.0,-185333.0
2025-02-04,6231,53630,1000,0,660002,13000,23964,-1000,0,117002,13000,29666,2000,0,543000,0,24946.0,83144.0,-58000.0,-72000.0,0.0,0.0,-136096.0,-4110616.0,58900.0,-83333.0
2025-02-05,6231,59608,8000,0,617000,245250,38481,8000,0,-148400,245250,21127,0,0,765400,0,38740.0,121604.0,-54000.0,-64000.0,0.0,0.0,-573498.0,-4280016.0,273150.0,209917.0
2025-02-06,6231,206744,46000,0,986000,649000,166257,45000,0,55960,649000,40487,1000,0,930040,0,204952.0,295679.0,-10000.0,-26000.0,0.0,0.0,-501538.0,-4442056.0,913150.0,1018917.0
2025-02-07,6231,12895,4000,0,274000,102000,-50325,1000,0,-554000,102000,63220,3000,0,828000,0,181096.0,243187.0,8000.0,-20000.0,0.0,0.0,-808538.0,-5118056.0,1012150.0,1259917.0
2025-02-10,6231,4838,3000,0,418000,1000,-136945,-24000,0,-170000,1000,141783,27000,0,588000,0,41432.0,101487.0,29000.0,-44000.0,0.0,0.0,-699438.0,-5248256.0,1010250.0,1275917.0
2025-02-11,6231,32896,1601,0,234000,0,2831,1601,0,-346000,0,30065,0,0,580000,0,20299.0,103276.0,31601.0,-72399.0,0.0,0.0,-1162440.0,-5577835.0,997250.0,1275917.0
2025-02-12,6231,10566,0,0,262000,1000,-14542,-1406,0,4995,1000,25108,1406,0,257005,0,-32724.0,82621.0,22195.0,40195.0,0.0,0.0,-1009045.0,-5679240.0,753000.0,1329917.0
2025-02-13,6231,48906,5000,0,179000,45220,35501,3805,0,-115800,45220,13405,1195,0,294800,0,-163480.0,122947.0,-19000.0,29000.0,0.0,0.0,-1180805.0,-5804840.0,149220.0,1463137.0
2025-02-14,6231,10048,0,0,84000,4000,-25066,-13000,0,-77000,4000,35114,13000,0,161000,0,-138221.0,100641.0,-33000.0,15000.0,0.0,0.0,-703805.0,-5516840.0,51220.0,1467137.0
2025-02-17,6231,4272,1000,0,88000,4000,-6041,1000,0,6000,4000,10313,0,0,82000,0,-7317.0,72795.0,-8000.0,-1000.0,0.0,0.0,-527805.0,-5547840.0,54220.0,1458070.0
2025-02-18,6231,62217,10000,0,316000,75000,50292,10000,0,-106000,75000,11925,0,0,422000,0,40144.0,131563.0,399.0,30000.0,0.0,0.0,-287805.0,-4130870.0,129220.0,1400070.0
2025-02-19,6231,14436,0,0,118000,3100,-40516,-2000,0,-162800,3100,54952,2000,0,280800,0,14170.0,92447.0,-195.0,17000.0,0.0,0.0,-455600.0,-3988070.0,131320.0,1363170.0
2025-02-20,6231,28219,0,0,85000,0,1736,-6000,0,-193000,-54000,26483,6000,0,278000,54000,-19595.0,37241.0,-10000.0,-15000.0,0.0,0.0,-532800.0,-4085051.0,32100.0,1254170.0
2025-02-21,6231,35000,0,0,307000,5000,-34873,-6000,0,-303200,-163000,69873,6000,0,610200,168000,-29402.0,31783.0,-3000.0,5000.0,0.0,0.0,-759000.0,-3157251.0,-134900.0,1013170.0
2025-02-24,6231,24000,2000,0,114000,5000,-6445,-3000,0,-197000,-35000,30445,5000,0,311000,40000,-29806.0,-3981.0,-7000.0,-43000.0,0.0,0.0,-962000.0,-3311241.0,-173900.0,954170.0
2025-02-25,6231,10020,7000,0,77600,1000,-1725,5000,0,-278400,1000,11745,2000,0,356000,0,-81823.0,3566.0,-12000.0,-38000.0,0.0,0.0,-1134400.0,-2720741.0,-247900.0,937470.0
2025-02-26,6231,27967,8000,0,186000,1000,14109,-3000,0,-301000,-5000,13858,11000,0,487000,6000,-27198.0,-7012.0,-13000.0,-45000.0,0.0,0.0,-1272600.0,-3310743.0,-256000.0,901470.0
2025-02-27,6231,64913,0,0,491196,0,56235,-4000,0,206196,-34000,8678,4000,0,285000,34000,27301.0,49178.0,-11000.0,-50000.0,0.0,0.0,-873404.0,-3088547.0,-236000.0,858470.0
2025-03-03,6231,54281,5000,0,242007,2000,-61035,-1000,0,-837893,2000,115316,6000,0,1079900,0,1139.0,14612.0,-6000.0,-34000.0,0.0,0.0,-1408097.0,-3679440.0,-71000.0,857470.0
2025-03-04,6231,42409,0,0,437000,0,-715,0,0,26800,-41000,43124,0,0,410200,41000,6869.0,11178.0,-3000.0,11000.0,0.0,0.0,-1184297.0,-3373540.0,-77000.0,813570.0
2025-03-05,6231,40488,0,0,382000,0,4470,-1000,0,-124000,-285000,36018,1000,0,506000,285000,13064.0,-8316.0,-9000.0,11000.0,0.0,0.0,-1029897.0,-3614542.0,-363000.0,515570.0
2025-03-06,6231,11790,0,0,243000,0,2950,0,0,-5000,-5000,8840,0,0,248000,5000,1905.0,-43847.0,-6000.0,3000.0,0.0,0.0,-733897.0,-3471142.0,-363000.0,265320.0
2025-03-07,6231,43000,3000,0,436000,0,-28511,-2000,0,175000,-115000,71511,5000,0,261000,115000,-82841.0,-238615.0,-4000.0,-44000.0,0.0,0.0,-765093.0,-3352102.0,-444000.0,-498680.0
2025-03-10,6231,5550,1000,0,606000,0,-7895,-2000,0,304000,-263000,13445,3000,0,302000,263000,-29701.0,-196185.0,-5000.0,-47000.0,0.0,0.0,376800.0,-2494102.0,-709000.0,-863680.0
2025-03-11,6231,14630,0,0,591000,11000,2595,-12000,0,245000,-61000,12035,12000,0,346000,72000,-26391.0,-56645.0,-17000.0,-35000.0,0.0,0.0,595000.0,-2079102.0,-729000.0,-925680.0
2025-03-12,6231,8236,0,0,268000,0,-3133,0,0,3773,-70000,11369,0,0,264227,70000,-33994.0,-62609.0,-16000.0,-36601.0,0.0,0.0,722773.0,-1729329.0,-514000.0,-995680.0
2025-03-13,6231,8173,1332,0,530000,0,-5357,1332,0,277000,-335200,13530,0,0,253000,335200,-42301.0,-53424.0,-14668.0,-33863.0,0.0,0.0,1004773.0,-1457324.0,-844200.0,-1331880.0
2025-03-14,6231,3814,0,0,578000,0,1181,-1000,0,353000,-125000,2633,1000,0,225000,125000,-12609.0,-87744.0,-13668.0,-38668.0,0.0,0.0,1182773.0,-988524.0,-854200.0,-1502100.0
2025-03-17,6231,1263,0,0,124800,0,-2163,0,0,-54200,-60000,3426,0,0,179000,60000,-6877.0,-64841.0,-11668.0,-25668.0,0.0,0.0,824573.0,-965724.0,-651200.0,-1566100.0
2025-03-18,6231,1158,0,0,101000,0,-1208,-332,0,18000,-29000,2366,332,0,83000,29000,-10680.0,-60008.0,0.0,-27000.0,0.0,0.0,597573.0,-953724.0,-619200.0,-1599100.0
2025-03-19,6231,5000,0,0,125000,0,-9295,0,0,-40000,-30000,14295,0,0,165000,30000,-16842.0,-119595.0,0.0,-37000.0,0.0,0.0,553800.0,-887724.0,-579200.0,-1704100.0
2025-03-20,6231,2159,0,0,421000,6000,-1109,0,0,245000,-262000,3268,0,0,176000,268000,-12594.0,-80188.0,-1332.0,-35000.0,0.0,0.0,521800.0,-479924.0,-506000.0,-1969200.0
2025-03-21,6231,4692,3000,0,192000,2000,3646,3000,0,29000,2000,1046,0,0,163000,0,-10129.0,-78278.0,2668.0,-26000.0,0.0,0.0,197800.0,-257924.0,-379000.0,-1913200.0
2025-03-24,6231,3194,0,0,75000,12000,-13358,0,0,-39000,12000,16552,0,0,114000,0,-21324.0,-56763.0,2668.0,-20000.0,0.0,0.0,213000.0,6276.0,-307000.0,-1738200.0
2025-03-25,6231,1000,0,0,90000,0,-868,0,0,23800,0,1868,0,0,66200,0,-20984.0,-51186.0,3000.0,-17000.0,0.0,0.0,218800.0,227076.0,-278000.0,-1703200.0
2025-03-26,6231,1851,4000,0,141000,10000,410,4000,0,29000,10000,1441,0,0,112000,0,-11279.0,-49051.0,7000.0,-18000.0,0.0,0.0,287800.0,534476.0,-238000.0,-1694200.0
2025-03-27,6231,18030,3000,0,216000,11000,-2355,-1000,0,-71000,11000,20385,4000,0,287000,0,-12525.0,-65515.0,6000.0,-16000.0,0.0,0.0,-28200.0,764476.0,35000.0,-1678200.0
2025-03-28,6231,5112,3000,0,438000,0,1667,-2000,0,133000,0,3445,5000,0,305000,0,-14504.0,-120083.0,1000.0,-14000.0,0.0,0.0,75800.0,691280.0,33000.0,-1644200.0
2025-03-31,6231,9648,2000,0,926000,1000,-8961,-1000,0,549000,1000,18609,3000,0,377000,0,-10107.0,-68009.0,0.0,-14000.0,0.0,0.0,663800.0,2078173.0,22000.0,-1645200.0
2025-04-01,6231,1943,13000,0,429000,0,-219,11000,0,268000,-15000,2162,2000,0,161000,15000,-9458.0,-67513.0,11000.0,-3000.0,0.0,0.0,908000.0,2319373.0,7000.0,-1619200.0
2025-04-02,6231,744,2058,0,152000,10100,692,2058,0,-22800,-22900,52,0,0,174800,33000,-9176.0,-71291.0,9058.0,58.0,0.0,0.0,856200.0,2420573.0,-25900.0,-1357100.0
2025-04-07,6231,0,0,0,15000,0,-1000,0,0,15000,0,1000,0,0,0,0,-7821.0,-75241.0,10058.0,58.0,0.0,0.0,942200.0,2440573.0,-36900.0,-1352100.0
2025-04-08,6231,0,0,0,22000,0,-1000,0,0,22000,0,1000,0,0,0,0,-10488.0,-47730.0,12058.0,2058.0,0.0,0.0,831200.0,2287573.0,-36900.0,-1237100.0
2025-04-09,6231,0,0,0,65000,0,0,0,0,64000,0,0,0,0,1000,0,-1527.0,-39835.0,13058.0,4058.0,0.0,0.0,346200.0,2047573.0,-37900.0,-974100.0
2025-04-10,6231,64303,1144,0,432000,12000,13325,-6856,0,-906063,-253000,50978,8000,0,1338063,265000,12017.0,-29105.0,-4798.0,9202.0,0.0,0.0,-827863.0,896510.0,-275900.0,-1166100.0
2025-04-11,6231,25699,0,0,1732000,0,-9895,-11601,0,1224000,-581000,35594,11601,0,508000,581000,1430.0,-35867.0,-18457.0,-2399.0,0.0,0.0,418937.0,2116737.0,-834000.0,-1677100.0
2025-04-14,6231,39656,19956,0,838000,0,-18608,19956,0,375800,-333000,58264,0,0,462200,333000,-16178.0,-49118.0,1499.0,16225.0,0.0,0.0,779737.0,2215537.0,-1167000.0,-1674900.0
2025-04-15,6231,11632,3000,0,426000,0,3383,2044,0,187000,0,8249,956,0,239000,0,-11795.0,-46916.0,3543.0,19269.0,0.0,0.0,944737.0,2049537.0,-1167000.0,-1549900.0
2025-04-16,6231,10668,0,0,274096,0,1313,0,0,-20904,0,9355,0,0,295000,0,-10482.0,-43440.0,3543.0,19269.0,0.0,0.0,859833.0,2082833.0,-1167000.0,-1489900.0
2025-04-17,6231,6356,12000,0,507000,0,-4183,12000,0,118278,0,10539,0,0,388722,0,-27990.0,-46415.0,22399.0,31601.0,0.0,0.0,1884174.0,2183111.0,-914000.0,-1460900.0
2025-04-18,6231,3847,0,0,200000,0,-269,0,0,56000,-4916,4116,0,0,144000,4916,-18364.0,-37389.0,34000.0,31601.0,0.0,0.0,716174.0,2279111.0,-337916.0,-1435816.0
2025-04-21,6231,2036,0,0,221000,0,-2662,0,0,54000,-1000,4698,0,0,167000,1000,-2418.0,-38942.0,14044.0,31601.0,0.0,0.0,394374.0,2088111.0,-5916.0,-1174816.0
2025-04-22,6231,15866,1000,0,300000,0,3388,1000,0,113188,-25000,12478,0,0,186812,25000,-2413.0,-39200.0,13000.0,29601.0,0.0,0.0,320562.0,2172299.0,-30916.0,-1201816.0
2025-04-23,6231,3896,121,0,311000,0,2020,121,0,144384,-20000,1876,0,0,166616,20000,-1706.0,-23822.0,13121.0,29722.0,0.0,0.0,485850.0,2355683.0,-50916.0,-1233816.0
2025-04-24,6231,2175,0,0,172000,0,-3945,0,0,-36000,0,6120,0,0,208000,0,-1468.0,-26899.0,1121.0,29722.0,0.0,0.0,331572.0,2295883.0,-50916.0,-1233816.0
2025-04-25,6231,17130,0,0,413000,0,3979,-324,0,196000,0,13151,324,0,217000,0,2780.0,-23330.0,797.0,25398.0,0.0,0.0,471572.0,2462883.0,-46000.0,-1243816.0
2025-04-28,6231,9217,0,0,278000,0,4385,0,0,-33787,0,4832,0,0,311787,0,9827.0,-16590.0,797.0,26398.0,0.0,0.0,383785.0,2500096.0,-45000.0,-1254816.0
2025-04-29,6231,34070,0,0,398008,0,8131,0,0,-634480,0,25939,0,0,1032488,0,14570.0,-10126.0,-203.0,28398.0,0.0,0.0,-363883.0,1732616.0,-20000.0,-1254816.0
2025-04-30,6231,29686,0,0,279000,0,583,-2344,0,-211725,0,29103,2344,0,490725,0,13133.0,-582.0,-2668.0,27054.0,0.0,0.0,-719992.0,971891.0,0.0,-1255816.0
2025-05-02,6231,5632,0,0,202000,0,2304,0,0,42992,0,3328,0,0,159008,0,19382.0,1941.0,-2668.0,16054.0,0.0,0.0,-641000.0,746883.0,0.0,-1240816.0
2025-05-05,6231,14230,0,0,383000,0,-19654,0,0,80000,0,33884,0,0,303000,0,-4251.0,-18405.0,-2344.0,13996.0,0.0,0.0,-757000.0,849683.0,0.0,-1217916.0
2025-05-06,6231,1390,2000,0,225000,0,-1083,2000,0,120000,0,2473,0,0,105000,0,-9719.0,-18488.0,-344.0,15996.0,0.0,0.0,-603213.0,954683.0,0.0,-1217916.0
2025-05-07,6231,7364,385,0,164000,0,-2827,385,0,-154000,0,10191,0,0,318000,0,-20677.0,-20315.0,41.0,16381.0,0.0,0.0,-122733.0,778683.0,0.0,-1217916.0
2025-05-08,6231,4082,0,0,194000,0,1178,-183,0,4000,0,2904,183,0,190000,0,-20082.0,-19137.0,2202.0,16198.0,0.0,0.0,92992.0,718683.0,0.0,-1217916.0
2025-05-09,6231,13000,0,0,266000,0,-5081,0,0,-45000,0,18081,0,0,311000,0,-27467.0,-37543.0,2202.0,23054.0,0.0,0.0,5000.0,1579746.0,0.0,-964916.0
2025-05-12,6231,14940,0,0,372000,0,3579,0,0,140200,0,11361,0,0,231800,0,-4234.0,-24069.0,2202.0,34655.0,0.0,0.0,65200.0,495946.0,0.0,-383916.0
2025-05-13,6231,4478,0,0,214000,0,-5708,-243,0,-33000,0,10186,243,0,247000,0,-8859.0,-11169.0,-41.0,14456.0,0.0,0.0,-87800.0,87146.0,0.0,-50916.0
2025-05-14,6231,8714,0,0,163000,0,2268,0,0,-142600,0,6446,0,0,305600,0,-3764.0,-12284.0,-426.0,12412.0,0.0,0.0,-76400.0,-242454.0,0.0,-50916.0
2025-05-15,6231,6370,0,0,127000,0,-1002,-3000,0,-148000,0,7372,3000,0,275000,0,-5944.0,-14599.0,-3243.0,9412.0,0.0,0.0,-228400.0,-369550.0,0.0,-50916.0
2025-05-16,6231,10963,0,0,73000,0,-858,0,0,-99091,0,11821,0,0,172091,0,-1721.0,-11274.0,-3243.0,-2588.0,0.0,0.0,-282491.0,-586919.0,0.0,-50916.0
2025-05-19,6231,6266,0,0,179000,0,-2578,0,0,-29600,-4000,8844,0,0,208600,4000,-7878.0,-13583.0,-3243.0,-2588.0,0.0,0.0,-452291.0,-672519.0,-4000.0,-50000.0
2025-05-20,6231,14000,0,0,241000,0,-2202,0,0,-136000,-31000,16202,0,0,377000,31000,-4372.0,-13123.0,-3000.0,-2588.0,0.0,0.0,-555291.0,-862519.0,-35000.0,-80000.0
2025-05-21,6231,14297,0,0,213000,0,5755,-13,0,11000,0,8542,13,0,202000,0,-885.0,-10756.0,-3013.0,-3601.0,0.0,0.0,-401691.0,-964707.0,-35000.0,-55000.0
2025-05-22,6231,4500,0,0,113000,0,-200,0,0,-3000,0,4700,0,0,116000,0,-83.0,-12976.0,-13.0,-3722.0,0.0,0.0,-256691.0,-1112091.0,-35000.0,-35000.0
2025-05-23,6231,9100,0,0,55000,0,-1051,0,0,-119000,0,10151,0,0,174000,0,-276.0,-10082.0,-13.0,-3722.0,0.0,0.0,-276600.0,-1195091.0,-35000.0,-35000.0
2025-05-26,6231,6483,0,0,130000,0,-800,0,0,33000,0,7283,0,0,97000,0,1502.0,-14861.0,-13.0,-3398.0,0.0,0.0,-214000.0,-1358091.0,-31000.0,-35000.0
2025-05-27,6231,18006,0,0,141000,0,-336,0,0,-54003,0,18342,0,0,195003,0,3368.0,-19582.0,-13.0,-3398.0,0.0,0.0,-132003.0,-1378307.0,0.0,-35000.0
2025-05-28,6231,5534,0,0,125000,0,-1691,0,0,15398,0,7225,0,0,109602,0,-4078.0,-29404.0,0.0,-3398.0,0.0,0.0,-127605.0,-728429.0,0.0,-35000.0
2025-05-29,6231,2942,1000,0,822000,0,-723,1000,0,-11125,0,3665,0,0,833125,0,-4601.0,-30710.0,1000.0,-54.0,0.0,0.0,-135730.0,-527829.0,0.0,-35000.0
2025-06-02,6231,16000,5000,0,114000,0,-3543,5000,0,-99000,0,19543,0,0,213000,0,-7093.0,-36557.0,6000.0,4946.0,0.0,0.0,-115730.0,-669821.0,0.0,-35000.0
2025-06-03,6231,4693,0,0,170000,0,1755,0,0,71000,0,2938,0,0,99000,0,-4538.0,-15148.0,6000.0,4946.0,0.0,0.0,-77730.0,-678821.0,0.0,-35000.0
2025-06-04,6231,5038,0,0,143000,0,1936,0,0,4000,0,3102,0,0,139000,0,-2266.0,-12129.0,6000.0,2946.0,0.0,0.0,-19727.0,-794821.0,0.0,-35000.0
2025-06-05,6231,10005,0,0,168000,0,5905,0,0,29000,0,4100,0,0,139000,0,5330.0,-3397.0,6000.0,2561.0,0.0,0.0,-6125.0,-611821.0,0.0,-35000.0
2025-06-06,6231,6000,0,0,92002,0,-2577,0,0,-46998,0,8577,0,0,139000,0,3476.0,-7152.0,5000.0,2744.0,0.0,0.0,-41998.0,-662819.0,0.0,-35000.0
2025-06-09,6231,11526,0,0,296000,0,3902,0,0,-388400,0,7624,0,0,684400,0,10921.0,1831.0,0.0,2744.0,0.0,0.0,-331398.0,-1006219.0,0.0,-35000.0
2025-06-10,6231,22166,0,0,560000,0,18599,-12000,0,268000,0,3567,12000,0,292000,0,27765.0,16851.0,-12000.0,-9256.0,0.0,0.0,-134398.0,-878419.0,0.0,-35000.0
2025-06-11,6231,4051,0,0,194000,0,-6665,0,0,-49000,0,10716,0,0,243000,0,19164.0,15894.0,-12000.0,-9013.0,0.0,0.0,-187398.0,-894419.0,0.0,-35000.0
2025-06-12,6231,4692,10000,0,254000,0,769,10000,0,-15000,0,3923,0,0,269000,0,14028.0,14395.0,-2000.0,987.0,0.0,0.0,-231398.0,-766819.0,0.0,-35000.0
2025-06-13,6231,4010,21000,0,145013,0,-1673,6000,0,-49987,0,5683,15000,0,195000,0,14932.0,13724.0,4000.0,9987.0,0.0,0.0,-234387.0,-668806.0,0.0,-35000.0
2025-06-16,6231,2926,9000,0,219000,0,-186,4000,0,170000,0,3112,5000,0,49000,0,10844.0,14396.0,8000.0,13987.0,0.0,0.0,324013.0,-399715.0,0.0,-35000.0
2025-06-17,6231,17558,11000,0,455000,0,10045,11000,0,193000,0,7513,0,0,262000,0,2290.0,27019.0,31000.0,24987.0,0.0,0.0,249013.0,-177115.0,0.0,-31000.0
2025-06-18,6231,49826,3000,0,699005,0,14711,3000,0,-1456467,0,35115,0,0,2155472,0,23666.0,43932.0,34000.0,27987.0,0.0,0.0,-1158454.0,-1497582.0,0.0,0.0
2025-06-19,6231,37382,2000,0,296472,0,20424,-10000,0,-306528,0,16958,12000,0,603000,0,43321.0,58601.0,14000.0,18000.0,0.0,0.0,-1449982.0,-1815110.0,0.0,0.0
2025-06-20,6231,11406,0,0,273052,0,-1911,-23000,0,-24948,0,13317,23000,0,298000,0,43083.0,56890.0,-15000.0,-5000.0,0.0,0.0,-1424943.0,-1837058.0,0.0,0.0
2025-06-23,6231,1813,0,0,210003,0,-6751,0,0,-56997,0,8564,0,0,267000,0,36518.0,51190.0,-19000.0,-5000.0,0.0,0.0,-1651940.0,-1775055.0,0.0,0.0
2025-06-24,6231,15002,0,0,293000,0,11455,0,0,24000,0,3547,0,0,269000,0,37928.0,63445.0,-30000.0,-5000.0,0.0,0.0,-1820940.0,-1784055.0,0.0,0.0
2025-06-25,6231,36817,0,0,448000,0,27164,0,0,109000,0,9653,0,0,339000,0,50381.0,90945.0,-33000.0,-5000.0,0.0,0.0,-255473.0,-1621052.0,0.0,0.0
2025-06-26,6231,4206,0,0,151004,0,-16517,0,0,-130996,0,20723,0,0,282000,0,13440.0,76119.0,-23000.0,-5000.0,0.0,0.0,-79941.0,-1767446.0,0.0,0.0
2025-06-27,6231,15126,0,0,153400,0,7947,0,0,-20000,0,7179,0,0,173400,0,23298.0,84789.0,0.0,-6000.0,0.0,0.0,-74993.0,-1776321.0,0.0,0.0
2025-06-30,6231,19003,0,0,317843,0,15162,0,0,-152757,0,3841,0,0,470600,0,45211.0,103494.0,0.0,-11000.0,0.0,0.0,-170753.0,-1830078.0,0.0,0.0
2025-07-01,6231,29813,0,0,246000,0,3004,0,0,-166000,0,26809,0,0,412000,0,36760.0,104743.0,0.0,-11000.0,0.0,0.0,-360753.0,-2067078.0,0.0,0.0
2025-07-02,6231,6000,0,0,128000,0,-18821,0,0,-76000,0,24821,0,0,204000,0,-9225.0,83986.0,0.0,-11000.0,0.0,0.0,-545753.0,-2147078.0,0.0,0.0
2025-07-03,6231,4000,0,0,150000,0,-4532,0,0,76000,0,8532,0,0,74000,0,2760.0,73549.0,0.0,-11000.0,0.0,0.0,-338757.0,-2100078.0,0.0,0.0
2025-07-04,6231,14000,0,0,153000,0,2194,0,0,-92000,0,11806,0,0,245000,0,-2993.0,78320.0,0.0,-11000.0,0.0,0.0,-410757.0,-2145080.0,0.0,0.0
2025-07-07,6231,6403,0,0,194000,0,575,0,0,100000,0,5828,0,0,94000,0,-17580.0,74993.0,0.0,-11000.0,0.0,0.0,-158000.0,-1656680.0,0.0,0.0
2025-07-08,6231,2196,0,0,133000,0,-387,0,0,-3000,0,2583,0,0,136000,0,-20971.0,56007.0,0.0,1000.0,0.0,0.0,5000.0,-1927680.0,0.0,0.0
2025-07-09,6231,21245,0,0,469000,0,-9196,0,0,55000,0,30441,0,0,414000,0,-11346.0,53476.0,0.0,1000.0,0.0,0.0,136000.0,-1823680.0,0.0,0.0
2025-07-10,6231,5630,0,0,153000,18000,2671,0,0,-55000,18000,2959,0,0,208000,0,-4143.0,55378.0,0.0,-9000.0,0.0,0.0,5000.0,-1863680.0,18000.0,18000.0
2025-07-11,6231,5653,0,0,111000,0,-2794,0,0,52000,0,8447,0,0,59000,0,-9131.0,54257.0,0.0,-15000.0,0.0,0.0,149000.0,-1761693.0,18000.0,18000.0
2025-07-14,6231,8000,0,0,58000,0,-12113,0,0,-176012,0,20113,0,0,234012,0,-21819.0,42330.0,0.0,-19000.0,0.0,0.0,-127012.0,-2107705.0,18000.0,18000.0
2025-07-15,6231,4000,0,0,65000,0,543,0,0,-23000,0,3457,0,0,88000,0,-20889.0,32828.0,0.0,-30000.0,0.0,0.0,-147012.0,-2323705.0,18000.0,18000.0
2025-07-16,6231,11169,8000,0,112050,0,5744,8000,0,20650,0,5425,0,0,91400,0,-5949.0,23861.0,8000.0,-25000.0,0.0,0.0,-181362.0,-846588.0,18000.0,18000.0
2025-07-17,6231,25997,14000,0,463010,0,11553,14000,0,93410,0,14444,0,0,369600,0,2933.0,14990.0,22000.0,-1000.0,0.0,0.0,-32952.0,-446650.0,0.0,18000.0
2025-07-18,6231,3582,0,0,262000,0,-841,-11000,0,-138000,0,4423,11000,0,400000,0,4886.0,16060.0,11000.0,11000.0,0.0,0.0,-222952.0,-559702.0,0.0,18000.0
2025-07-21,6231,7201,9000,0,67000,0,5681,9000,0,-20001,0,1520,0,0,87001,0,22680.0,28492.0,20000.0,20000.0,0.0,0.0,-66941.0,-522706.0,0.0,18000.0
2025-07-22,6231,22490,11000,0,66000,0,-19544,2000,0,-474000,0,42034,9000,0,540000,0,2593.0,-2507.0,22000.0,22000.0,0.0,0.0,-517941.0,-1020706.0,0.0,18000.0
2025-07-23,6231,11226,0,0,29000,0,1398,0,0,-118000,0,9828,0,0,147000,0,-1753.0,-28273.0,14000.0,22000.0,0.0,0.0,-656591.0,-1247706.0,0.0,18000.0
2025-07-24,6231,5633,0,0,87000,0,2890,0,0,-64000,0,2743,0,0,151000,0,-10416.0,-8866.0,0.0,22000.0,0.0,0.0,-814001.0,-1180710.0,0.0,18000.0
2025-07-25,6231,4000,0,0,22000,0,-4871,0,0,-40000,0,8871,0,0,62000,0,-14446.0,-21684.0,11000.0,22000.0,0.0,0.0,-716001.0,-1200710.0,0.0,18000.0
2025-07-28,6231,9920,0,0,109000,0,5941,0,0,64990,0,3979,0,0,44010,0,-14186.0,-30905.0,2000.0,22000.0,0.0,0.0,-631010.0,-982963.0,0.0,18000.0
2025-07-29,6231,7351,10000,0,118000,0,-7288,10000,0,-125000,0,14639,0,0,243000,0,-1930.0,-41197.0,10000.0,32000.0,0.0,0.0,-282010.0,-941963.0,0.0,18000.0
2025-07-30,6231,5212,0,0,67050,0,-2712,-4000,0,-11950,0,7924,4000,0,79000,0,-6040.0,-25088.0,6000.0,28000.0,0.0,0.0,-175960.0,-877913.0,0.0,18000.0
2025-07-31,6231,10057,0,0,103000,0,1637,0,0,-225000,0,8420,0,0,328000,0,-7293.0,-18919.0,6000.0,28000.0,0.0,0.0,-336960.0,-1178913.0,0.0,18000.0
2025-08-01,6231,10214,0,0,318000,0,-32,0,0,185000,0,10246,0,0,133000,0,-2454.0,-21145.0,6000.0,28000.0,0.0,0.0,-111960.0,-901913.0,0.0,18000.0
2025-08-04,6231,4279,0,0,166000,0,-3084,0,0,88000,0,7363,0,0,78000,0,-11479.0,-24804.0,6000.0,28000.0,0.0,0.0,-88950.0,-913913.0,0.0,18000.0
2025-08-05,6231,13795,0,0,183000,0,13795,0,0,117980,0,0,0,0,65020,0,9604.0,-10622.0,-4000.0,28000.0,0.0,0.0,154030.0,-792933.0,0.0,18000.0
2025-08-06,6231,53539,0,0,697000,0,3593,-28000,0,-382867,0,49946,28000,0,1079867,0,15909.0,2167.0,-28000.0,0.0,0.0,0.0,-216887.0,-1230800.0,0.0,18000.0
2025-08-07,6231,13000,0,0,258000,0,5351,0,0,-87000,0,7649,0,0,345000,0,19623.0,4847.0,-28000.0,0.0,0.0,0.0,-78887.0,-1262800.0,0.0,0.0
2025-08-08,6231,7185,0,0,66000,0,-10,0,0,-120000,0,7195,0,0,186000,0,19645.0,7631.0,-28000.0,0.0,0.0,0.0,-383887.0,-1434800.0,0.0,0.0
2025-08-11,6231,7147,0,0,117000,0,908,0,0,-1000,0,6239,0,0,118000,0,23637.0,20652.0,-28000.0,0.0,0.0,0.0,-472887.0,-1259788.0,0.0,0.0
2025-08-12,6231,10000,0,0,62000,0,-422,0,0,-80000,0,10422,0,0,142000,0,9420.0,19687.0,-28000.0,0.0,0.0,0.0,-670867.0,-1316788.0,0.0,0.0
2025-08-13,6231,22048,4000,0,379000,0,17629,4000,0,220000,0,4419,0,0,159000,0,23456.0,31572.0,4000.0,-4000.0,0.0,0.0,-68000.0,-1117438.0,0.0,0.0
2025-08-14,6231,10499,0,0,256000,0,-2890,0,0,88000,0,13389,0,0,168000,0,15215.0,17129.0,4000.0,-18000.0,0.0,0.0,107000.0,-1122848.0,0.0,0.0
2025-08-15,6231,14101,1000,0,58000,0,-12603,1000,0,-319533,0,26704,0,0,377533,0,2622.0,5367.0,5000.0,-6000.0,0.0,0.0,-92533.0,-1304381.0,0.0,0.0
2025-08-18,6231,14103,0,0,113000,0,-3783,-5000,0,-40000,0,17886,5000,0,153000,0,-2069.0,-4097.0,0.0,-20000.0,0.0,0.0,-131533.0,-1324380.0,0.0,0.0
2025-08-19,6231,9151,0,0,145000,0,1347,0,0,2000,0,7804,0,0,143000,0,-300.0,16794.0,0.0,-22000.0,0.0,0.0,-49533.0,-848380.0,0.0,0.0
2025-08-20,6231,16000,0,0,106000,20000,-12855,0,0,-212000,20000,28855,0,0,318000,0,-30784.0,2541.0,-4000.0,-22000.0,0.0,0.0,-481533.0,-942380.0,20000.0,20000.0
2025-08-21,6231,14080,0,0,114100,0,8485,0,0,39100,0,5595,0,0,75000,0,-19409.0,8136.0,-4000.0,-22000.0,0.0,0.0,-530433.0,-839280.0,20000.0,20000.0
2025-08-22,6231,13181,0,0,106000,0,-5004,0,0,-153000,0,18185,0,0,259000,0,-11810.0,8003.0,-5000.0,-22000.0,0.0,0.0,-363900.0,-952280.0,20000.0,20000.0
2025-08-25,6231,15997,0,0,702000,0,3982,0,0,572000,0,12015,0,0,130000,0,-4045.0,6044.0,0.0,-22000.0,0.0,0.0,248100.0,-445270.0,20000.0,20000.0
2025-08-26,6231,9792,5000,0,181000,0,2523,5000,0,30000,0,7269,0,0,151000,0,-2869.0,15855.0,5000.0,-27000.0,0.0,0.0,276100.0,-290270.0,20000.0,20000.0
2025-08-27,6231,4527,0,0,222000,0,-2298,-5000,0,151000,0,6825,5000,0,71000,0,7688.0,16269.0,0.0,-28000.0,0.0,0.0,639100.0,-127320.0,0.0,20000.0
2025-08-28,6231,23857,0,0,309000,0,21715,0,0,160980,0,2142,0,0,148020,0,20918.0,36347.0,0.0,-28000.0,0.0,0.0,760980.0,258660.0,0.0,20000.0
2025-08-29,6231,12848,5000,0,171000,0,7039,5000,0,-6000,0,5809,0,0,177000,0,32961.0,43418.0,5000.0,-23000.0,0.0,0.0,907980.0,67660.0,0.0,20000.0
2025-09-01,6231,12175,0,0,260000,0,-502,-5000,0,114900,0,12677,5000,0,145100,0,28477.0,46000.0,0.0,-28000.0,0.0,0.0,450880.0,94560.0,0.0,20000.0
2025-09-02,6231,87124,0,0,555000,0,72354,0,0,51000,0,14770,0,0,504000,0,98308.0,104559.0,-5000.0,-28000.0,0.0,0.0,471880.0,27580.0,0.0,20000.0
2025-09-03,6231,46967,9000,0,210000,0,9979,9000,0,-25400,0,36988,0,0,235400,0,110585.0,110945.0,9000.0,9000.0,0.0,0.0,295480.0,385047.0,0.0,20000.0
2025-09-04,6231,88636,16000,0,373010,0,47527,16000,0,-981050,0,41109,0,0,1354060,0,136397.0,153121.0,25000.0,25000.0,0.0,0.0,-846550.0,-509003.0,0.0,20000.0
2025-09-05,6231,50323,0,0,165000,0,-14046,-5000,0,-400000,0,64369,5000,0,565000,0,115312.0,139085.0,15000.0,20000.0,0.0,0.0,-1240550.0,-789003.0,0.0,20000.0
2025-09-08,6231,185261,0,0,843005,0,129528,0,0,37005,0,55733,0,0,806000,0,245342.0,267705.0,20000.0,20000.0,0.0,0.0,-1318445.0,-750998.0,0.0,20000.0
2025-09-09,6231,111718,0,0,383000,0,-10710,0,0,-410000,0,122428,0,0,793000,0,162278.0,257417.0,20000.0,20000.0,0.0,0.0,-1779445.0,-1080998.0,0.0,20000.0
2025-09-10,6231,17000,10000,0,154100,0,-98718,3000,0,-437000,0,115718,7000,0,591100,0,53581.0,141070.0,14000.0,19000.0,0.0,0.0,-2191045.0,-1737998.0,0.0,20000.0
2025-09-11,6231,14565,1000,0,379000,0,-17103,-12000,0,104000,0,31668,13000,0,275000,0,-11049.0,126857.0,-14000.0,7000.0,0.0,0.0,-1105995.0,-1721998.0,0.0,20000.0
2025-09-12,6231,7928,0,0,151000,0,4157,0,0,21000,0,3771,0,0,130000,0,7154.0,143617.0,-9000.0,6000.0,0.0,0.0,-684995.0,-1381465.0,0.0,20000.0
2025-09-15,6231,18149,0,0,109000,0,-7925,0,0,-234015,0,26074,0,0,343015,0,-130299.0,139475.0,-9000.0,11000.0,0.0,0.0,-956015.0,-1575480.0,0.0,20000.0
2025-09-16,6231,43891,4000,0,306100,0,27586,4000,0,177100,0,16305,0,0,129000,0,-92003.0,165714.0,-5000.0,15000.0,0.0,0.0,-368915.0,-1400380.0,0.0,20000.0
2025-09-17,6231,148926,8000,0,900015,0,91578,1000,0,24815,0,57348,7000,0,875200,0,98293.0,270147.0,-7000.0,16000.0,0.0,0.0,92900.0,-1163565.0,0.0,0.0
2025-09-18,6231,81831,41000,0,640000,0,-41047,41000,0,-836000,0,122878,0,0,1476000,0,74349.0,220615.0,46000.0,57000.0,0.0,0.0,-847100.0,-2038665.0,0.0,0.0
2025-09-19,6231,118647,70000,0,1062002,0,-57187,61000,0,-280998,0,175834,9000,0,1343000,0,13005.0,168432.0,107000.0,118000.0,0.0,0.0,-1149098.0,-2166663.0,0.0,0.0
2024-09-23,6643,0,0,0,24000,0,-7251,-1000,0,24000,0,7251,1000,0,0,0,-7251.0,-7251.0,-1000.0,-1000.0,0.0,0.0,24000.0,24000.0,0.0,0.0
2024-09-24,6643,0,1,0,66050,0,-7354,-33999,0,65050,-95880,7354,34000,0,1000,95880,-14605.0,-14605.0,-34999.0,-34999.0,0.0,0.0,89050.0,89050.0,-95880.0,-95880.0
2024-09-25,6643,159000,0,0,226200,0,134839,-56000,0,135200,-415643,24161,56000,0,91000,415643,120234.0,120234.0,-90999.0,-90999.0,0.0,0.0,224250.0,224250.0,-511523.0,-511523.0
2024-09-26,6643,59000,0,0,111310,0,59000,-1001,0,100845,-48000,0,1001,0,10465,48000,179234.0,179234.0,-92000.0,-92000.0,0.0,0.0,325095.0,325095.0,-559523.0,-559523.0
2024-09-27,6643,31000,4000,0,69000,0,29000,4000,0,67000,-5000,2000,0,0,2000,5000,208234.0,208234.0,-88000.0,-88000.0,0.0,0.0,392095.0,392095.0,-564523.0,-564523.0
2024-09-30,6643,8000,0,0,32000,0,7000,0,0,28000,-1162,1000,0,0,4000,1162,222485.0,215234.0,-87000.0,-88000.0,0.0,0.0,396095.0,420095.0,-565685.0,-565685.0
2024-10-01,6643,9000,0,0,29425,0,9000,0,0,25425,-11000,0,0,0,4000,11000,238839.0,224234.0,-53001.0,-88000.0,0.0,0.0,356470.0,445520.0,-480805.0,-576685.0
2024-10-04,6643,9000,0,0,22000,0,9000,0,0,11559,0,0,0,0,10441,0,113000.0,233234.0,2999.0,-88000.0,0.0,0.0,232829.0,457079.0,-65162.0,-576685.0
2024-10-07,6643,3000,0,0,34660,0,3000,0,0,8300,0,0,0,0,26360,0,57000.0,236234.0,4000.0,-88000.0,0.0,0.0,140284.0,465379.0,-17162.0,-576685.0
2024-10-08,6643,0,5000,0,9000,0,0,4000,0,4000,0,0,1000,0,5000,0,28000.0,236234.0,4000.0,-84000.0,0.0,0.0,77284.0,469379.0,-12162.0,-576685.0
2024-10-09,6643,14418,6000,0,187276,30000,-9178,1000,0,-152724,-40000,23596,5000,0,340000,70000,11822.0,227056.0,5000.0,-83000.0,0.0,0.0,-103440.0,316655.0,-51000.0,-616685.0
2024-10-11,6643,22436,8000,0,324120,30500,-28203,7000,0,-187060,27500,50639,1000,0,511180,3000,-25381.0,198853.0,12000.0,-76000.0,0.0,0.0,-315925.0,129595.0,-12500.0,-589185.0
2024-10-14,6643,14323,4000,0,201000,0,-30623,4000,0,-76000,-81004,44946,0,0,277000,81004,-65004.0,168230.0,16000.0,-72000.0,0.0,0.0,-403484.0,53595.0,-93504.0,-670189.0
2024-10-15,6643,6233,4000,0,163452,0,-222,3000,0,32452,-35001,6455,1000,0,131000,35001,-68226.0,168008.0,19000.0,-69000.0,0.0,0.0,-379332.0,86047.0,-128505.0,-705190.0
2024-10-16,6643,14000,2000,0,120010,0,-3288,-5000,0,-155025,-94000,17288,7000,0,275035,94000,-71514.0,164720.0,10000.0,-74000.0,0.0,0.0,-538357.0,-68978.0,-222505.0,-799190.0
2024-10-17,6643,17640,0,0,166700,0,-4063,0,0,-194300,-49000,21703,0,0,361000,49000,-66399.0,160657.0,9000.0,-74000.0,0.0,0.0,-579933.0,-263278.0,-231505.0,-848190.0
2024-10-18,6643,22417,5000,0,231000,0,-1568,5000,0,-81015,-23568,23985,0,0,312015,23568,-39764.0,159089.0,7000.0,-69000.0,0.0,0.0,-473888.0,-344293.0,-282573.0,-871758.0
2024-10-21,6643,16324,2000,0,877912,11000,-41036,2000,0,339938,-19000,57360,0,0,537974,30000,-50177.0,118053.0,5000.0,-67000.0,0.0,0.0,-57950.0,-4355.0,-220569.0,-890758.0
2024-10-22,6643,16203,7000,0,258000,9000,-19087,5000,0,-303212,7000,35290,2000,0,561212,2000,-69042.0,98966.0,7000.0,-62000.0,0.0,0.0,-393614.0,-307567.0,-178568.0,-883758.0
2024-10-23,6643,8038,0,0,349010,8000,-24597,0,0,-73990,8000,32635,0,0,423000,0,-90351.0,74369.0,12000.0,-62000.0,0.0,0.0,-312579.0,-381557.0,-76568.0,-875758.0
2024-10-24,6643,16222,0,0,94000,61000,-7628,0,0,-257000,60000,23850,0,0,351000,1000,-93916.0,73992.0,12000.0,-61000.0,0.0,0.0,-375279.0,-662557.0,32432.0,-815758.0
2024-10-25,6643,8000,0,0,137200,0,-1632,-6000,0,-126800,0,9632,6000,0,264000,0,-93980.0,79714.0,1000.0,-33001.0,0.0,0.0,-421064.0,-854407.0,56000.0,-719878.0
2024-10-28,6643,11122,5000,0,276040,88000,-10199,0,0,-182960,88000,21321,5000,0,459000,0,-63143.0,-65324.0,-1000.0,22999.0,0.0,0.0,-943962.0,-1172567.0,163000.0,-216235.0
2024-10-29,6643,54000,3000,0,226235,21700,178,3000,0,-417765,21700,53822,0,0,644000,0,-43878.0,-124146.0,-3000.0,27000.0,0.0,0.0,-1058515.0,-1691177.0,177700.0,-146535.0
2024-10-30,6643,59221,15000,0,517665,0,-5887,1000,0,-236406,0,65108,14000,0,754071,0,-25168.0,-159033.0,-2000.0,24000.0,0.0,0.0,-1220931.0,-1994583.0,169700.0,-141535.0
2024-11-01,6643,29983,0,0,717900,0,-896,-11000,0,15899,-39000,30879,11000,0,702001,39000,-18436.0,-166929.0,-13000.0,13000.0,0.0,0.0,-948032.0,-2006684.0,70700.0,-179373.0
2024-11-04,6643,9391,0,0,926030,0,981,0,0,-38977,-9000,8410,0,0,965007,9000,-15823.0,-174948.0,-7000.0,13000.0,0.0,0.0,-860209.0,-2071086.0,61700.0,-177373.0
2024-11-05,6643,21048,0,0,171110,16000,-1846,0,0,-265890,10600,22894,0,0,437000,5400,-7470.0,-185794.0,-7000.0,13000.0,0.0,0.0,-943139.0,-2348535.0,-15700.0,-166773.0
2024-11-06,6643,7443,5000,0,447010,0,243,5000,0,113810,-118760,7200,0,0,333200,118760,-7405.0,-188551.0,-5000.0,18000.0,0.0,0.0,-411564.0,-2243025.0,-156160.0,-285533.0
2024-11-07,6643,71999,26000,0,510975,0,-1070,10000,0,-371025,-290000,73069,16000,0,882000,290000,-2588.0,-189621.0,4000.0,24000.0,0.0,0.0,-546183.0,-2618050.0,-446160.0,-575533.0
2024-11-08,6643,11184,10000,0,269235,0,-1471,9000,0,-24765,-31000,12655,1000,0,294000,31000,-3163.0,-181914.0,24000.0,32000.0,0.0,0.0,-586847.0,-2490091.0,-438160.0,-566533.0
2024-11-11,6643,9466,0,0,343000,0,989,0,0,-97000,-95000,8477,0,0,440000,95000,-3155.0,-152722.0,24000.0,25000.0,0.0,0.0,-644870.0,-2400031.0,-524160.0,-689033.0
2024-11-12,6643,4330,4000,0,235000,0,-785,-2000,0,116042,-13200,5115,6000,0,118958,13200,-2094.0,-122884.0,22000.0,19000.0,0.0,0.0,-262938.0,-2207989.0,-547960.0,-621229.0
2024-11-13,6643,25000,4000,0,61005,1000,-1379,0,0,-238045,-15680,26379,4000,0,299050,16680,-3716.0,-124041.0,17000.0,16000.0,0.0,0.0,-614793.0,-2478486.0,-444880.0,-601908.0
2024-11-14,6643,5327,0,0,248400,50,-416,0,0,-2600,-11751,5743,0,0,251000,11801,-3062.0,-121169.0,7000.0,21000.0,0.0,0.0,-246368.0,-2326061.0,-166631.0,-519659.0
2024-11-15,6643,25000,12000,0,118010,5000,-5,-18000,0,-86990,4000,25005,30000,0,205000,1000,-1596.0,-117111.0,-20000.0,3000.0,0.0,0.0,-308593.0,-2218751.0,-131631.0,-466659.0
2024-11-18,6643,25000,11000,0,407320,0,-485,-9000,0,205920,-101712,25485,20000,0,201400,101712,-3070.0,-116028.0,-29000.0,-11000.0,0.0,0.0,-5673.0,-1931816.0,-138343.0,-544803.0
2024-11-19,6643,3314,5000,0,429000,0,384,5000,0,315400,-133200,2930,0,0,113600,133200,-1901.0,-74608.0,-22000.0,-8000.0,0.0,0.0,193685.0,-1956354.0,-258343.0,-659003.0
2024-11-20,6643,3008,11000,0,235025,16000,249,7000,0,-17975,-1000,2759,4000,0,253000,17000,-273.0,-55272.0,-15000.0,-6000.0,0.0,0.0,413755.0,-1671117.0,-243663.0,-667003.0
2024-11-21,6643,1109,5000,0,237028,16000,109,5000,0,95628,16000,1000,0,0,141400,0,252.0,-30566.0,-10000.0,-1000.0,0.0,0.0,511983.0,-1501499.0,-215912.0,-659003.0
2024-11-22,6643,1000,0,0,298000,200,328,0,0,28992,200,672,0,0,269008,0,585.0,-22610.0,8000.0,-1000.0,0.0,0.0,627965.0,-1215507.0,-219712.0,-718803.0
2024-11-25,6643,560,0,0,177281,0,-687,-1000,0,70281,0,1247,1000,0,107000,0,383.0,-21665.0,16000.0,4000.0,0.0,0.0,492326.0,-1018426.0,-118000.0,-718803.0
2024-11-26,6643,6000,3000,0,65140,0,-1817,-4000,0,-118260,0,7817,7000,0,183400,0,-1818.0,-13283.0,7000.0,0.0,0.0,0.0,58666.0,-953726.0,15200.0,-806803.0
2024-11-27,6643,9000,0,0,95000,0,790,-15000,0,8000,-5000,8210,15000,0,87000,5000,-1277.0,-12671.0,-15000.0,-18000.0,0.0,0.0,84641.0,-527961.0,11200.0,-833503.0
2024-11-28,6643,5382,11000,0,105000,0,12,0,0,24000,0,5370,11000,0,81000,0,-1374.0,-6772.0,-20000.0,-19000.0,0.0,0.0,13013.0,-267555.0,-4800.0,-833503.0
2024-11-29,6643,4600,2000,0,471000,0,1346,-3000,0,294480,-11000,3254,5000,0,176520,11000,-356.0,-4530.0,-23000.0,-11000.0,0.0,0.0,278501.0,11026.0,-16000.0,-805503.0
2024-12-02,6643,3198,4000,0,72000,0,118,0,0,-95020,-1401,3080,4000,0,167020,1401,449.0,-5393.0,-22000.0,-11000.0,0.0,0.0,113200.0,-45017.0,-17401.0,-797904.0
2024-12-03,6643,12979,7000,0,470000,0,-21,7000,0,295000,0,13000,0,0,175000,0,2245.0,-3568.0,-11000.0,-4000.0,0.0,0.0,526460.0,515873.0,-17401.0,-808504.0
2024-12-04,6643,6384,12000,0,193000,0,-126,12000,0,-192000,0,6510,0,0,385000,0,1329.0,-3937.0,16000.0,3000.0,0.0,0.0,326460.0,210063.0,-12401.0,-689744.0
2024-12-05,6643,3164,6000,0,175000,0,-191,6000,0,77000,0,3355,0,0,98000,0,1126.0,-3058.0,22000.0,-1000.0,0.0,0.0,379460.0,658088.0,-12401.0,-399744.0
2024-12-06,6643,21072,6000,0,713000,0,-645,5000,0,-1000,0,21717,1000,0,714000,0,-865.0,-2232.0,30000.0,-5000.0,0.0,0.0,83980.0,681853.0,-1401.0,-368744.0
2024-12-09,6643,716,4000,0,172000,0,-199,4000,0,-58000,0,915,0,0,230000,0,-1182.0,-3420.0,34000.0,-1000.0,0.0,0.0,121000.0,720853.0,0.0,-273744.0
2024-12-10,6643,12015,1000,0,273800,0,-1431,-10000,0,-222200,0,13446,11000,0,496000,0,-2592.0,-4066.0,17000.0,-9000.0,0.0,0.0,-396200.0,382611.0,0.0,-260544.0
2024-12-11,6643,819,9000,0,135000,0,-270,9000,0,40000,0,1089,0,0,95000,0,-2736.0,-2957.0,14000.0,0.0,0.0,0.0,-164200.0,660656.0,0.0,-244864.0
2024-12-12,6643,1524,14000,0,301000,0,615,14000,0,154988,-24000,909,0,0,146012,24000,-1930.0,-1926.0,22000.0,14000.0,0.0,0.0,-86212.0,818244.0,-24000.0,-257113.0
2024-12-13,6643,3135,0,0,205000,0,515,0,0,670,0,2620,0,0,204330,0,-770.0,-1406.0,17000.0,32000.0,0.0,0.0,-84542.0,905904.0,-24000.0,-261113.0
2024-12-16,6643,50050,6000,0,912000,7000,-29272,-1000,0,-113230,7000,79322,7000,0,1025230,0,-29843.0,-30193.0,12000.0,40000.0,0.0,0.0,-139772.0,586754.0,-17000.0,-152401.0
2024-12-17,6643,32275,14000,0,690060,29000,535,11000,0,-493592,29000,31740,3000,0,1183652,0,-27877.0,-30042.0,33000.0,46000.0,0.0,0.0,-411164.0,-222238.0,12000.0,9799.0
2024-12-18,6643,13028,6000,0,283010,0,-1298,6000,0,-72990,0,14326,0,0,356000,0,-28905.0,-31589.0,30000.0,45000.0,0.0,0.0,-524154.0,-277253.0,12000.0,10799.0
2024-12-19,6643,19688,0,0,337000,0,44,-10000,0,55000,0,19644,10000,0,282000,0,-29476.0,-31654.0,6000.0,30000.0,0.0,0.0,-624142.0,-317881.0,36000.0,-5201.0
2024-12-20,6643,15020,14000,0,229030,17000,705,4000,0,-226833,17000,14315,10000,0,455863,0,-29286.0,-31277.0,10000.0,34000.0,0.0,0.0,-851645.0,-573706.0,53000.0,11599.0
2024-12-23,6643,6501,4000,0,95000,0,-445,3000,0,-85000,0,6946,1000,0,180000,0,-459.0,-31035.0,14000.0,38000.0,0.0,0.0,-823415.0,-728987.0,46000.0,11599.0
2024-12-24,6643,14000,5000,0,125050,0,1012,5000,0,13050,0,12988,0,0,112000,0,18.0,-28206.0,8000.0,47000.0,0.0,0.0,-316773.0,-597677.0,17000.0,11599.0
2024-12-25,6643,3731,0,0,185010,400,-321,-1000,0,72010,400,4052,1000,0,113000,0,995.0,-29317.0,1000.0,61000.0,0.0,0.0,-171773.0,-533667.0,17400.0,16999.0
2024-12-26,6643,10240,6000,0,85020,3000,12,-45000,0,-42980,-19000,10228,51000,0,128000,22000,963.0,-29317.0,-34000.0,16000.0,0.0,0.0,-269753.0,-600647.0,-1600.0,-2001.0
2024-12-27,6643,8133,4000,0,164003,2000,-320,2000,0,-106997,2000,8453,2000,0,271000,0,-62.0,-30983.0,-36000.0,21000.0,0.0,0.0,-149917.0,-1002124.0,-16600.0,10999.0
2024-12-30,6643,8362,0,0,34030,0,8,-2000,0,-29970,0,8354,2000,0,64000,0,391.0,-31093.0,-41000.0,19000.0,0.0,0.0,-94887.0,-937074.0,-16600.0,12400.0
2024-12-31,6643,1960,6000,0,115010,0,370,6000,0,-72331,0,1590,0,0,187341,0,-251.0,-30702.0,-40000.0,18000.0,0.0,0.0,-180268.0,-1304405.0,-16600.0,12400.0
2025-01-02,6643,24000,1000,0,27005,0,99,-3000,0,-162543,-17000,23901,4000,0,189548,17000,169.0,-30477.0,-42000.0,3000.0,0.0,0.0,-414821.0,-1274948.0,-34000.0,-4600.0
2025-01-03,6643,3625,0,0,79000,0,-256,0,0,63452,0,3881,0,0,15548,0,-99.0,-30542.0,3000.0,-3000.0,0.0,0.0,-308389.0,-1288496.0,-15000.0,-4600.0
2025-01-06,6643,31,4000,0,187000,0,-461,4000,0,123416,-5000,492,0,0,63584,5000,-240.0,-30358.0,5000.0,-4000.0,0.0,0.0,-77976.0,-1164080.0,-22000.0,-9600.0
2025-01-07,6643,3261,1000,0,284001,0,437,-3000,0,130453,-6000,2824,4000,0,153548,6000,189.0,-29722.0,4000.0,-11000.0,0.0,0.0,82447.0,-975627.0,-28000.0,-15600.0
2025-01-08,6643,41000,0,0,74015,0,-626,-10000,0,-332933,0,41626,10000,0,406948,0,-807.0,-28917.0,-12000.0,-11000.0,0.0,0.0,-178155.0,-1086360.0,-28000.0,-15600.0
2025-01-09,6643,35000,3000,0,119035,0,477,3000,0,-97057,-121202,34523,0,0,216092,121202,-429.0,-28170.0,-6000.0,-17000.0,0.0,0.0,-112669.0,-1223417.0,-132202.0,-136802.0
2025-01-10,6643,25000,2000,0,168010,4000,279,-28000,0,11970,4000,24721,30000,0,156040,0,106.0,-28506.0,-34000.0,-59000.0,0.0,0.0,-164151.0,-1366435.0,-128202.0,-108802.0
2025-01-13,6643,65294,13000,0,348145,6000,-648,-9000,0,10145,-14000,65942,22000,0,338000,20000,-81.0,-29669.0,-47000.0,-68000.0,0.0,0.0,-277422.0,-1356960.0,-137202.0,-122802.0
2025-01-14,6643,12278,0,0,274204,1300,-175,-31000,0,128204,-38700,12453,31000,0,146000,40000,-693.0,-572.0,-75000.0,-98000.0,0.0,0.0,-279671.0,-1115526.0,-169902.0,-168502.0
2025-01-15,6643,5562,0,0,188050,2000,534,0,0,56502,-9000,5028,0,0,131548,11000,467.0,-573.0,-65000.0,-109000.0,0.0,0.0,109764.0,-565432.0,-178902.0,-206502.0
2025-01-16,6643,1241,0,0,53011,0,-42,0,0,-26067,0,1283,0,0,79078,0,-52.0,683.0,-68000.0,-115000.0,0.0,0.0,180754.0,-518509.0,-57700.0,-206502.0
2025-01-17,6643,6116,0,0,126020,0,1318,-9000,0,38467,-23800,4798,9000,0,87553,23800,987.0,1957.0,-49000.0,-114000.0,0.0,0.0,207251.0,-535042.0,-85500.0,-230302.0
2025-01-20,6643,9687,18000,0,144120,0,3662,18000,0,37120,-5000,6025,0,0,107000,5000,5297.0,4914.0,-22000.0,-100000.0,0.0,0.0,234226.0,-271089.0,-76500.0,-252302.0
2025-01-21,6643,11234,7000,0,300006,0,3837,7000,0,134002,0,7397,0,0,166004,0,9309.0,9196.0,16000.0,-96000.0,0.0,0.0,240024.0,-52087.0,-37800.0,-252302.0
2025-01-22,6643,7391,5000,0,66184,0,749,5000,0,-135993,0,6642,0,0,202177,0,9524.0,8933.0,21000.0,-96000.0,0.0,0.0,47529.0,-201130.0,-28800.0,-252302.0
2025-02-03,6643,31030,0,0,180011,0,10901,0,0,-12022,0,20129,0,0,192033,0,20467.0,20155.0,21000.0,-95000.0,0.0,0.0,61574.0,-285162.0,-28800.0,-252702.0
2025-02-04,6643,10792,4000,0,185900,0,-1406,3000,0,81893,-60,12198,1000,0,104007,60,17743.0,18737.0,33000.0,-47000.0,0.0,0.0,105000.0,-160289.0,-5060.0,-233762.0
2025-02-05,6643,12546,1000,0,129000,0,1358,-2000,0,6183,0,11188,3000,0,122817,0,15439.0,20415.0,13000.0,-51000.0,0.0,0.0,74063.0,-47109.0,-60.0,-235762.0
2025-02-06,6643,17442,3000,0,146215,0,5143,3000,0,-29478,0,12299,0,0,175693,0,16745.0,25550.0,9000.0,-46000.0,0.0,0.0,-89417.0,-46617.0,-60.0,-235762.0
2025-02-07,6643,22373,1000,0,273000,0,7157,-15,0,41960,0,15216,1015,0,231040,0,23153.0,32337.0,3985.0,-52015.0,0.0,0.0,88536.0,67674.0,-60.0,-235762.0
2025-02-10,6643,4861,1000,0,177000,0,-12604,0,0,-32694,0,17465,1000,0,209694,0,-352.0,19634.0,3985.0,-49015.0,0.0,0.0,67864.0,197523.0,-60.0,-218762.0
2025-02-11,6643,3517,1000,0,38610,0,-6070,0,0,-58177,0,9587,1000,0,96787,0,-5016.0,13820.0,985.0,-49015.0,0.0,0.0,-72206.0,75894.0,0.0,-218762.0
2025-02-12,6643,1020,0,0,52167,0,-2261,-2000,0,10167,0,3281,2000,0,42000,0,-8635.0,12020.0,985.0,-55015.0,0.0,0.0,-68222.0,-37355.0,0.0,-213762.0
2025-02-13,6643,85094,12000,0,1082000,11100,21255,12000,0,603213,11100,63839,0,0,478787,0,7477.0,32838.0,9985.0,-40015.0,0.0,0.0,564469.0,435405.0,11100.0,-196662.0
2025-02-14,6643,26346,8000,0,864000,52000,-4939,4000,0,51277,52000,31285,4000,0,812723,0,-4619.0,28525.0,14000.0,-26015.0,0.0,0.0,573786.0,819615.0,63100.0,-144662.0
2025-02-17,6643,25879,3000,0,357031,35200,-1027,-6000,0,-226786,35200,26906,9000,0,583817,0,6958.0,27021.0,8000.0,-35015.0,0.0,0.0,379694.0,689886.0,98300.0,11740.0
2025-02-18,6643,26502,33000,0,438001,30000,8962,33000,0,105001,30000,17540,0,0,333000,0,21990.0,35704.0,41000.0,25985.0,0.0,0.0,542872.0,782917.0,128300.0,37740.0
2025-02-19,6643,62148,10000,0,935000,86000,9289,9000,0,372640,86000,52859,1000,0,562360,0,33540.0,45641.0,52000.0,43985.0,0.0,0.0,905345.0,1145412.0,214300.0,137740.0
2025-02-20,6643,15134,5000,0,334252,0,-13335,-3000,0,12252,0,28469,8000,0,322000,0,-1050.0,32481.0,37000.0,71985.0,0.0,0.0,314384.0,1029460.0,203200.0,176440.0
2025-02-21,6643,3813,0,0,238401,1000,-8759,-40000,0,85401,1000,12572,40000,0,153000,0,-4870.0,23188.0,-7000.0,31985.0,0.0,0.0,348508.0,1058359.0,152200.0,186440.0
2025-02-24,6643,24273,2000,0,190150,0,16603,2000,0,101934,0,7670,0,0,88216,0,12760.0,39833.0,1000.0,33985.0,0.0,0.0,677228.0,1186360.0,117000.0,186440.0
2025-02-25,6643,17000,0,0,73100,30000,-15042,-1000,0,-162000,30000,32042,1000,0,235100,0,-11244.0,23473.0,-33000.0,41985.0,0.0,0.0,410227.0,985893.0,117000.0,240240.0
2025-02-26,6643,22688,2000,0,197012,0,287,-5000,0,-44013,0,22401,7000,0,241025,0,-20246.0,20098.0,-47000.0,18985.0,0.0,0.0,-6426.0,904760.0,31000.0,245240.0
2025-02-27,6643,10969,7000,0,348372,0,1827,3000,0,155743,0,9142,4000,0,192629,0,-5084.0,18088.0,-41000.0,14985.0,0.0,0.0,137065.0,926501.0,31000.0,245240.0
2025-03-03,6643,2076,3000,0,101202,0,-4919,-2000,0,7802,0,6995,5000,0,93400,0,-1244.0,12420.0,-3000.0,7985.0,0.0,0.0,59466.0,1070296.0,30000.0,245240.0
2025-03-04,6643,19033,0,0,232041,0,1107,-1000,0,-240959,0,17926,1000,0,473000,0,-16740.0,2626.0,-6000.0,6985.0,0.0,0.0,-283427.0,841359.0,30000.0,245240.0
2025-03-05,6643,11868,0,0,229000,0,7292,0,0,-60150,-100,4576,0,0,289150,100,5594.0,11324.0,-5000.0,3985.0,0.0,0.0,-181577.0,699316.0,-100.0,245200.0
2025-03-06,6643,2150,8000,0,140000,0,-5197,8000,0,-6000,0,7347,0,0,146000,0,110.0,4769.0,8000.0,13985.0,0.0,0.0,-143564.0,687133.0,-100.0,245200.0
2025-03-07,6643,30106,7000,0,172070,0,8285,6000,0,-208930,-100,21821,1000,0,381000,100,6568.0,7911.0,11000.0,16985.0,0.0,0.0,-508237.0,507681.0,-200.0,245100.0
2025-03-10,6643,4502,0,0,202000,0,105,-11000,0,58000,0,4397,11000,0,144000,0,11592.0,859.0,2000.0,6000.0,0.0,0.0,-458039.0,523721.0,-200.0,245100.0
2025-03-11,6643,15042,0,0,225006,0,-3193,0,0,11006,0,18235,0,0,214000,0,7292.0,10270.0,3000.0,6000.0,0.0,0.0,-206074.0,567421.0,-200.0,245100.0
2025-03-12,6643,10037,0,0,117757,0,777,-3000,0,3757,0,9260,3000,0,114000,0,777.0,17117.0,0.0,3000.0,0.0,0.0,-142167.0,629355.0,-100.0,245100.0
2025-03-13,6643,18629,1000,0,362000,0,6907,1000,0,169000,0,11722,0,0,193000,0,12881.0,26285.0,-7000.0,6000.0,0.0,0.0,32833.0,788188.0,-100.0,245100.0
2025-03-14,6643,5300,1000,0,98120,35000,-71,0,0,-64880,35000,5371,1000,0,163000,0,4525.0,4959.0,-13000.0,-6000.0,0.0,0.0,176883.0,120095.0,35000.0,269000.0
2025-03-17,6643,12251,0,0,166010,23000,-4449,-2000,0,-337472,23000,16700,2000,0,503482,0,-29.0,5449.0,-4000.0,-12000.0,0.0,0.0,-218589.0,-268654.0,58000.0,240000.0
2025-03-18,6643,11044,1000,0,318000,0,5413,0,0,266000,0,5631,1000,0,52000,0,8577.0,11889.0,-4000.0,-6000.0,0.0,0.0,36405.0,224132.0,58000.0,204800.0
2025-03-19,6643,9870,0,0,106000,0,2416,-1000,0,45000,0,7454,1000,0,61000,0,10216.0,5343.0,-2000.0,-40000.0,0.0,0.0,77648.0,164131.0,58000.0,174800.0
2025-03-20,6643,17228,1000,0,109000,0,-2246,-7000,0,-250000,-97000,19474,8000,0,359000,97000,1063.0,-6192.0,-10000.0,-56000.0,0.0,0.0,-341352.0,-458509.0,-39000.0,-8200.0
2025-03-21,6643,17017,0,0,147115,0,-8017,0,0,32115,-73803,25034,0,0,115000,73803,-6883.0,-874.0,-10000.0,-53000.0,0.0,0.0,-244357.0,-438646.0,-147803.0,-82003.0
2025-03-24,6643,10672,0,0,132056,0,906,0,0,81056,0,9766,0,0,51000,0,-1528.0,8791.0,-8000.0,-13000.0,0.0,0.0,174171.0,-442991.0,-170803.0,-83003.0
2025-03-25,6643,1102,0,0,129000,0,-2631,0,0,82000,-60004,3733,0,0,47000,60004,-9572.0,-10443.0,-8000.0,-15000.0,0.0,0.0,-9829.0,-462925.0,-230807.0,-143007.0
2025-03-26,6643,2275,0,0,50100,0,-725,-6000,0,17100,0,3000,6000,0,33000,0,-12713.0,3874.0,-13000.0,-20000.0,0.0,0.0,-37729.0,-283825.0,-230807.0,-173007.0
2025-03-27,6643,3152,0,0,57000,0,-793,0,0,18000,0,3945,0,0,39000,0,-11260.0,2794.0,-6000.0,-15000.0,0.0,0.0,230271.0,-221812.0,-133807.0,-173007.0
2025-03-28,6643,24602,0,0,80006,0,-377,-2000,0,-113994,0,24979,2000,0,194000,0,-3620.0,590.0,-8000.0,-20000.0,0.0,0.0,84162.0,-491549.0,-60004.0,-173007.0
2025-03-31,6643,38000,0,0,219025,0,-2110,0,0,-20103,0,40110,0,0,239128,0,-6636.0,3399.0,-8000.0,-18000.0,0.0,0.0,-16997.0,-519454.0,-60004.0,-173007.0
2025-04-01,6643,17085,0,0,391100,0,7714,-2000,0,157100,-3961,9371,2000,0,234000,3961,3709.0,10006.0,-10000.0,-19000.0,0.0,0.0,58103.0,-121395.0,-3961.0,-176968.0
2025-04-02,6643,8058,0,0,196007,0,-2043,-20000,0,66982,-12000,10101,20000,0,129025,12000,2391.0,671.0,-24000.0,-39000.0,0.0,0.0,107985.0,5737.0,-15961.0,-188868.0
2025-04-07,6643,0,0,0,4000,0,0,0,0,4000,0,0,0,0,0,0,3184.0,5868.0,-24000.0,-47000.0,0.0,0.0,93985.0,15737.0,-15961.0,-188868.0
2025-04-08,6643,0,0,0,9008,0,-1001,0,0,6991,0,1001,0,0,2017,0,2560.0,-3418.0,-22000.0,-53000.0,0.0,0.0,214970.0,231658.0,-15961.0,-188768.0
2025-04-09,6643,0,0,0,40000,0,-5201,0,0,39000,0,5201,0,0,1000,0,-531.0,-8724.0,-22000.0,-42000.0,0.0,0.0,274073.0,212658.0,-15961.0,-188768.0
2025-04-10,6643,0,0,0,270000,0,-434,0,0,-73000,0,434,0,0,343000,0,-8679.0,-5965.0,-20000.0,-42000.0,0.0,0.0,43973.0,128652.0,-12000.0,-188768.0
2025-04-11,6643,30405,1000,0,769001,0,1403,1000,0,386999,0,29002,0,0,382002,0,-5233.0,-5339.0,1000.0,-38000.0,0.0,0.0,363990.0,511894.0,0.0,-188768.0
2025-04-14,6643,23959,0,0,797210,0,79,0,0,313210,0,23880,0,0,484000,0,-5154.0,-12167.0,1000.0,-39000.0,0.0,0.0,673200.0,656104.0,0.0,-188768.0
2025-04-15,6643,19471,1000,0,371050,0,6194,1000,0,71050,0,13277,0,0,300000,0,2041.0,-5902.0,2000.0,-38000.0,0.0,0.0,737259.0,792034.0,0.0,-223768.0
2025-04-16,6643,4321,0,0,161610,0,-1045,0,0,23610,0,5366,0,0,138000,0,6197.0,-2498.0,2000.0,-36000.0,0.0,0.0,721869.0,1153116.0,0.0,-246768.0
2025-04-17,6643,15577,0,0,287000,0,9633,0,0,125000,-101,5944,0,0,162000,101,16264.0,1722.0,2000.0,-36000.0,0.0,0.0,919869.0,1012116.0,-101.0,-246869.0
2025-04-18,6643,7295,0,0,91000,1314,-4457,0,0,-74000,1314,11752,0,0,165000,0,10404.0,-5151.0,1000.0,-35000.0,0.0,0.0,458870.0,893116.0,1213.0,-245555.0
2025-04-21,6643,13576,0,0,381004,0,-7791,0,0,15004,0,21367,0,0,366000,0,2534.0,-10696.0,1000.0,-28000.0,0.0,0.0,160664.0,1158120.0,1213.0,-148555.0
2025-04-22,6643,4033,0,0,533000,0,-1450,0,0,323000,-129000,5483,0,0,210000,129000,-5110.0,-4129.0,0.0,-28000.0,0.0,0.0,412614.0,1449005.0,-127787.0,-203752.0
2025-04-23,6643,3868,0,0,265000,0,3322,0,0,-139881,-11000,546,0,0,404881,11000,-743.0,-1713.0,0.0,-28000.0,0.0,0.0,249123.0,1228068.0,-138787.0,-214752.0
2025-04-24,6643,2000,6000,0,261000,0,-558,6000,0,133000,-120000,2558,0,0,128000,120000,-10934.0,360.0,6000.0,-22000.0,0.0,0.0,257123.0,1279068.0,-258686.0,-274748.0
2025-04-25,6643,11327,0,0,480150,0,4508,0,0,214150,-74000,6819,0,0,266000,74000,-1969.0,5593.0,6000.0,-16000.0,0.0,0.0,545273.0,1476118.0,-334000.0,-348748.0
2025-04-28,6643,6726,0,0,241000,0,654,0,0,-1200,-9000,6072,0,0,242200,9000,6476.0,7040.0,6000.0,-16000.0,0.0,0.0,529069.0,1456918.0,-343000.0,-357748.0
2025-04-29,6643,7282,0,0,242000,0,5345,-1000,0,56000,-25000,1937,1000,0,186000,25000,13271.0,12762.0,5000.0,-15000.0,0.0,0.0,262069.0,1626912.0,-239000.0,-382748.0
2025-04-30,6643,1885,0,0,147400,0,-5519,0,0,28400,-15000,7404,0,0,119000,15000,4430.0,9353.0,5000.0,-15000.0,0.0,0.0,430350.0,1675415.0,-243000.0,-397748.0
2025-05-02,6643,12115,0,0,265484,0,4014,0,0,133484,0,8101,0,0,132000,0,9002.0,5653.0,-1000.0,-13000.0,0.0,0.0,430834.0,1651799.0,-123000.0,-393787.0
2025-05-05,6643,9475,0,0,213000,0,-11280,0,0,-59040,0,20755,0,0,272040,0,-6786.0,-3584.0,-1000.0,7000.0,0.0,0.0,157644.0,1525777.0,-49000.0,-381787.0
2025-05-06,6643,4651,0,0,247242,0,1842,0,0,103242,0,2809,0,0,144000,0,-5598.0,-1742.0,-1000.0,7000.0,0.0,0.0,262086.0,1625019.0,-40000.0,-381787.0
2025-05-07,6643,40523,0,0,295130,0,355,0,0,-514870,0,40168,0,0,810000,0,-10588.0,-386.0,0.0,7000.0,0.0,0.0,-308784.0,1103158.0,-15000.0,-381787.0
2025-05-08,6643,7271,0,0,456124,0,2126,0,0,234124,0,5145,0,0,222000,0,-2943.0,6941.0,0.0,7000.0,0.0,0.0,-103060.0,1298282.0,0.0,-381787.0
2025-05-09,6643,7051,0,0,726030,0,1686,0,0,68030,0,5365,0,0,658000,0,-5271.0,9061.0,0.0,7000.0,0.0,0.0,-168514.0,1439312.0,0.0,-381787.0
2025-05-12,6643,13783,0,0,333000,9000,10415,0,0,213880,9000,3368,0,0,119120,0,16424.0,18073.0,0.0,6000.0,0.0,0.0,104406.0,1266193.0,9000.0,-372787.0
2025-05-13,6643,5850,0,0,188000,6000,-3823,0,0,21000,6000,9673,0,0,167000,0,10759.0,14171.0,0.0,6000.0,0.0,0.0,22164.0,973983.0,15000.0,-366787.0
2025-05-14,6643,16831,4000,0,262010,0,14335,4000,0,-114990,0,2496,0,0,377000,0,24739.0,22312.0,4000.0,9000.0,0.0,0.0,422044.0,787943.0,15000.0,-366787.0
2025-05-15,6643,11776,0,0,106010,0,-4505,-5000,0,-123990,0,16281,5000,0,230000,0,18108.0,18852.0,-1000.0,4000.0,0.0,0.0,63930.0,640343.0,15000.0,-366787.0
2025-05-16,6643,10039,0,0,138030,0,3815,0,0,-1970,0,6224,0,0,140000,0,20237.0,13034.0,-1000.0,4000.0,0.0,0.0,-6070.0,513373.0,15000.0,-366686.0
2025-05-19,6643,10000,0,0,54000,0,-5462,0,0,-147240,-1000,15462,0,0,201240,1000,4360.0,12029.0,-1000.0,4000.0,0.0,0.0,-367190.0,440133.0,5000.0,-369000.0
2025-05-20,6643,12450,0,0,152050,0,2690,0,0,-21950,-1000,9760,0,0,174000,1000,10873.0,22510.0,-1000.0,4000.0,0.0,0.0,-410140.0,403179.0,-2000.0,-370000.0
2025-05-21,6643,6090,0,0,62000,0,-941,0,0,-91000,0,7031,0,0,153000,0,-4403.0,23019.0,-5000.0,4000.0,0.0,0.0,-386150.0,-10821.0,-2000.0,-241000.0
2025-05-22,6643,4075,0,0,64000,0,-3129,0,0,-21060,-1600,7204,0,0,85060,1600,-3027.0,16568.0,0.0,4000.0,0.0,0.0,-283220.0,108000.0,-3600.0,-231600.0
2025-05-23,6643,6000,0,0,52000,0,-893,0,0,-30000,0,6893,0,0,82000,0,-7735.0,16233.0,0.0,-2000.0,0.0,0.0,-311250.0,-55000.0,-3600.0,-111600.0
2025-05-26,6643,4603,0,0,47071,0,-2516,0,0,-56929,0,7119,0,0,104000,0,-4789.0,9209.0,0.0,-2000.0,0.0,0.0,-220939.0,-326079.0,-2600.0,-37600.0
2025-05-27,6643,8000,0,0,56010,0,1038,0,0,-24990,0,6962,0,0,81000,0,-6441.0,9593.0,0.0,-2000.0,0.0,0.0,-223979.0,-349869.0,-1600.0,-28600.0
2025-05-28,6643,1085,0,0,89626,0,-911,0,0,39626,0,1996,0,0,50000,0,-6411.0,3337.0,0.0,-1000.0,0.0,0.0,-93353.0,-366243.0,-1600.0,-3600.0
2025-05-29,6643,1000,0,0,31066,0,-17,0,0,-43276,0,1017,0,0,74342,0,-3299.0,8839.0,0.0,-1000.0,0.0,0.0,-115569.0,-437919.0,0.0,11400.0
2025-06-02,6643,20000,2000,0,148007,0,-2517,2000,0,-52010,0,22517,0,0,200017,0,-4923.0,2308.0,2000.0,1000.0,0.0,0.0,-137579.0,-623413.0,0.0,11400.0
2025-06-03,6643,4246,1000,0,118010,0,1687,0,0,45010,-54000,2559,1000,0,73000,54000,-720.0,15275.0,2000.0,1000.0,0.0,0.0,-35640.0,-519363.0,-54000.0,-42600.0
2025-06-04,6643,7247,0,0,107100,0,-209,-1000,0,40050,-54600,7456,1000,0,67050,54600,-1967.0,13224.0,1000.0,0.0,0.0,0.0,29400.0,-582555.0,-108600.0,-97200.0
2025-06-05,6643,1283,0,0,70000,0,1222,0,0,25775,0,61,0,0,44225,0,166.0,14091.0,1000.0,0.0,0.0,0.0,15549.0,-41910.0,-108600.0,-97200.0
2025-06-06,6643,14006,2000,0,81832,0,5804,1000,0,-61618,0,8202,1000,0,143450,0,5987.0,17769.0,2000.0,1000.0,0.0,0.0,-2793.0,-337652.0,-108600.0,-97200.0
2025-06-09,6643,1673,0,0,69064,0,480,-2000,0,-12936,0,1193,2000,0,82000,0,8984.0,16563.0,-2000.0,-1000.0,0.0,0.0,36281.0,-418618.0,-108600.0,-97200.0
2025-06-10,6643,15058,0,0,66000,0,-772,0,0,-204640,-1000,15830,0,0,270640,1000,6525.0,5376.0,-2000.0,-1000.0,0.0,0.0,-213369.0,-837138.0,-55600.0,-107200.0
2025-06-11,6643,21411,0,0,477000,0,12767,0,0,305256,0,8644,0,0,171744,0,19501.0,21966.0,-1000.0,-1000.0,0.0,0.0,51837.0,-552882.0,-1000.0,-113200.0
2025-06-12,6643,8000,0,0,44010,0,-447,0,0,-158990,0,8447,0,0,203000,0,17832.0,7184.0,-1000.0,-5000.0,0.0,0.0,-132928.0,-596882.0,-1000.0,-113200.0
2025-06-13,6643,17000,0,0,132000,0,-3821,-1000,0,-157000,0,20821,1000,0,289000,0,8207.0,7868.0,-3000.0,-1000.0,0.0,0.0,-228310.0,-629892.0,-1000.0,-113200.0
2025-06-16,6643,5391,0,0,49000,0,-1941,0,0,-62000,0,7332,0,0,111000,0,5786.0,2112.0,-1000.0,-1000.0,0.0,0.0,-277374.0,-689922.0,-1000.0,-113200.0
2025-06-17,6643,9888,0,0,191020,0,3591,0,0,50020,0,6297,0,0,141000,0,10149.0,11165.0,-1000.0,-1000.0,0.0,0.0,-22714.0,-492662.0,0.0,-112200.0
2025-06-18,6643,0,0,0,18000,0,-1186,0,0,-63000,0,1186,0,0,81000,0,-3804.0,7289.0,-1000.0,-1000.0,0.0,0.0,-390970.0,-533712.0,0.0,-111200.0
2025-06-19,6643,3188,0,0,94008,0,-3863,-6000,0,-84992,0,7051,6000,0,179000,0,-7220.0,4367.0,-7000.0,-7000.0,0.0,0.0,-316972.0,-527704.0,0.0,-111200.0
2025-06-20,6643,6095,0,0,166010,0,-5098,0,0,-28990,0,11193,0,0,195000,0,-8497.0,2398.0,-6000.0,-7000.0,0.0,0.0,-188962.0,-535634.0,0.0,-109600.0
2025-06-23,6643,27795,0,0,122000,0,23187,0,0,4000,0,4608,0,0,118000,0,16631.0,26478.0,-6000.0,-7000.0,0.0,0.0,-122962.0,-501634.0,0.0,-109600.0
2025-06-24,6643,35808,0,0,620093,0,18482,0,0,446073,0,17326,0,0,174020,0,31522.0,47476.0,-6000.0,-7000.0,0.0,0.0,273091.0,1368.0,0.0,-109600.0
2025-06-25,6643,9930,0,0,203000,0,-207,0,0,-5000,0,10137,0,0,208000,0,32501.0,46231.0,-6000.0,-7000.0,0.0,0.0,331091.0,21358.0,0.0,-109600.0
2025-06-26,6643,459,0,0,36057,0,-4697,0,0,-87543,0,5156,0,0,123600,0,31667.0,42445.0,0.0,-7000.0,0.0,0.0,328540.0,-105811.0,0.0,-109600.0
2025-06-27,6643,26873,9000,0,260003,0,18846,9000,0,-65007,0,8027,0,0,325010,0,55611.0,61308.0,9000.0,2000.0,0.0,0.0,292523.0,-127542.0,0.0,-109600.0
2025-06-30,6643,9809,0,0,76789,0,-4322,0,0,-215241,0,14131,0,0,292030,0,28102.0,59503.0,9000.0,0.0,0.0,0.0,73282.0,-290773.0,0.0,-109600.0
2025-07-01,6643,4000,0,0,103000,0,-5684,-3000,0,42011,0,9684,3000,0,60989,0,3936.0,52132.0,6000.0,-3000.0,0.0,0.0,-330780.0,-293772.0,0.0,-55600.0
2025-07-02,6643,46031,3000,0,671068,0,34123,3000,0,339968,0,11908,0,0,331100,0,38266.0,86464.0,9000.0,1000.0,0.0,0.0,14188.0,6146.0,0.0,-1000.0
2025-07-03,6643,40140,0,0,95000,0,2689,0,0,-702000,0,37451,0,0,797000,0,45652.0,87931.0,9000.0,1000.0,0.0,0.0,-600269.0,-721629.0,0.0,-1000.0
2025-07-04,6643,26000,0,0,91494,0,-33471,-9000,0,-285506,0,59471,9000,0,377000,0,-6665.0,48656.0,-9000.0,-9000.0,0.0,0.0,-820768.0,-945517.0,0.0,-1000.0
2025-07-07,6643,14236,0,0,83943,0,-1488,0,0,-77861,0,15724,0,0,161804,0,-3831.0,46688.0,-9000.0,-7000.0,0.0,0.0,-683388.0,-1010442.0,0.0,-1000.0
2025-07-08,6643,22347,0,0,145409,0,-1013,0,0,-105597,0,23360,0,0,251006,0,840.0,46447.0,-6000.0,-7000.0,0.0,0.0,-830996.0,-911399.0,0.0,0.0
2025-07-09,6643,13128,0,0,53981,0,1550,0,0,-173020,0,11578,0,0,227001,0,-31733.0,35230.0,-9000.0,-7000.0,0.0,0.0,-1343984.0,-1389675.0,0.0,0.0
2025-07-10,6643,46455,0,0,795587,0,28748,0,0,590587,0,17707,0,0,205000,0,-5674.0,64425.0,-9000.0,-7000.0,0.0,0.0,-51397.0,-640098.0,0.0,0.0
2025-07-11,6643,8020,4000,0,644057,0,-8417,4000,0,165216,0,16437,0,0,478841,0,19380.0,59829.0,4000.0,-2000.0,0.0,0.0,399325.0,-317882.0,0.0,0.0
2025-07-14,6643,13000,6000,0,71016,0,-11800,-4000,0,-435984,0,24800,10000,0,507000,0,9068.0,49970.0,0.0,-6000.0,0.0,0.0,41202.0,-691866.0,0.0,0.0
2025-07-15,6643,9126,0,0,26020,0,1874,0,0,-158980,0,7252,0,0,185000,0,11955.0,48253.0,0.0,-6000.0,0.0,0.0,-12181.0,-900866.0,0.0,0.0
2025-07-16,6643,15781,0,0,177397,0,5730,0,0,10284,0,10051,0,0,167113,0,16135.0,55169.0,0.0,-6000.0,0.0,0.0,171123.0,-827582.0,0.0,0.0
2025-07-17,6643,27710,4000,0,163007,0,21838,4000,0,52483,-50,5872,0,0,110524,50,9225.0,80870.0,4000.0,4000.0,0.0,0.0,-366981.0,-690107.0,-50.0,-50.0
2025-07-18,6643,8182,0,0,152050,0,-12711,-4000,0,37050,0,20893,4000,0,115000,0,4931.0,73257.0,-4000.0,0.0,0.0,0.0,-495147.0,-624067.0,-50.0,-50.0
2025-07-21,6643,13265,0,0,69000,0,2972,0,0,-11004,0,10293,0,0,80004,0,19703.0,53042.0,0.0,0.0,0.0,0.0,-70167.0,-639071.0,-50.0,-50.0
2025-07-22,6643,41870,6000,0,424000,0,5808,4000,0,-459000,0,36062,2000,0,883000,0,23637.0,40368.0,4000.0,4000.0,0.0,0.0,-370187.0,-1544144.0,-50.0,-50.0
2025-07-23,6643,10187,0,0,146008,0,4238,-1000,0,-117992,0,5949,1000,0,264000,0,22145.0,44813.0,3000.0,3000.0,0.0,0.0,-498463.0,-1657136.0,-50.0,-50.0
2025-07-24,6643,8114,0,0,149000,0,2464,-3000,0,25000,0,5650,3000,0,124000,0,2771.0,51974.0,-4000.0,0.0,0.0,0.0,-525946.0,-1544593.0,0.0,-50.0
2025-07-25,6643,6223,0,0,120000,0,1783,0,0,-57100,0,4440,0,0,177100,0,17265.0,34911.0,0.0,-9000.0,0.0,0.0,-620096.0,-1536686.0,0.0,-50.0
2025-07-28,6643,3879,0,0,139000,0,-1015,0,0,53000,0,4894,0,0,86000,0,13278.0,38218.0,0.0,-9000.0,0.0,0.0,-556092.0,-1268445.0,0.0,-50.0
2025-07-29,6643,24146,0,0,42030,0,-3746,0,0,-191970,0,27892,0,0,234000,0,3724.0,40156.0,-4000.0,-6000.0,0.0,0.0,-289062.0,-1502426.0,0.0,-50.0
2025-07-30,6643,28050,0,0,104215,0,-6201,0,0,-59785,0,34251,0,0,164000,0,-6715.0,-168.0,-3000.0,-9000.0,0.0,0.0,-230855.0,-1902179.0,0.0,-50.0
2025-07-31,6643,9237,0,0,74000,0,-388,0,0,-133000,0,9625,0,0,207000,0,-9567.0,-3245.0,0.0,-9000.0,0.0,0.0,-388855.0,-1333179.0,0.0,-50.0
2025-08-01,6643,18316,0,0,202010,0,13710,0,0,96010,0,4606,0,0,106000,0,2360.0,43936.0,0.0,0.0,0.0,0.0,-235745.0,-951663.0,0.0,-50.0
2025-08-04,6643,15281,0,0,53120,0,-8769,0,0,-126880,0,24050,0,0,180000,0,-5394.0,36655.0,0.0,0.0,0.0,0.0,-415625.0,-1000682.0,0.0,-50.0
2025-08-05,6643,7608,0,0,282020,0,3522,0,0,246669,0,4086,0,0,35351,0,1874.0,41190.0,0.0,0.0,0.0,0.0,23014.0,-648416.0,0.0,-50.0
2025-08-06,6643,33552,0,0,72024,0,91,0,0,-279216,0,33461,0,0,351240,0,8166.0,39731.0,0.0,0.0,0.0,0.0,-196417.0,-754612.0,0.0,-50.0
2025-08-07,6643,36894,0,0,902000,0,20976,0,0,699000,0,15918,0,0,203000,0,29530.0,31959.0,0.0,0.0,0.0,0.0,635583.0,-646199.0,0.0,-50.0
2025-08-08,6643,10000,10000,0,64071,0,-5147,8000,0,-188929,0,15147,2000,0,253000,0,10673.0,35229.0,8000.0,4000.0,0.0,0.0,350644.0,-1000344.0,0.0,-50.0
2025-08-11,6643,21000,0,0,43020,0,-3913,-2000,0,-163980,0,24913,2000,0,207000,0,15529.0,43116.0,6000.0,6000.0,0.0,0.0,313544.0,-728340.0,0.0,-50.0
2025-08-12,6643,2917,0,0,177000,0,1939,0,0,128000,0,978,0,0,49000,0,13946.0,43181.0,6000.0,6000.0,0.0,0.0,194875.0,-441360.0,0.0,-50.0
2025-08-13,6643,17442,0,0,522050,0,12769,0,0,349900,0,4673,0,0,172150,0,26624.0,50220.0,6000.0,6000.0,0.0,0.0,823991.0,-101744.0,0.0,-50.0
2025-08-14,6643,3169,2000,0,145015,0,-301,2000,0,51015,-100,3470,0,0,94000,100,5347.0,28081.0,8000.0,4000.0,0.0,0.0,176006.0,-103212.0,-100.0,-100.0
2025-08-15,6643,5067,0,0,44200,0,-5001,-2000,0,-197800,0,10068,2000,0,242000,0,5493.0,35791.0,-2000.0,6000.0,0.0,0.0,167135.0,-338062.0,-100.0,-100.0
2025-08-18,6643,9401,0,0,47302,2000,-5451,0,0,-138698,2000,14852,0,0,186000,0,3955.0,27368.0,0.0,6000.0,0.0,0.0,192417.0,-465756.0,1900.0,1900.0
2025-08-19,6643,21085,0,0,50020,1000,-3122,-4000,0,-257980,1000,24207,4000,0,308000,0,-1106.0,18438.0,-4000.0,-2000.0,0.0,0.0,-193563.0,-264736.0,2900.0,2900.0
2025-08-20,6643,23859,0,0,100070,3000,-7739,0,0,-311280,3000,31598,0,0,411350,0,-21614.0,6461.0,-4000.0,-1000.0,0.0,0.0,-854743.0,-458024.0,5900.0,5900.0
2025-08-21,6643,23066,0,0,12006,0,-6665,0,0,-165994,0,29731,0,0,178000,0,-27978.0,-2668.0,-6000.0,2000.0,0.0,0.0,-1071752.0,-649018.0,6000.0,5900.0
2025-08-22,6643,18142,0,0,58020,0,-13411,0,0,-84480,0,31553,0,0,142500,0,-36388.0,-17862.0,-4000.0,2000.0,0.0,0.0,-958432.0,-676398.0,6000.0,5900.0
2025-08-25,6643,13055,0,0,400020,0,12905,0,0,316020,0,150,0,0,84000,0,-18032.0,-3942.0,-4000.0,2000.0,0.0,0.0,-503714.0,-413378.0,4000.0,5900.0
2025-08-26,6643,73927,20000,0,770770,0,56991,20000,0,591208,0,16936,0,0,179562,0,42081.0,56795.0,20000.0,22000.0,0.0,0.0,345474.0,369800.0,3000.0,5900.0
2025-08-27,6643,17740,8000,0,420000,0,-5579,-1000,0,314000,0,23319,9000,0,106000,0,44241.0,57417.0,19000.0,21000.0,0.0,0.0,970754.0,743585.0,0.0,5900.0
2025-08-28,6643,4045,6000,0,158000,0,-7199,-2000,0,67000,-1000,11244,8000,0,91000,1000,43707.0,50606.0,17000.0,19000.0,0.0,0.0,1203748.0,943585.0,-1000.0,4900.0
2025-08-29,6643,1499,2000,0,61603,0,-3527,-7000,0,20094,0,5026,9000,0,41509,0,53591.0,33369.0,10000.0,12000.0,0.0,0.0,1308322.0,867669.0,-1000.0,4900.0
2025-09-01,6643,1366,0,0,129000,0,-2695,-3000,0,7920,0,4061,3000,0,121080,0,37991.0,39443.0,7000.0,9000.0,0.0,0.0,1000222.0,1002469.0,-1000.0,4900.0
2025-09-02,6643,23576,4000,0,438000,0,13201,2000,0,36850,0,10375,2000,0,401150,0,-5799.0,49122.0,-11000.0,11000.0,0.0,0.0,445864.0,792650.0,-1000.0,4900.0
2025-09-03,6643,10080,4000,0,200000,0,4877,3000,0,97000,0,5203,1000,0,103000,0,4657.0,53908.0,-7000.0,14000.0,0.0,0.0,228864.0,1168866.0,-1000.0,4900.0
2025-09-04,6643,2120,0,0,173000,0,-10987,-3000,0,50000,0,13107,3000,0,123000,0,869.0,21945.0,-8000.0,11000.0,0.0,0.0,211864.0,519866.0,0.0,4900.0
2025-09-05,6643,11308,0,0,220100,0,-456,-3000,0,-60900,0,11764,3000,0,281000,0,3940.0,26636.0,-4000.0,0.0,0.0,0.0,130870.0,647895.0,0.0,4900.0
2025-09-08,6643,3050,0,0,148000,0,1445,-4000,0,78000,-1000,1605,4000,0,70000,1000,8080.0,31994.0,-5000.0,-2000.0,0.0,0.0,200950.0,889875.0,-1000.0,3900.0
2025-09-09,6643,721,0,0,109000,0,265,0,0,4994,-100,456,0,0,104006,100,-4856.0,30320.0,-7000.0,-2000.0,0.0,0.0,169094.0,766869.0,-1100.0,3800.0
2025-09-10,6643,14306,0,0,21000,0,-5545,0,0,-264000,0,19851,0,0,285000,0,-15278.0,12006.0,-10000.0,-2000.0,0.0,0.0,-191906.0,152969.0,-1100.0,3800.0
2025-09-11,6643,30000,0,0,44030,0,-8533,0,0,-163970,0,38533,0,0,208000,0,-12824.0,3774.0,-7000.0,-4000.0,0.0,0.0,-405876.0,-62016.0,-1100.0,3900.0
2025-09-12,6643,17595,0,0,150000,0,4754,0,0,-23000,0,12841,0,0,173000,0,-7614.0,13529.0,-4000.0,-2000.0,0.0,0.0,-367976.0,112784.0,-1100.0,3900.0
2025-09-15,6643,18000,0,0,39000,0,-6093,-4000,0,-199000,0,24093,4000,0,238000,0,-15152.0,12887.0,-4000.0,-6000.0,0.0,0.0,-644976.0,52482.0,-100.0,1900.0
2025-09-16,6643,8000,1000,0,36020,0,1150,1000,0,-39980,0,6850,0,0,76000,0,-14267.0,17159.0,-3000.0,-1000.0,0.0,0.0,-689950.0,270482.0,0.0,900.0
2025-09-17,6643,29000,0,0,74242,0,-809,0,0,-219758,0,29809,0,0,294000,0,-9531.0,24089.0,-3000.0,-1000.0,0.0,0.0,-645708.0,362004.0,0.0,-2100.0
2025-09-18,6643,11707,0,0,264032,0,7529,0,0,213832,0,4178,0,0,50200,0,6531.0,38283.0,-3000.0,-1000.0,0.0,0.0,-267906.0,741830.0,0.0,-2100.0
2025-09-19,6643,39700,2000,0,415600,0,11470,0,0,-221400,-1153,28230,2000,0,637000,1153,13247.0,63164.0,-3000.0,-1000.0,0.0,0.0,-466306.0,604910.0,-1153.0,-3253.0
2024-09-23,8358,11000,7000,0,233000,0,10408,-22000,0,125000,0,592,29000,0,108000,0,10408.0,10408.0,-22000.0,-22000.0,0.0,0.0,125000.0,125000.0,0.0,0.0
2024-09-24,8358,3000,64001,0,92000,0,-3901,-20999,0,-112117,0,6901,85000,0,204117,0,6507.0,6507.0,-42999.0,-42999.0,0.0,0.0,12883.0,12883.0,0.0,0.0
2024-09-25,8358,6000,3000,0,346000,0,5325,-22000,0,10000,0,675,25000,0,336000,0,11832.0,11832.0,-64999.0,-64999.0,0.0,0.0,22883.0,22883.0,0.0,0.0
2024-09-26,8358,2000,2000,0,185000,0,1304,-2000,0,3990,0,696,4000,0,181010,0,13136.0,13136.0,-66999.0,-66999.0,0.0,0.0,26873.0,26873.0,0.0,0.0
2024-09-27,8358,10000,94000,0,375005,0,8567,-4000,0,111005,0,1433,98000,0,264000,0,21703.0,21703.0,-70999.0,-70999.0,0.0,0.0,137878.0,137878.0,0.0,0.0
2024-09-30,8358,4000,9000,0,204000,0,-4193,-4001,0,-24002,0,8193,13001,0,228002,0,7102.0,17510.0,-53000.0,-75000.0,0.0,0.0,-11124.0,113876.0,0.0,0.0
2024-10-01,8358,7000,61000,0,389000,0,-11122,38000,0,28995,-100000,18122,23000,0,360005,100000,-119.0,6388.0,5999.0,-37000.0,0.0,0.0,129988.0,142871.0,-100000.0,-100000.0
2024-10-04,8358,6000,10000,0,239005,0,-3656,10000,0,-66015,-100000,9656,0,0,305020,100000,-9100.0,2732.0,37999.0,-27000.0,0.0,0.0,53973.0,76856.0,-200000.0,-200000.0
2024-10-07,8358,2000,0,0,272000,0,-1449,-2000,0,227999,-123000,3449,2000,0,44001,123000,-11853.0,1283.0,37999.0,-29000.0,0.0,0.0,277982.0,304855.0,-323000.0,-323000.0
2024-10-08,8358,2000,9000,0,104000,0,-2140,7000,0,-223006,0,4140,2000,0,327006,0,-22560.0,-857.0,48999.0,-22000.0,0.0,0.0,-56029.0,81849.0,-323000.0,-323000.0
2024-10-09,8358,11000,35000,0,106000,0,87,33000,0,-419006,0,10913,2000,0,525006,0,-18280.0,-770.0,86000.0,11000.0,0.0,0.0,-451033.0,-337157.0,-323000.0,-323000.0
2024-10-11,8358,12000,71000,0,289000,0,-16042,60000,0,-735000,0,28042,11000,0,1024000,0,-23200.0,-16812.0,108000.0,71000.0,0.0,0.0,-1215028.0,-1072157.0,-223000.0,-323000.0
2024-10-14,8358,2000,4000,0,524000,0,-167,-2000,0,326611,0,2167,6000,0,197389,0,-19711.0,-16979.0,96000.0,69000.0,0.0,0.0,-822402.0,-745546.0,-123000.0,-323000.0
2024-10-15,8358,4000,4000,0,127000,0,-3642,4000,0,-26016,0,7642,0,0,153016,0,-21904.0,-20621.0,102000.0,73000.0,0.0,0.0,-1076417.0,-771562.0,0.0,-323000.0
2024-10-16,8358,2000,4000,0,79000,0,-13815,-62000,0,-20007,0,15815,66000,0,99007,0,-33579.0,-34436.0,33000.0,11000.0,0.0,0.0,-873418.0,-791569.0,0.0,-323000.0
2024-10-17,8358,1000,44000,0,168000,0,-3320,44000,0,98980,0,4320,0,0,69020,0,-36986.0,-37756.0,44000.0,55000.0,0.0,0.0,-355432.0,-692589.0,0.0,-323000.0
2024-10-18,8358,11000,4000,0,48000,0,4780,0,0,-380011,0,6220,4000,0,428011,0,-16164.0,-32976.0,-16000.0,55000.0,0.0,0.0,-443.0,-1072600.0,0.0,-323000.0
2024-10-21,8358,2000,14000,0,320000,0,1901,-1000,0,235999,0,99,15000,0,84001,0,-14096.0,-31075.0,-15000.0,54000.0,0.0,0.0,-91055.0,-836601.0,0.0,-323000.0
2024-10-22,8358,1000,2000,0,189000,0,-3306,-8000,0,109000,0,4306,10000,0,80000,0,-13760.0,-34381.0,-27000.0,46000.0,0.0,0.0,43961.0,-727601.0,0.0,-323000.0
2024-10-23,8358,87000,31000,0,376000,0,83000,7000,0,218000,0,4000,24000,0,158000,0,83055.0,48619.0,42000.0,53000.0,0.0,0.0,281968.0,-509601.0,0.0,-323000.0
2024-10-24,8358,3000,8000,0,196000,0,-5080,-61000,0,-150000,0,8080,69000,0,346000,0,81295.0,33131.0,-63000.0,14000.0,0.0,0.0,32988.0,-784601.0,0.0,-323000.0
2024-10-25,8358,8019,11000,0,580000,0,-9138,-96000,0,206000,0,17157,107000,0,374000,0,67377.0,27894.0,-159000.0,-61001.0,0.0,0.0,618999.0,-466484.0,0.0,-323000.0
2024-10-28,8358,2000,14000,0,217000,0,-30294,-9000,0,-648000,0,32294,23000,0,865000,0,35182.0,-7725.0,-167000.0,-48001.0,0.0,0.0,-265000.0,-1124484.0,0.0,-323000.0
2024-10-29,8358,3000,0,0,211000,0,-50231,-17000,0,-365000,0,53231,17000,0,576000,0,-11743.0,-59260.0,-176000.0,-63001.0,0.0,0.0,-739000.0,-1493474.0,0.0,-323000.0
2024-10-30,8358,5000,15000,0,117000,0,-3650,-46000,0,-277074,0,8650,61000,0,394074,0,-98393.0,-71477.0,-229000.0,-105001.0,0.0,0.0,-1234074.0,-1881553.0,0.0,-323000.0
2024-11-01,8358,2000,14000,0,719000,0,-6183,2000,0,484969,0,8183,12000,0,234031,0,-99496.0,-73467.0,-166000.0,-99000.0,0.0,0.0,-599105.0,-1372582.0,0.0,-323000.0
2024-11-04,8358,1000,0,0,247000,0,-214,0,0,42000,0,1214,0,0,205000,0,-90572.0,-62559.0,-70000.0,-137000.0,0.0,0.0,-763105.0,-1359577.0,0.0,-223000.0
2024-11-05,8358,0,5000,0,146000,0,-2000,3000,0,4900,0,2000,2000,0,141100,0,-62278.0,-60903.0,-58000.0,-144000.0,0.0,0.0,-110205.0,-1288662.0,0.0,-123000.0
2024-11-06,8358,4000,2000,0,263000,0,-590,-2000,0,138000,0,4590,4000,0,125000,0,-12637.0,-60044.0,-43000.0,-144000.0,0.0,0.0,392795.0,-1378661.0,0.0,0.0
2024-11-07,8358,10055,28000,0,647000,0,10055,24000,0,514000,0,0,4000,0,133000,0,1068.0,-47849.0,27000.0,-127000.0,0.0,0.0,1183869.0,-641655.0,0.0,0.0
2024-11-08,8358,1000,0,0,166000,0,-14663,-22000,0,-379015,0,15663,22000,0,545015,0,-7412.0,-62599.0,3000.0,-182000.0,0.0,0.0,319885.0,-601664.0,0.0,0.0
2024-11-11,8358,29000,58000,0,414000,0,-10242,54000,0,-386024,0,39242,4000,0,800024,0,-17440.0,-56799.0,57000.0,-188000.0,0.0,0.0,-108139.0,-252688.0,0.0,0.0
2024-11-12,8358,14000,0,0,66000,0,-10702,-8000,0,-969010,0,24702,8000,0,1035010,0,-26142.0,-67334.0,46000.0,-194000.0,0.0,0.0,-1082049.0,-1548309.0,0.0,0.0
2024-11-13,8358,1000,10000,0,83000,0,-1709,-8000,0,-187613,0,2709,18000,0,270613,0,-27261.0,-65401.0,40000.0,-206000.0,0.0,0.0,-1407662.0,-1709906.0,0.0,0.0
2024-11-14,8358,5000,0,0,88000,0,-13562,-34000,0,-615455,0,18562,34000,0,703455,0,-50878.0,-65148.0,-18000.0,-178000.0,0.0,0.0,-2537117.0,-2305354.0,0.0,0.0
2024-11-15,8358,2000,32000,0,109000,0,-234,-69000,0,-115065,0,2234,101000,0,224065,0,-36449.0,-62062.0,-65000.0,-291000.0,0.0,0.0,-2273167.0,-2519399.0,0.0,0.0
2024-11-18,8358,1000,18000,0,33000,0,-7614,4000,0,-330485,0,8614,14000,0,363485,0,-33821.0,-74456.0,-115000.0,-287000.0,0.0,0.0,-2217628.0,-2469873.0,0.0,0.0
2024-11-19,8358,7000,6000,0,168000,0,7000,6000,0,-7000,0,0,0,0,175000,0,-16119.0,-69357.0,-101000.0,-280000.0,0.0,0.0,-1255618.0,-2712872.0,0.0,0.0
2024-11-20,8358,8000,82000,0,46000,0,4937,80000,0,-345710,0,3063,2000,0,391710,0,-9473.0,-61114.0,-13000.0,-192000.0,0.0,0.0,-1413715.0,-3167582.0,0.0,0.0
2024-11-21,8358,12000,24000,0,525000,0,10819,-84000,0,396719,0,1181,108000,0,128281,0,14908.0,-133295.0,-63000.0,-283000.0,0.0,0.0,-401541.0,-2988863.0,0.0,0.0
2024-11-22,8358,89776,87000,0,1310000,0,76442,-30000,0,-98438,0,13334,117000,0,1408438,0,91584.0,-51773.0,-24000.0,-252000.0,0.0,0.0,-384914.0,-2937301.0,0.0,0.0
2024-11-25,8358,4000,4000,0,116276,0,-41000,-40000,0,-741548,0,45000,44000,0,857824,0,58198.0,-83635.0,-68000.0,-196000.0,0.0,0.0,-795977.0,-3884849.0,0.0,0.0
2024-11-26,8358,8000,2000,0,177115,0,3746,-28000,0,24115,0,4254,30000,0,153000,0,54944.0,-49595.0,-102000.0,-215000.0,0.0,0.0,-764862.0,-3212734.0,0.0,0.0
2024-11-27,8358,7000,3000,0,244059,0,-6099,-24000,0,-302942,0,13099,27000,0,547001,0,43908.0,-5463.0,-206000.0,-222000.0,0.0,0.0,-722094.0,-3150676.0,0.0,0.0
2024-11-28,8358,10000,0,0,338005,0,-2453,-24000,0,-277487,0,12453,24000,0,615492,0,30636.0,-4266.0,-146000.0,-200000.0,0.0,0.0,-1396300.0,-3151089.0,0.0,0.0
2024-11-29,8358,5000,3000,0,286425,0,-17529,-60000,0,617,0,22529,63000,0,285808,0,-63335.0,-15612.0,-176000.0,-262000.0,0.0,0.0,-1297245.0,-3635441.0,0.0,0.0
2024-12-02,8358,6027,20000,0,178480,0,-4999,16000,0,-433555,0,11026,4000,0,612035,0,-27334.0,-20397.0,-120000.0,-246000.0,0.0,0.0,-989252.0,-4110996.0,0.0,0.0
2024-12-03,8358,3000,16000,0,200334,0,-561,12000,0,-53666,0,3561,4000,0,254000,0,-31641.0,-18958.0,-80000.0,-237000.0,0.0,0.0,-1067033.0,-4169562.0,0.0,0.0
2024-12-04,8358,43826,20000,0,1171970,0,30731,10000,0,324970,0,13095,10000,0,847000,0,5189.0,12363.0,-46000.0,-225000.0,0.0,0.0,-439121.0,-3982592.0,0.0,0.0
2024-12-05,8358,6000,10000,0,316000,0,-12000,4000,0,-164000,0,18000,6000,0,480000,0,-4358.0,-9692.0,-18000.0,-245000.0,0.0,0.0,-325634.0,-4660592.0,0.0,0.0
2024-12-06,8358,1000,2000,0,95631,0,-7548,-14000,0,-50369,0,8548,16000,0,146000,0,5623.0,-2577.0,28000.0,-237000.0,0.0,0.0,-376620.0,-4331946.0,0.0,0.0
2024-12-09,8358,22000,8000,0,143249,0,14050,8000,0,-197751,0,7950,0,0,341000,0,24672.0,21715.0,20000.0,-283000.0,0.0,0.0,-140816.0,-4143673.0,0.0,0.0
2024-12-10,8358,42000,3000,0,330460,0,36695,-6000,0,71460,0,5305,9000,0,259000,0,61928.0,69112.0,2000.0,-281000.0,0.0,0.0,-15690.0,-3103203.0,0.0,0.0
2024-12-11,8358,4000,6000,0,155030,0,-20000,6000,0,-105970,0,24000,0,0,261000,0,11197.0,50821.0,-2000.0,-267000.0,0.0,0.0,-446630.0,-3021560.0,0.0,0.0
2024-12-12,8358,23000,26000,0,107478,0,12301,24000,0,-165522,0,10699,2000,0,273000,0,35498.0,76684.0,18000.0,-209000.0,0.0,0.0,-448152.0,-2571627.0,0.0,0.0
2024-12-13,8358,48000,24000,0,346443,0,35241,18000,0,-1055663,0,12759,6000,0,1402106,0,78287.0,112159.0,50000.0,-122000.0,0.0,0.0,-1453446.0,-3512225.0,0.0,0.0
2024-12-16,8358,27000,18000,0,181451,0,-41042,-12000,0,-391593,0,68042,30000,0,573044,0,23195.0,78731.0,30000.0,-138000.0,0.0,0.0,-1647288.0,-3573333.0,0.0,0.0
2024-12-17,8358,7000,0,0,64397,0,-3196,-16000,0,-118606,0,10196,16000,0,183003,0,-16696.0,68535.0,20000.0,-160000.0,0.0,0.0,-1837354.0,-3684939.0,0.0,0.0
2024-12-18,8358,19000,0,0,142366,0,8364,0,0,-224659,0,10636,0,0,367025,0,11668.0,71962.0,14000.0,-240000.0,0.0,0.0,-1956043.0,-3563888.0,0.0,0.0
2024-12-19,8358,3000,4000,0,173000,0,-20908,-12000,0,22971,0,23908,16000,0,150029,0,-21541.0,40235.0,-22000.0,-168000.0,0.0,0.0,-1767550.0,-3937636.0,0.0,0.0
2024-12-20,8358,1000,2000,0,166432,0,-21520,2000,0,-84569,0,22520,0,0,251001,0,-78302.0,-57727.0,-38000.0,-136000.0,0.0,0.0,-796456.0,-3923767.0,0.0,0.0
2024-12-23,8358,0,0,0,92345,40000,-113,-2249,0,-22655,40000,113,2249,0,115000,0,-37373.0,-16840.0,-28249.0,-98249.0,0.0,0.0,-427518.0,-3204874.0,40000.0,40000.0
2024-12-24,8358,3000,0,0,96000,80000,-631,0,0,-19029,80000,3631,0,0,115029,0,-34808.0,-21217.0,-12249.0,-70249.0,0.0,0.0,-327941.0,-3248018.0,120000.0,120000.0
2024-12-25,8358,5000,12000,0,172248,80000,1196,6000,0,3248,80000,3804,6000,0,169000,0,-41976.0,-13922.0,-6249.0,-40249.0,0.0,0.0,-100034.0,-2941828.0,200000.0,200000.0
2024-12-26,8358,11000,14000,0,293000,84078,9175,-4000,0,204998,84078,1825,18000,0,88002,0,-11893.0,-2294.0,1751.0,-20249.0,0.0,0.0,81993.0,-2459343.0,284078.0,284078.0
2024-12-27,8358,65000,0,0,224121,281219,54171,-4000,0,57120,281219,10829,4000,0,167001,0,63798.0,69406.0,-4249.0,35751.0,0.0,0.0,223682.0,-2402840.0,565297.0,565297.0
2024-12-30,8358,14000,0,0,89809,261364,-1471,-4000,0,-415199,261364,15471,4000,0,505008,0,62440.0,72934.0,-6000.0,15751.0,0.0,0.0,-168862.0,-2384484.0,786661.0,826661.0
2024-12-31,8358,1000,2000,0,26196,9224,-17232,-1000,0,-197204,9224,18232,3000,0,223400,0,45839.0,56263.0,-7000.0,2751.0,0.0,0.0,-347037.0,-2528022.0,715885.0,835885.0
2025-01-02,8358,0,7000,0,83520,0,-29476,6000,0,-81108,-6329,29476,1000,0,164628,6329,15167.0,-3944.0,-7000.0,-1249.0,0.0,0.0,-431393.0,-2934100.0,629556.0,829556.0
2025-01-03,8358,3000,0,0,149461,0,-1011,-6000,0,54411,0,4011,6000,0,95050,0,4981.0,7045.0,-9000.0,-11249.0,0.0,0.0,-581980.0,-2715689.0,545478.0,829556.0
2025-01-06,8358,15000,4000,0,60021,0,12707,4000,0,-185180,-7341,2293,0,0,245201,7341,-36483.0,27300.0,-1000.0,6751.0,0.0,0.0,-824280.0,-2850500.0,256918.0,822215.0
2025-01-07,8358,15000,0,0,85008,0,10703,-4000,0,-114049,-9791,4297,4000,0,199057,9791,-24309.0,23953.0,-1000.0,-5249.0,0.0,0.0,-523130.0,-2766798.0,-14237.0,812424.0
2025-01-08,8358,10000,4000,0,145766,0,-2457,1889,0,-163275,-9792,12457,2111,0,309041,9792,-9534.0,-15199.0,1889.0,2640.0,0.0,0.0,-489201.0,-3001533.0,-33253.0,802632.0
2025-01-09,8358,19000,16000,0,169000,0,-57337,-15000,0,-601174,-14601,76337,31000,0,770174,14601,-37395.0,-52536.0,-19111.0,-18360.0,0.0,0.0,-1009267.0,-3496737.0,-41525.0,788031.0
2025-01-10,8358,4000,4000,0,218000,0,-1533,-8000,0,-337624,-5132,5533,12000,0,555624,5132,-37917.0,-66370.0,-21111.0,-50360.0,0.0,0.0,-1401302.0,-3668839.0,-46657.0,782899.0
2025-01-13,8358,9000,52000,0,696000,0,-35444,0,0,39471,0,44444,52000,0,656529,0,-86068.0,-137055.0,-25111.0,-68360.0,0.0,0.0,-1176651.0,-2573705.0,-39316.0,782899.0
2025-01-14,8358,4000,14000,0,266008,0,1615,6000,0,170689,-44052,2385,8000,0,95319,44052,-95156.0,-94398.0,-15111.0,-50360.0,0.0,0.0,-891913.0,-2011423.0,-73577.0,738847.0
2025-01-15,8358,0,4000,0,222001,0,-1019,-8000,0,87001,-2447,1019,12000,0,135000,2447,-93718.0,-92221.0,-25000.0,-42360.0,0.0,0.0,-641637.0,-1805816.0,-66232.0,736400.0
2025-01-16,8358,0,24000,0,47262,0,-436,12000,0,-84739,-4892,436,12000,0,132001,4892,-36817.0,-101021.0,2000.0,-30360.0,0.0,0.0,-125202.0,-1665896.0,-56523.0,731508.0
2025-01-17,8358,2000,0,0,174231,0,-2058,0,0,72061,-4894,4058,0,0,102170,4894,-37342.0,-82171.0,10000.0,-18360.0,0.0,0.0,284483.0,-1616806.0,-56285.0,726614.0
2025-01-20,8358,0,23000,0,160010,0,-7857,23000,0,111008,-4888,7857,0,0,49002,4888,-9755.0,-68508.0,33000.0,2640.0,0.0,0.0,356020.0,-1421229.0,-61173.0,721726.0
2025-01-21,8358,4000,2000,0,189056,0,-648,-6281,0,-378987,-2444,4648,8281,0,568043,2444,-12018.0,-69043.0,20719.0,-1392.0,0.0,0.0,-193656.0,-1777561.0,-19565.0,679282.0
2025-01-22,8358,0,2000,0,193000,0,-1000,2000,0,120955,-2444,1000,0,0,72045,2444,-11999.0,-69412.0,30719.0,608.0,0.0,0.0,-159702.0,-1637577.0,-19562.0,596838.0
2025-02-03,8358,8000,2000,0,129392,0,101,-54000,0,-135614,0,7899,56000,0,265006,0,-11462.0,-70507.0,-35281.0,-59392.0,0.0,0.0,-210577.0,-1776439.0,-14670.0,516838.0
2025-02-04,8358,3000,1000,0,110001,0,-1483,-2000,0,-75038,-2442,4483,3000,0,185039,2442,-10887.0,-81165.0,-37281.0,-57392.0,0.0,0.0,-357676.0,-2056475.0,-12218.0,430318.0
2025-02-05,8358,2000,16000,0,242360,0,415,14000,0,45883,-9608,1585,2000,0,196477,9608,-2615.0,-134921.0,-46281.0,-39392.0,0.0,0.0,-422801.0,-2067712.0,-16938.0,139491.0
2025-02-06,8358,1000,2000,0,320972,0,-2000,-15000,0,252933,-7328,3000,17000,0,68039,7328,-3967.0,-135450.0,-55000.0,-50392.0,0.0,0.0,209119.0,-1399580.0,-21822.0,-129201.0
2025-02-07,8358,0,14000,0,281000,0,-2000,9000,0,149930,-17097,2000,5000,0,131070,17097,-4967.0,-120218.0,-48000.0,-40392.0,0.0,0.0,238094.0,-1052446.0,-36475.0,-155522.0
2025-02-10,8358,1000,42000,0,627000,0,1000,36000,0,484950,-11972,0,6000,0,142050,11972,-4068.0,-89742.0,42000.0,-10392.0,0.0,0.0,858658.0,-486388.0,-48447.0,-161165.0
2025-02-11,8358,0,26000,0,314383,0,-1000,22000,0,162317,-24420,1000,4000,0,152066,24420,-3585.0,-89731.0,66000.0,17608.0,0.0,0.0,1096013.0,-378482.0,-70425.0,-185585.0
2025-02-12,8358,1000,10015,0,269444,0,948,6015,0,-13939,-4884,52,4000,0,283383,4884,-3052.0,-101490.0,58015.0,19623.0,0.0,0.0,1036191.0,-207241.0,-65701.0,-183128.0
2025-02-13,8358,1000,9041,0,204000,0,-3000,5041,0,-23070,-4884,4000,4000,0,227070,4884,-4052.0,-115193.0,78056.0,28664.0,0.0,0.0,760188.0,-116262.0,-63257.0,-178221.0
2025-02-14,8358,0,2000,0,149000,0,0,0,0,-31000,-9767,0,2000,0,180000,9767,-2052.0,-112736.0,69056.0,26775.0,0.0,0.0,579258.0,16013.0,-55927.0,-178196.0
2025-02-17,8358,2000,0,0,338776,0,-256,0,0,31679,-7323,2256,0,0,307097,7323,-3308.0,-55655.0,33056.0,41775.0,0.0,0.0,125987.0,648866.0,-51278.0,-170918.0
2025-02-18,8358,0,22000,0,326706,0,0,22000,0,73686,-19776,0,0,0,253020,19776,-2308.0,-54122.0,33056.0,71775.0,0.0,0.0,37356.0,1060176.0,-46634.0,-185562.0
2025-02-19,8358,4000,104336,0,330000,0,-56,98336,0,-278024,-9767,4056,6000,0,608024,9767,-3312.0,-18734.0,125377.0,170111.0,0.0,0.0,-226729.0,742681.0,-51517.0,-195329.0
2025-02-20,8358,2000,14000,0,431000,0,58,14000,0,-169024,-26852,1942,0,0,600024,26852,-254.0,-20291.0,134336.0,178111.0,0.0,0.0,-372683.0,402968.0,-73485.0,-178129.0
2025-02-21,8358,1000,0,0,234000,0,-1628,0,0,-70030,-7323,2628,0,0,304030,7323,-1882.0,-20900.0,134336.0,186111.0,0.0,0.0,-411713.0,245937.0,-71041.0,-183005.0
2025-02-24,8358,3000,7000,0,405294,0,463,-48000,0,-5773,-17093,2537,55000,0,411067,17093,-1163.0,-20001.0,86336.0,126111.0,0.0,0.0,-449165.0,324903.0,-80811.0,-195206.0
2025-02-25,8358,0,48000,0,282937,0,-88,44000,0,-163133,-12205,88,4000,0,446070,12205,-1251.0,-18031.0,108336.0,170111.0,0.0,0.0,-685984.0,89709.0,-73240.0,-202517.0
2025-02-26,8358,2000,48000,0,528000,0,-9654,46000,0,75919,-7322,11654,2000,0,452081,7322,-10849.0,-19828.0,56000.0,193111.0,0.0,0.0,-332041.0,54620.0,-70795.0,-204951.0
2025-02-27,8358,2000,38000,0,5984737,0,-89,32000,0,-1763452,-14644,2089,6000,0,7748189,14644,-10996.0,-19269.0,74000.0,231392.0,0.0,0.0,-1926469.0,-1329845.0,-58587.0,-217151.0
2025-03-03,8358,7000,58000,0,331869,0,-6440,23000,0,-671648,-2440,13440,35000,0,1003517,2440,-15808.0,-24709.0,97000.0,252392.0,0.0,0.0,-2528087.0,-2122448.0,-53704.0,-217147.0
2025-03-04,8358,0,3000,0,359000,0,-289,-12000,0,-56502,-4880,289,15000,0,415502,4880,-16560.0,-25099.0,133000.0,294392.0,0.0,0.0,-2578816.0,-2043336.0,-41491.0,-222027.0
2025-03-05,8358,1000,6000,0,686000,0,977,6000,0,419893,0,23,0,0,266107,0,-15495.0,-22639.0,95000.0,302392.0,0.0,0.0,-1995790.0,-1548405.0,-29286.0,-219585.0
2025-03-06,8358,1001,23000,0,409000,0,-67,19000,0,20700,-4879,1068,4000,0,388300,4879,-5908.0,-23121.0,68000.0,307392.0,0.0,0.0,-2051009.0,-1573588.0,-26843.0,-214856.0
2025-03-07,8358,2000,26000,0,171000,0,652,-10000,0,-93003,-4879,1348,36000,0,264003,4879,-5167.0,-20469.0,26000.0,312392.0,0.0,0.0,-380560.0,-1919524.0,-17078.0,-212407.0
2025-03-10,8358,1000,0,0,156000,0,-976,-8000,0,-131031,-7317,1976,8000,0,287031,7317,297.0,-19445.0,-5000.0,295392.0,0.0,0.0,160057.0,-2200485.0,-21955.0,-202627.0
2025-03-11,8358,3000,10000,0,192000,0,-5609,-36000,0,-603101,-2439,8609,46000,0,795101,2439,-5023.0,-26054.0,-29000.0,223392.0,0.0,0.0,-386542.0,-3288536.0,-19514.0,-193094.0
2025-03-12,8358,2107,4000,0,451000,0,639,0,0,35514,-2438,1468,4000,0,415486,2438,-5361.0,-24415.0,-35000.0,201392.0,0.0,0.0,-770921.0,-3415339.0,-21952.0,-171112.0
2025-03-13,8358,0,2000,0,304000,0,0,-16000,0,98960,-4876,0,18000,0,205040,4876,-5294.0,-25363.0,-70000.0,179377.0,0.0,0.0,-692661.0,-3302440.0,-21949.0,-171104.0
2025-03-14,8358,0,2000,0,284000,0,-4000,-2000,0,137742,0,4000,4000,0,146258,0,-9946.0,-26363.0,-62000.0,172336.0,0.0,0.0,-461916.0,-3141628.0,-17070.0,-166220.0
2025-03-17,8358,0,10000,0,134494,0,0,10000,0,30474,0,0,0,0,104020,0,-8970.0,-26363.0,-44000.0,182336.0,0.0,0.0,-300411.0,-3080154.0,-9753.0,-156453.0
2025-03-18,8358,0,38000,0,124000,0,0,38000,0,9586,-2438,0,0,0,114414,2438,-3361.0,-26107.0,30000.0,220336.0,0.0,0.0,312276.0,-3102247.0,-9752.0,-151568.0
2025-03-19,8358,2000,98000,0,153402,0,-635,69987,0,-394859,-4876,2635,28013,0,548261,4876,-4635.0,-26742.0,99987.0,268323.0,0.0,0.0,-118097.0,-3570792.0,-12190.0,-136668.0
2025-03-20,8358,1000,8000,0,423000,0,500,8000,0,311596,-9751,500,0,0,111404,9751,-4135.0,-26186.0,123987.0,177987.0,0.0,0.0,94539.0,-2981172.0,-17065.0,-136652.0
2025-03-21,8358,13990,14000,0,249000,0,12990,10000,0,40000,0,1000,4000,0,209000,0,12855.0,-13254.0,135987.0,173987.0,0.0,0.0,-3203.0,-2772148.0,-17065.0,-109800.0
2025-03-24,8358,22917,123000,0,695000,0,20904,81000,0,-46102,0,2013,42000,0,741102,0,33759.0,9278.0,206987.0,254987.0,0.0,0.0,-79779.0,-2748220.0,-17065.0,-102477.0
2025-03-25,8358,3000,5000,0,277000,0,-1060,-82000,0,-600001,0,4060,87000,0,877001,0,32699.0,7755.0,86987.0,220987.0,0.0,0.0,-689366.0,-3342448.0,-14627.0,-85384.0
2025-03-26,8358,92626,219000,0,1455000,0,64183,119000,0,-586121,-2440,28443,100000,0,2041121,2440,97517.0,72026.0,136000.0,295987.0,0.0,0.0,-880628.0,-3765436.0,-12191.0,-75619.0
2025-03-27,8358,8000,19000,0,699000,0,-49634,-113000,0,-247241,-2440,57634,132000,0,946241,2440,47383.0,32046.0,15000.0,136987.0,0.0,0.0,-1439465.0,-4088596.0,-4880.0,-70737.0
2025-03-28,8358,8000,30000,0,644000,0,-17337,-40187,0,-141002,0,25337,70187,0,785002,0,17056.0,14798.0,-35187.0,64800.0,0.0,0.0,-1620467.0,-2466146.0,-4880.0,-56093.0
2025-03-31,8358,6000,3000,0,515000,0,-15128,-62000,0,-232058,0,21128,65000,0,747058,0,-18976.0,6110.0,-178187.0,-20200.0,0.0,0.0,-1806423.0,-2026556.0,-4880.0,-53653.0
2025-04-01,8358,1000,10000,0,181050,0,-5928,6000,0,-366961,0,6928,4000,0,548011,0,-23844.0,471.0,-90187.0,-2200.0,0.0,0.0,-1573383.0,-2337015.0,-4880.0,-48773.0
2025-04-02,8358,1001,28000,0,382400,0,-1629,14000,0,53346,0,2630,14000,0,329054,0,-89656.0,-2135.0,-195187.0,5800.0,0.0,0.0,-933916.0,-2703562.0,-2440.0,-48773.0
2025-04-07,8358,0,0,0,104000,0,-342,0,0,103850,0,342,0,0,150,0,-40364.0,-2410.0,-82187.0,-13200.0,0.0,0.0,-582825.0,-2620412.0,0.0,-43894.0
2025-04-08,8358,3000,0,0,111000,0,-3024,-4000,0,-87045,0,6024,4000,0,198045,0,-26051.0,-6086.0,-46000.0,-7200.0,0.0,0.0,-528868.0,-2614454.0,0.0,-39015.0
2025-04-09,8358,12000,12000,0,653000,0,-9598,-4003,0,279900,0,21598,16003,0,373100,0,-20521.0,-14708.0,11997.0,-3203.0,0.0,0.0,-16910.0,-2203523.0,0.0,-31698.0
2025-04-10,8358,2000,0,0,711000,0,-22001,-8000,0,418000,-4134,24001,8000,0,293000,4134,-36594.0,-31100.0,-2003.0,24797.0,0.0,0.0,768051.0,-1182422.0,-4134.0,-33393.0
2025-04-11,8358,7941,24000,0,824000,0,-5826,-10000,0,332949,0,13767,34000,0,491051,0,-40791.0,-37565.0,-26003.0,14797.0,0.0,0.0,1047654.0,-884987.0,-4134.0,-30955.0
2025-04-14,8358,69901,43000,0,1081000,0,-29552,0,0,265000,-10359,99453,43000,0,816000,10359,-70001.0,-67117.0,-26003.0,30797.0,0.0,0.0,1208804.0,-718947.0,-14493.0,-36438.0
2025-04-15,8358,62000,1000,0,510000,0,57919,-4000,0,3996,-2439,4081,5000,0,506004,2439,-9058.0,-5198.0,-26003.0,28797.0,0.0,0.0,1299845.0,-852693.0,-16932.0,-38877.0
2025-04-16,8358,19002,80000,0,318000,0,4612,42000,0,-1001,-2438,14390,38000,0,319001,2438,5152.0,-586.0,20000.0,60797.0,0.0,0.0,1018944.0,-884168.0,-19370.0,-41315.0
2025-04-17,8358,2001,1000,0,484000,0,-29050,-30000,0,216000,0,31051,31000,0,268000,0,-1897.0,-29636.0,-2000.0,-7203.0,0.0,0.0,816944.0,-677754.0,-15236.0,-38877.0
2025-04-18,8358,3000,21000,0,36001,0,909,-2000,0,-133018,-2440,2091,23000,0,169019,2440,4838.0,-28092.0,6000.0,-79190.0,0.0,0.0,350977.0,-415913.0,-17676.0,-36441.0
2025-04-21,8358,2000,0,0,222100,0,-1347,0,0,108056,0,3347,0,0,114044,0,33043.0,-29939.0,6000.0,-87190.0,0.0,0.0,194033.0,-619453.0,-7317.0,-26690.0
2025-04-22,8358,4000,4000,0,210002,0,-12550,-8000,0,43995,0,16550,12000,0,166007,0,-37426.0,-55479.0,2000.0,-105190.0,0.0,0.0,234032.0,-615458.0,-4878.0,-26690.0
2025-04-23,8358,951,2000,0,512000,0,-1049,0,0,401000,0,2000,2000,0,111000,0,-43087.0,-77432.0,-40000.0,-186190.0,0.0,0.0,636033.0,-168356.0,-2440.0,-26690.0
2025-04-24,8358,1,4000,0,342000,0,0,-4000,0,132000,0,1,8000,0,210000,0,-14037.0,-76372.0,-14000.0,-108190.0,0.0,0.0,552033.0,563645.0,-2440.0,-26690.0
2025-04-25,8358,888,2000,0,601000,0,888,-4000,0,549900,0,0,6000,0,51100,0,-14058.0,-139667.0,-16000.0,-231190.0,0.0,0.0,1234951.0,1699666.0,0.0,-24250.0
2025-04-28,8358,11280,18000,0,284400,0,11268,18000,0,260320,0,12,0,0,24080,0,-1443.0,-78765.0,2000.0,-100190.0,0.0,0.0,1387215.0,2207227.0,0.0,-21810.0
2025-04-29,8358,12099,20914,0,584000,0,12099,8914,0,462915,0,0,12000,0,121085,0,23206.0,-49329.0,18914.0,-51089.0,0.0,0.0,1806135.0,2811144.0,0.0,-21810.0
2025-04-30,8358,2021,1000,0,300000,0,1167,-48000,0,73363,-7320,854,49000,0,226637,7320,25422.0,-33034.0,-29086.0,-37089.0,0.0,0.0,1478498.0,3116565.0,-7320.0,-29130.0
2025-05-02,8358,7586,3000,0,272000,0,3312,-7000,0,-276138,0,4274,10000,0,548138,0,28734.0,-23794.0,-32086.0,-50089.0,0.0,0.0,1070360.0,3207388.0,-7320.0,-29130.0
2025-05-05,8358,9000,0,0,565060,0,-3600,-16001,0,-171942,-2441,12600,16001,0,737002,2441,24246.0,-25765.0,-44087.0,-80090.0,0.0,0.0,348518.0,2982100.0,-9761.0,-31571.0
2025-05-06,8358,1062,17409,0,331000,0,-538,-1591,0,218973,-4882,1600,19000,0,112027,4882,12440.0,-25961.0,-63678.0,-81681.0,0.0,0.0,307171.0,3097223.0,-14643.0,-36453.0
2025-05-07,8358,2000,10000,0,144000,0,-396,10000,0,-31000,-2440,2396,0,0,175000,2440,-55.0,-23333.0,-62592.0,-67681.0,0.0,0.0,-186744.0,3153268.0,-17083.0,-38893.0
2025-05-08,8358,2311,14000,0,547000,0,311,2000,0,253940,0,2000,12000,0,293060,0,-911.0,-13424.0,-12592.0,-61678.0,0.0,0.0,-6167.0,3127308.0,-9763.0,-38893.0
2025-05-09,8358,12000,0,0,516000,0,11949,0,0,258910,0,51,0,0,257090,0,7726.0,20526.0,-5592.0,-53678.0,0.0,0.0,528881.0,2968218.0,-9763.0,-34759.0
2025-05-12,8358,9146,2000,0,843000,0,-4856,2000,0,287690,0,14002,0,0,555310,0,6470.0,21496.0,12409.0,-41678.0,0.0,0.0,988513.0,2922959.0,-7322.0,-34759.0
2025-05-13,8358,6055,8000,0,1727000,0,55,1000,0,622680,0,6000,7000,0,1104320,0,7063.0,51103.0,15000.0,-40678.0,0.0,0.0,1392220.0,3280639.0,-2440.0,-24400.0
2025-05-14,8358,3000,12000,0,700000,0,3000,-11000,0,316780,0,0,23000,0,383220,0,10459.0,-3816.0,-6000.0,-47678.0,0.0,0.0,1740000.0,3593423.0,0.0,-21961.0
2025-05-15,8358,0,2000,0,81000,0,-101,-4001,0,-426193,0,101,6001,0,507193,0,10047.0,-8529.0,-12001.0,-93679.0,0.0,0.0,1059867.0,3168231.0,0.0,-19523.0
2025-05-16,8358,2000,6000,0,234013,0,1854,-4000,0,115932,0,146,10000,0,118081,0,-48.0,22375.0,-16001.0,-67679.0,0.0,0.0,916889.0,3068163.0,0.0,-19523.0
2025-05-19,8358,0,0,0,189000,0,-3001,-8000,0,82700,0,3001,8000,0,106300,0,1807.0,18465.0,-26001.0,-73679.0,0.0,0.0,711899.0,3283881.0,0.0,-17083.0
2025-05-20,8358,0,6000,0,176000,0,-3007,-11000,0,115680,0,3007,17000,0,60320,0,-1255.0,16805.0,-38001.0,-84679.0,0.0,0.0,204899.0,3291505.0,0.0,-17083.0
2025-05-21,8358,15421,19000,0,363000,0,12654,-16000,0,174550,0,2767,35000,0,188450,0,8399.0,42009.0,-43001.0,-92679.0,0.0,0.0,62669.0,3422060.0,0.0,-17083.0
2025-05-22,8358,15100,4000,0,509000,0,-4733,-20000,0,50765,-2441,19833,24000,0,458235,2441,3767.0,38325.0,-59000.0,-112679.0,0.0,0.0,539627.0,3071825.0,-2441.0,-19524.0
2025-05-23,8358,12061,2000,0,636000,0,-3039,0,0,537900,-2441,15100,2000,0,98100,2441,-1126.0,35286.0,-55000.0,-108679.0,0.0,0.0,961595.0,3477725.0,-4882.0,-21965.0
2025-05-26,8358,45000,4000,0,438000,0,34967,-14000,0,-529099,-4881,10033,18000,0,967099,4881,36842.0,69365.0,-61000.0,-118679.0,0.0,0.0,349796.0,2398726.0,-9763.0,-26846.0
2025-05-27,8358,70000,2000,0,449000,0,26460,-86000,0,-682027,-4881,43540,88000,0,1131027,4881,66309.0,84557.0,-136000.0,-222679.0,0.0,0.0,-447911.0,1456379.0,-14644.0,-31727.0
2025-05-28,8358,12000,2000,0,323000,0,-43476,-34000,0,-34657,0,55476,36000,0,357657,0,10179.0,28982.0,-154000.0,-265593.0,0.0,0.0,-657118.0,958807.0,-14644.0,-31727.0
2025-05-29,8358,6000,19000,0,209000,0,3941,-16000,0,-74003,0,2059,35000,0,283003,0,18853.0,31756.0,-150000.0,-233593.0,0.0,0.0,-781886.0,811441.0,-12203.0,-24407.0
2025-06-02,8358,1800,2000,0,255000,0,-25737,-8000,0,27000,-4881,27537,10000,0,228000,4881,-3845.0,2707.0,-158000.0,-234593.0,0.0,0.0,-1292786.0,1114579.0,-14643.0,-29288.0
2025-06-03,8358,151453,16000,0,1352000,0,140715,10000,0,936995,0,10738,6000,0,415005,0,101903.0,147022.0,-134000.0,-208592.0,0.0,0.0,173308.0,2223516.0,-9762.0,-26847.0
2025-06-04,8358,81200,2000,0,82000,0,9463,2000,0,-1238002,0,71737,0,0,1320002,0,84906.0,157023.0,-46000.0,-205001.0,0.0,0.0,-382667.0,766541.0,-4881.0,-21965.0
2025-06-05,8358,4000,17000,0,274000,0,-28106,14000,0,130969,0,32106,3000,0,143031,0,100276.0,129313.0,2000.0,-201001.0,0.0,0.0,-217041.0,928510.0,-4881.0,-19525.0
2025-06-06,8358,3000,5000,0,153000,0,-2644,5000,0,71172,-2444,5644,0,0,81828,2444,93691.0,126358.0,23000.0,-198001.0,0.0,0.0,-71866.0,745742.0,-7325.0,-21969.0
2025-06-09,8358,232469,120000,0,1756210,0,214917,111000,0,174210,0,17552,9000,0,1582000,0,334345.0,329326.0,142000.0,-87001.0,0.0,0.0,75344.0,661042.0,-2444.0,-21969.0
2025-06-10,8358,1000,115000,0,424000,0,-167689,65000,0,-1407000,0,168689,50000,0,1831000,0,25941.0,166493.0,197000.0,-24001.0,0.0,0.0,-2268651.0,-1033648.0,-2444.0,-21969.0
2025-06-11,8358,168,51000,0,496000,0,-4201,4000,0,-78670,0,4369,47000,0,574670,0,12277.0,162237.0,199000.0,-21001.0,0.0,0.0,-1109319.0,-1734998.0,-2444.0,-21969.0
2025-06-12,8358,7000,102000,0,563000,0,-9871,-70000,0,-1686000,0,16871,172000,0,2249000,0,30512.0,149366.0,115000.0,-80001.0,0.0,0.0,-2926288.0,-3737778.0,-2444.0,-21969.0
2025-06-13,8358,1000,63000,0,1683000,0,-133148,-30000,0,1051000,0,134148,93000,0,632000,0,-99992.0,16319.0,80000.0,-106000.0,0.0,0.0,-1946460.0,-2260585.0,0.0,-21969.0
2025-06-16,8358,1000,49000,0,499000,0,-4000,-32000,0,-64766,0,5000,81000,0,563766,0,-318909.0,10465.0,-63000.0,-134000.0,0.0,0.0,-2185436.0,-2441283.0,0.0,-21969.0
2025-06-17,8358,100,11000,0,375000,0,-1900,-64000,0,-315210,0,2000,75000,0,690210,0,-153120.0,11566.0,-192000.0,-190000.0,0.0,0.0,-1093646.0,-2839193.0,0.0,-21969.0
2025-06-18,8358,3000,20000,0,656010,0,-5000,-26000,0,297010,0,8000,46000,0,359000,0,-153919.0,9573.0,-222000.0,-205000.0,0.0,0.0,-717966.0,-2657863.0,0.0,-21969.0
2025-06-19,8358,3000,10000,0,360000,0,-14389,1000,0,-191001,0,17389,9000,0,551001,0,-158437.0,-17470.0,-151000.0,-188000.0,0.0,0.0,777033.0,-3023414.0,0.0,-21969.0
2025-06-20,8358,5540,2000,0,570000,0,-2733,-4000,0,91741,0,8273,6000,0,478259,0,-28022.0,-15470.0,-125000.0,-172000.0,0.0,0.0,-182226.0,-2982438.0,0.0,-19528.0
2025-06-23,8358,3000,21000,0,699000,0,-187,17000,0,527958,-4949,3187,4000,0,171042,4949,-24209.0,-12618.0,-76000.0,-155000.0,0.0,0.0,410498.0,-2992380.0,-4949.0,-22036.0
2025-06-24,8358,4552,0,0,883000,0,2552,-8000,0,823000,-7438,2000,8000,0,60000,7438,-19757.0,-45033.0,-20000.0,-149000.0,0.0,0.0,1548708.0,-1640281.0,-12387.0,-24593.0
2025-06-25,8358,112204,22000,0,885000,0,96323,1000,0,-318000,0,15881,21000,0,1203000,0,81566.0,24830.0,7000.0,-62000.0,0.0,0.0,933698.0,-1276254.0,-12387.0,-19712.0
2025-06-26,8358,43000,6000,0,167000,0,-19782,-90000,0,-944000,0,62782,96000,0,1111000,0,76173.0,48524.0,-84000.0,-118000.0,0.0,0.0,180699.0,-2185597.0,-12387.0,-19712.0
2025-06-27,8358,1000,0,0,308000,0,-70000,-34000,0,107000,-125031,71000,34000,0,201000,125031,8906.0,-25417.0,-114000.0,-136000.0,0.0,0.0,195958.0,-2004594.0,-137418.0,-144743.0
2025-06-30,8358,20646,0,0,814000,0,15646,-30000,0,570000,-123494,5000,30000,0,244000,123494,24739.0,15966.0,-161000.0,-158000.0,0.0,0.0,238000.0,-1461594.0,-255963.0,-263356.0
2025-07-01,8358,23244,9000,0,526000,0,13705,3000,0,-158000,-124264,9539,6000,0,684000,124264,35892.0,-111044.0,-150000.0,-165000.0,0.0,0.0,-743000.0,-2556589.0,-372789.0,-387620.0
2025-07-02,8358,9761,2000,0,637000,0,-9328,-8000,0,-286005,0,19089,10000,0,923005,0,-69759.0,-129835.0,-159000.0,-175000.0,0.0,0.0,-711005.0,-1604592.0,-372789.0,-387620.0
2025-07-03,8358,2000,1000,0,205000,0,-2776,-4000,0,-235000,0,4776,5000,0,440000,0,-52753.0,-104505.0,-73000.0,-193000.0,0.0,0.0,-2005.0,-1970561.0,-372789.0,-387620.0
2025-07-04,8358,4000,2000,0,273000,0,-1184,-42000,0,-74202,0,5184,44000,0,347202,0,16063.0,-103045.0,-81000.0,-240000.0,0.0,0.0,-183207.0,-2115935.0,-247758.0,-385176.0
2025-07-07,8358,16000,0,0,199000,0,10577,-20000,0,29901,0,5423,20000,0,169099,0,10994.0,-307385.0,-71000.0,-371000.0,0.0,0.0,-723306.0,-2260244.0,-124264.0,-385176.0
2025-07-08,8358,32306,8000,0,567455,0,28248,-1000,0,377282,0,4058,9000,0,190173,0,25537.0,-111448.0,-75000.0,-437000.0,0.0,0.0,-188024.0,-475962.0,0.0,-385176.0
2025-07-09,8358,607640,617000,0,9746545,0,571242,412000,0,7039535,0,36398,205000,0,2707010,0,606107.0,463995.0,345000.0,-29000.0,0.0,0.0,7137516.0,6642243.0,0.0,-385176.0
2025-07-10,8358,376387,981000,0,15701000,2062000,274486,249000,0,6480998,2062000,101901,732000,0,9220002,0,883369.0,748352.0,598000.0,290000.0,0.0,0.0,13853514.0,14809241.0,2062000.0,1676824.0
2025-07-11,8358,334122,926000,0,14171769,4775000,110627,222000,0,-842532,4775000,223495,704000,0,15014301,0,995180.0,992127.0,862000.0,542000.0,0.0,0.0,13085184.0,12915709.0,6837000.0,6451824.0
2025-07-14,8358,148474,823000,0,3134000,0,-33772,407000,0,-1164000,0,182246,416000,0,4298000,0,950831.0,962355.0,1289000.0,981000.0,0.0,0.0,11891283.0,11816475.0,6837000.0,6451824.0
2025-07-15,8358,864461,705000,0,15684131,2114000,747306,-171000,0,-573873,2114000,117155,876000,0,16258004,0,1669889.0,1711561.0,1119000.0,874000.0,0.0,0.0,10940128.0,11557812.0,8951000.0,8565824.0
2025-07-16,8358,133109,363000,0,9248436,170000,-391655,-223000,0,1840384,170000,524764,586000,0,7408052,0,706992.0,1324906.0,484000.0,677000.0,0.0,0.0,5740977.0,13101186.0,9121000.0,8735824.0
2025-07-17,8358,331579,554291,0,18180139,392000,-415343,-64709,0,9452137,392000,746922,619000,0,8728002,0,17163.0,923952.0,170291.0,611291.0,0.0,0.0,8712116.0,22744324.0,7451000.0,9127824.0
2025-07-18,8358,547937,1924579,0,17248797,2746000,177834,1184579,0,2985075,2746000,370103,740000,0,14263722,0,84370.0,1104519.0,1132870.0,1799870.0,0.0,0.0,12539723.0,25637658.0,5422000.0,11873824.0
2025-07-21,8358,139031,528000,0,8629000,1137000,-101041,-227499,0,3143124,1137000,240072,755499,0,5485876,0,17101.0,1003665.0,498371.0,1555371.0,0.0,0.0,16846847.0,28252824.0,6559000.0,13015773.0
2025-07-22,8358,167377,2546000,0,16067110,3250000,-389455,813353,0,-88754,3250000,556832,1732647,0,16155864,0,-1119660.0,611658.0,1482724.0,2376724.0,0.0,0.0,17331966.0,27341070.0,7695000.0,16273211.0
2025-07-23,8358,151779,864074,0,13226500,429000,47002,-166926,0,419395,-71000,104777,1031000,0,12807105,500000,-681003.0,562337.0,1538798.0,2208798.0,0.0,0.0,15910977.0,28078465.0,7454000.0,16202211.0
2025-07-24,8358,232537,2419260,0,16975250,2848000,132243,838247,0,3346594,2687000,100294,1581013,0,13628656,161000,-133417.0,714362.0,2441754.0,3137045.0,0.0,0.0,9805434.0,32369059.0,9749000.0,18889211.0
2025-07-25,8358,53789,757333,0,9217000,92000,-8813,308333,0,837987,-8000,62602,449000,0,8379013,100000,-320064.0,775549.0,1565508.0,3479378.0,0.0,0.0,7658346.0,33100046.0,6995000.0,19006242.0
2025-07-28,8358,255685,578062,0,10032000,2298000,200521,-818642,0,3741250,2128000,55164,1396704,0,6290750,170000,-18502.0,960424.0,974365.0,2690736.0,0.0,0.0,8256472.0,36271296.0,7986000.0,21257736.0
2025-07-29,8358,126111,565000,0,16333100,181000,-38897,-488000,0,972100,-869000,165008,1053000,0,15361000,1050000,332056.0,907822.0,-326988.0,2199736.0,0.0,0.0,9317326.0,37401396.0,3867000.0,20513000.0
2025-07-30,8358,288399,835429,0,20141250,95000,182337,101782,0,5473655,-1045000,106062,733647,0,14667595,1140000,467391.0,1099487.0,-58280.0,2309518.0,0.0,0.0,14371586.0,43161056.0,2893000.0,19468000.0
2025-07-31,8358,384466,1240000,0,18583500,418000,122970,-560637,0,-4965750,-633000,261496,1800637,0,23549250,1051000,458118.0,1225233.0,-1457164.0,1752881.0,0.0,0.0,6059242.0,38430306.0,-427000.0,18835000.0
2025-08-01,8358,171270,1049000,0,12569000,330000,2794,409000,0,-4881050,-489000,168476,640000,0,17450050,819000,469725.0,1229211.0,-1356497.0,2203881.0,0.0,0.0,340205.0,33623458.0,-908000.0,18346000.0
2025-08-04,8358,95580,689001,0,15500250,257000,-54232,182000,0,8455250,257000,149812,507001,0,7045000,0,214972.0,1164402.0,-355855.0,2405881.0,0.0,0.0,5054205.0,42048807.0,-2779000.0,18603000.0
2025-08-05,8358,129072,646000,0,9845250,2027000,24253,-45000,0,-2051509,2027000,104819,691000,0,11896759,0,278122.0,1160407.0,87145.0,2361881.0,0.0,0.0,2030596.0,39620016.0,117000.0,20630000.0
2025-08-06,8358,174144,366000,0,8717200,2365000,-11302,51750,0,-177800,2342000,185446,314250,0,8895000,23000,84483.0,577863.0,37113.0,2001631.0,0.0,0.0,-3620859.0,32402681.0,3504000.0,22972000.0
2025-08-07,8358,62749,576000,0,9262080,1382000,-38385,-247346,0,-2415923,1382000,101134,823346,0,11678003,0,-76872.0,264992.0,350404.0,1505285.0,0.0,0.0,-1071032.0,23505760.0,5519000.0,22292000.0
2025-08-08,8358,200302,617000,0,6001000,16000,120302,393000,0,2049520,16000,80000,224000,0,3951480,0,40636.0,274667.0,334404.0,1676285.0,0.0,0.0,5859538.0,26397812.0,6024000.0,17533000.0
2025-08-11,8358,460365,1513000,0,18281000,162000,2638,773339,0,74527,162000,457727,739661,0,18206473,0,97506.0,311077.0,925743.0,2042624.0,0.0,0.0,-2521185.0,27636339.0,5929000.0,17695000.0
2025-08-12,8358,286698,2206000,0,21284007,4239000,-27085,-607000,0,-1328560,4239000,313783,2813000,0,22612567,0,46168.0,-463314.0,363743.0,1606624.0,0.0,0.0,-1798236.0,26881652.0,8141000.0,19820000.0
2025-08-13,8358,227945,1216000,0,13164500,323000,21805,335855,0,-4350516,323000,206140,880145,0,17515016,0,79275.0,-49854.0,647848.0,2165479.0,0.0,0.0,-5970952.0,20690752.0,6122000.0,19973000.0
2025-08-14,8358,191933,395000,0,6879328,193000,121815,76000,0,5063231,-493000,70118,319000,0,1816097,686000,239475.0,487304.0,971194.0,2306188.0,0.0,0.0,1508202.0,16301846.0,4247000.0,19088000.0
2025-08-15,8358,269697,2372473,0,11681100,40000,41567,1826538,0,2562428,1000,228130,545935,0,9118672,39000,160740.0,351037.0,2404732.0,2948147.0,0.0,0.0,2021110.0,15879199.0,4232000.0,16343000.0
2025-08-18,8358,286766,1004000,0,8280850,106000,129187,-677347,0,-8821250,-16000,157579,1681347,0,17102100,122000,287289.0,581265.0,954046.0,2498299.0,0.0,0.0,-6874667.0,3914825.0,4054000.0,15190000.0
2025-08-19,8358,98000,1754086,0,1477300,0,-33556,1172000,0,-365701,-84000,131556,582086,0,1843001,84000,280818.0,937164.0,2733046.0,2856946.0,0.0,0.0,-5911808.0,3637878.0,-269000.0,11856000.0
2025-08-20,8358,1198000,3574000,0,4359000,0,1068657,1858000,0,2132900,-345000,129343,1716000,0,2226100,345000,1327670.0,1958819.0,4255191.0,4881872.0,0.0,0.0,571608.0,5351383.0,-937000.0,11582000.0
2025-08-21,8358,175000,992000,0,2803095,0,-292000,-755524,0,374345,0,467000,1747524,0,2428750,0,913855.0,1534576.0,3423667.0,3288101.0,0.0,0.0,-4117278.0,2379134.0,-444000.0,8895000.0
2025-08-22,8358,390705,1778000,0,1472084,0,243505,509000,0,-204916,0,147200,1269000,0,1677000,0,1115793.0,1786894.0,2106129.0,3488768.0,0.0,0.0,-6884622.0,1336231.0,-445000.0,8903000.0
2025-08-25,8358,466749,1540607,0,772015,0,457749,1174607,0,-362985,0,9000,366000,0,1135000,0,1444355.0,2044122.0,3958083.0,5482017.0,0.0,0.0,1573643.0,-2768004.0,-429000.0,6775000.0
2025-08-26,8358,653000,1287393,0,1380409,0,461925,396468,0,-571806,-58000,191075,890925,0,1952215,58000,1939836.0,2544944.0,3182551.0,6366485.0,0.0,0.0,1367538.0,-4311910.0,-403000.0,7586000.0
2025-08-27,8358,1160000,1066000,0,1621314,0,954000,54000,0,-1221681,-1979000,206000,1012000,0,2842995,1979000,1825179.0,3316607.0,1378551.0,6318703.0,0.0,0.0,-1987043.0,-11007246.0,-2037000.0,6652000.0
2025-08-28,8358,673914,169000,0,322300,0,639861,-325000,0,-1370700,-436000,34053,494000,0,1693000,436000,2757040.0,3833498.0,1809075.0,6554340.0,0.0,0.0,-3732088.0,-7412196.0,-2473000.0,6849000.0
2025-08-29,8358,860000,127000,0,1110305,0,849000,-190000,0,-716810,-499000,11000,317000,0,1827115,499000,3362535.0,4679704.0,1110075.0,5955340.0,0.0,0.0,-4243982.0,-3247956.0,-2972000.0,6839000.0
2025-09-01,8358,171000,291000,0,920250,36000,6360,-1431000,0,-2267761,-551000,164640,1722000,0,3188011,587000,2911146.0,4740296.0,-1495532.0,4342340.0,0.0,0.0,-6148758.0,-13970967.0,-3523000.0,6031000.0
2025-09-02,8358,429837,1156000,0,11191057,7347000,-69366,-1958100,0,-2678943,7300000,499203,3114100,0,13870000,47000,2379855.0,4646677.0,-3850100.0,2429240.0,0.0,0.0,-8255895.0,-14598401.0,3835000.0,11304000.0
2025-09-03,8358,520024,818000,0,14122554,3951000,-52340,-815900,0,-6931034,3951000,572364,1633900,0,21053588,0,1373515.0,4605639.0,-4720000.0,1561590.0,0.0,0.0,-13965248.0,-21351635.0,9765000.0,12913000.0
2025-09-04,8358,626287,1849000,0,12357138,0,452741,709002,0,2196757,0,173546,1139998,0,10160381,0,1186395.0,5096765.0,-3685998.0,2517938.0,0.0,0.0,-10397791.0,-16738955.0,10201000.0,11531000.0
2025-09-05,8358,373520,1311127,0,10152590,3567000,306291,591000,0,1673240,3567000,67229,720127,0,8479350,0,643686.0,5282754.0,-2904998.0,2715938.0,0.0,0.0,-8007741.0,-17115235.0,14267000.0,15082000.0
2025-09-08,8358,208194,1061000,0,13835419,2335000,-691889,-686000,0,-1522442,2293000,900083,1747000,0,15357861,42000,-54563.0,4588227.0,-2159998.0,1256599.0,0.0,0.0,-7262422.0,-18712204.0,17111000.0,17213000.0
2025-09-09,8358,260144,1171000,0,14675863,1792000,146225,-96000,0,2255455,1792000,113919,1267000,0,12420408,0,161028.0,4761537.0,-297898.0,1767599.0,0.0,0.0,-2328024.0,-15128189.0,11603000.0,14766000.0
2025-09-10,8358,292732,836000,0,11801620,0,-777888,-222000,0,-6604719,-169000,1070620,1058000,0,18406339,169000,-564520.0,3961844.0,296002.0,1209744.0,0.0,0.0,-2001709.0,-17382392.0,7483000.0,14274000.0
2025-09-11,8358,512708,1263000,0,12478619,13000,-1099283,-201000,0,-2526128,-410000,1611991,1464000,0,15004747,423000,-2116544.0,2740746.0,-614000.0,932744.0,0.0,0.0,-6724594.0,-24971751.0,7073000.0,14357000.0
2025-09-12,8358,712618,4716252,0,24172746,14000,-603391,1107958,0,-1026398,-2070000,1316009,3608294,0,25199144,2084000,-3026226.0,2095788.0,-97042.0,214164.0,0.0,0.0,-9424232.0,-28560577.0,1436000.0,12286000.0
2025-09-15,8358,93740,447000,0,6733680,0,-1107046,-975999,0,-3704434,-1939000,1200786,1422999,0,10438114,1939000,-3441383.0,859555.0,-387041.0,-84488.0,0.0,0.0,-11606224.0,-23443761.0,-2796000.0,10363000.0
2025-09-16,8358,283215,765000,0,11890770,0,-428393,-151000,0,1488078,-2288000,711608,916000,0,10402692,2288000,-4016001.0,464718.0,-442041.0,-1407488.0,0.0,0.0,-12373601.0,-21589982.0,-6876000.0,8159000.0
2025-09-17,8358,298994,1166368,0,21953070,262000,-455239,-772499,0,9729838,-3099000,754233,1938867,0,12223232,3361000,-3693352.0,-1059178.0,-992540.0,-4037987.0,0.0,0.0,3960956.0,-13993044.0,-9806000.0,5405000.0
2025-09-18,8358,262182,997003,0,11815000,0,106659,572979,0,-1708588,-11000,155523,424024,0,13523588,11000,-2487410.0,-660519.0,-218561.0,-2709484.0,0.0,0.0,4778496.0,-16075977.0,-9407000.0,5394000.0
2025-09-19,8358,273695,1244054,0,12582056,401000,21477,425054,0,-3593144,378000,252218,819000,0,16175200,23000,-1862542.0,-882547.0,-901465.0,-2793430.0,0.0,0.0,2211750.0,-19464205.0,-6959000.0,5772000.0
2024-09-23,8932,75000,0,0,445000,0,-25631,0,0,-71000,0,100631,0,0,516000,0,-25631.0,-25631.0,0.0,0.0,0.0,0.0,-71000.0,-71000.0,0.0,0.0
2024-09-24,8932,251000,1,0,409000,0,216049,1,0,-31000,0,34951,0,0,440000,0,190418.0,190418.0,1.0,1.0,0.0,0.0,-102000.0,-102000.0,0.0,0.0
2024-09-25,8932,32000,0,0,184000,0,-1878,0,0,-46000,0,33878,0,0,230000,0,188540.0,188540.0,1.0,1.0,0.0,0.0,-148000.0,-148000.0,0.0,0.0
2024-09-26,8932,156000,0,0,101000,0,140000,0,0,-175000,0,16000,0,0,276000,0,328540.0,328540.0,1.0,1.0,0.0,0.0,-323000.0,-323000.0,0.0,0.0
2024-09-27,8932,68000,0,0,57000,0,66000,0,0,-142000,0,2000,0,0,199000,0,394540.0,394540.0,1.0,1.0,0.0,0.0,-465000.0,-465000.0,0.0,0.0
2024-09-30,8932,57227,0,0,57640,0,47225,-1,0,-90360,0,10002,1,0,148000,0,467396.0,441765.0,0.0,0.0,0.0,0.0,-484360.0,-555360.0,0.0,0.0
2024-10-01,8932,47000,0,0,162000,0,45999,0,0,5000,0,1001,0,0,157000,0,297346.0,487764.0,-1.0,0.0,0.0,0.0,-448360.0,-550360.0,0.0,0.0
2024-10-04,8932,45000,0,0,108000,0,44000,0,0,-82000,0,1000,0,0,190000,0,343224.0,531764.0,-1.0,0.0,0.0,0.0,-484360.0,-632360.0,0.0,0.0
2024-10-07,8932,20000,0,0,40000,0,19852,0,0,-99000,0,148,0,0,139000,0,223076.0,551616.0,-1.0,0.0,0.0,0.0,-408360.0,-731360.0,0.0,0.0
2024-10-08,8932,122001,0,0,130000,0,120796,0,0,-7000,0,1205,0,0,137000,0,277872.0,672412.0,-1.0,0.0,0.0,0.0,-273360.0,-738360.0,0.0,0.0
2024-10-09,8932,79000,0,0,234000,0,77316,0,0,67000,0,1684,0,0,167000,0,307963.0,749728.0,0.0,0.0,0.0,0.0,-116000.0,-671360.0,0.0,0.0
2024-10-11,8932,99000,0,0,421000,0,70778,0,0,158000,0,28222,0,0,263000,0,332742.0,820506.0,0.0,0.0,0.0,0.0,37000.0,-513360.0,0.0,0.0
2024-10-14,8932,1000,0,0,96000,0,-14678,0,0,-162000,0,15678,0,0,258000,0,274064.0,805828.0,0.0,0.0,0.0,0.0,-43000.0,-675360.0,0.0,0.0
2024-10-15,8932,143001,0,0,83000,0,120068,0,0,-75000,0,22933,0,0,158000,0,374280.0,925896.0,0.0,0.0,0.0,0.0,-19000.0,-750360.0,0.0,0.0
2024-10-16,8932,69160,35000,0,144000,0,68105,35000,0,5000,0,1055,0,0,139000,0,321589.0,994001.0,35000.0,35000.0,0.0,0.0,-7000.0,-745360.0,0.0,0.0
2024-10-17,8932,93000,0,0,136000,0,91000,0,0,-8000,0,2000,0,0,144000,0,335273.0,1085001.0,35000.0,35000.0,0.0,0.0,-82000.0,-753360.0,0.0,0.0
2024-10-18,8932,205434,0,0,1232000,0,145434,0,0,687832,0,60000,0,0,544168,0,409929.0,1230435.0,35000.0,35000.0,0.0,0.0,447832.0,-65528.0,0.0,0.0
2024-10-21,8932,208000,0,0,119000,0,107896,0,0,-492000,0,100104,0,0,611000,0,532503.0,1338331.0,35000.0,35000.0,0.0,0.0,117832.0,-557528.0,0.0,0.0
2024-10-22,8932,98054,0,0,293000,0,-24958,0,0,-162000,0,123012,0,0,455000,0,387477.0,1313373.0,35000.0,35000.0,0.0,0.0,30832.0,-719528.0,0.0,0.0
2024-10-23,8932,1000,0,0,50000,0,-4001,0,0,-139000,0,5001,0,0,189000,0,315371.0,1309372.0,0.0,35000.0,0.0,0.0,-113168.0,-858528.0,0.0,0.0
2024-10-24,8932,23001,6000,0,446000,0,-13127,6000,0,166000,0,36128,0,0,280000,0,211244.0,1321876.0,6000.0,41000.0,0.0,0.0,60832.0,-621528.0,0.0,0.0
2024-10-25,8932,217136,0,0,709000,0,200790,-35000,0,420000,0,16346,35000,0,289000,0,266600.0,1306617.0,-29000.0,5999.0,0.0,0.0,-207000.0,-170528.0,0.0,0.0
2024-10-28,8932,46089,0,0,116000,0,-9997,0,0,-595069,0,56086,0,0,711069,0,148707.0,1298498.0,-29000.0,5999.0,0.0,0.0,-310069.0,-719597.0,0.0,0.0
2024-10-29,8932,10000,0,0,316000,0,-83420,0,0,-246976,0,93420,0,0,562976,0,90245.0,1075078.0,-29000.0,5999.0,0.0,0.0,-395045.0,-791573.0,0.0,0.0
2024-10-30,8932,66124,0,0,269000,0,42824,-2000,0,102000,0,23300,2000,0,167000,0,137070.0,1051902.0,-31000.0,3999.0,0.0,0.0,-154045.0,-547573.0,0.0,0.0
2024-11-01,8932,23177,0,0,160000,0,2177,0,0,-72000,0,21000,0,0,232000,0,152374.0,1006854.0,-37000.0,4000.0,0.0,0.0,-392045.0,-529213.0,0.0,0.0
2024-11-04,8932,78000,2000,0,649300,0,68000,2000,0,408300,0,10000,0,0,241000,0,19584.0,1028855.0,0.0,6000.0,0.0,0.0,-403745.0,-125913.0,0.0,0.0
2024-11-05,8932,16000,0,0,471000,0,-62378,0,0,-139000,0,78378,0,0,610000,0,-32797.0,922477.0,0.0,6000.0,0.0,0.0,52324.0,-182913.0,0.0,0.0
2024-11-06,8932,20029,1000,0,183000,0,-237895,-5000,0,-223000,0,257924,6000,0,406000,0,-187272.0,664730.0,-5000.0,1000.0,0.0,0.0,76300.0,-306913.0,0.0,0.0
2024-11-07,8932,188999,0,0,361000,0,-396514,0,0,-522300,0,585513,0,0,883300,0,-626610.0,147420.0,-3000.0,1000.0,0.0,0.0,-548000.0,-822213.0,0.0,0.0
2024-11-08,8932,22036,0,0,365000,0,-2964,0,0,-35000,0,25000,0,0,400000,0,-631751.0,67140.0,-3000.0,1000.0,0.0,0.0,-511000.0,-924213.0,0.0,0.0
2024-11-11,8932,56028,0,0,243000,0,40005,0,0,62172,0,16023,0,0,180828,0,-659746.0,36367.0,-5000.0,1000.0,0.0,0.0,-857128.0,-1020041.0,0.0,0.0
2024-11-12,8932,25970,0,0,235000,0,-489331,0,0,65000,0,515301,0,0,170000,0,-1086699.0,-438286.0,-5000.0,1000.0,0.0,0.0,-653128.0,-793041.0,0.0,0.0
2024-11-13,8932,74000,20000,0,194000,0,-54000,20000,0,-49314,0,128000,0,0,243314,0,-902804.0,-612354.0,20000.0,21000.0,0.0,0.0,-479442.0,-767355.0,0.0,0.0
2024-11-14,8932,2500,0,0,189000,0,-168042,-12000,0,-215000,0,170542,12000,0,404000,0,-674332.0,-848501.0,8000.0,-26000.0,0.0,0.0,-172142.0,-987355.0,0.0,0.0
2024-11-15,8932,29000,0,0,133000,0,13757,-8000,0,-171000,0,15243,8000,0,304000,0,-657611.0,-925744.0,0.0,-34000.0,0.0,0.0,-308142.0,-1150355.0,0.0,0.0
2024-11-18,8932,41000,0,0,178000,0,-38683,0,0,-277004,0,79683,0,0,455004,0,-736299.0,-1109861.0,0.0,-34000.0,0.0,0.0,-647318.0,-2115191.0,0.0,0.0
2024-11-19,8932,33393,0,0,636000,0,13254,0,0,381000,0,20139,0,0,255000,0,-233714.0,-1204503.0,0.0,-34000.0,0.0,0.0,-331318.0,-1242191.0,0.0,0.0
2024-11-20,8932,4441,0,0,66000,0,-83139,0,0,-142551,0,87580,0,0,208551,0,-262853.0,-1262684.0,-20000.0,-34000.0,0.0,0.0,-424555.0,-1222742.0,0.0,0.0
2024-11-21,8932,192031,0,0,126000,0,152753,0,0,-197000,0,39278,0,0,323000,0,57942.0,-1105930.0,-8000.0,-34000.0,0.0,0.0,-406555.0,-1280742.0,0.0,0.0
2024-11-22,8932,142000,0,0,164000,0,86355,0,0,-188000,0,55645,0,0,352000,0,130540.0,-1006448.0,0.0,-40000.0,0.0,0.0,-423555.0,-1634742.0,0.0,0.0
2024-11-25,8932,103029,0,0,209000,0,60881,0,0,-35000,0,42148,0,0,244000,0,230104.0,-1146357.0,0.0,-5000.0,0.0,0.0,-181551.0,-2089742.0,0.0,0.0
2024-11-26,8932,21009,0,0,30000,0,-19937,0,0,-261000,0,40946,0,0,291000,0,196913.0,-1156297.0,0.0,-5000.0,0.0,0.0,-823551.0,-1755673.0,0.0,0.0
2024-11-27,8932,318571,0,0,175000,0,292337,0,0,-254000,0,26234,0,0,429000,0,572389.0,-780540.0,0.0,-5000.0,0.0,0.0,-935000.0,-1762697.0,0.0,0.0
2024-11-28,8932,252380,0,0,224313,0,244203,0,0,-50687,0,8177,0,0,275000,0,663839.0,-579161.0,0.0,-3000.0,0.0,0.0,-788687.0,-1915384.0,0.0,0.0
2024-11-29,8932,122000,0,0,302000,0,119022,0,0,48000,0,2978,0,0,254000,0,696506.0,-462316.0,0.0,-3000.0,0.0,0.0,-552687.0,-1795384.0,0.0,0.0
2024-12-02,8932,53000,0,0,94000,0,51503,0,0,-186000,0,1497,0,0,280000,0,687128.0,-478813.0,0.0,-5000.0,0.0,0.0,-703687.0,-2389684.0,0.0,0.0
2024-12-03,8932,115001,0,0,281000,0,114009,0,0,105000,0,992,0,0,176000,0,821074.0,-302426.0,0.0,-5000.0,0.0,0.0,-337687.0,-2145684.0,0.0,0.0
2024-12-04,8932,14000,0,0,264000,0,-3000,0,0,-188000,0,17000,0,0,452000,0,525737.0,-67531.0,0.0,0.0,0.0,0.0,-271687.0,-2110684.0,0.0,0.0
2024-12-05,8932,207569,0,0,136000,0,184233,0,0,-185000,0,23336,0,0,321000,0,465767.0,513216.0,0.0,0.0,0.0,0.0,-406000.0,-1773384.0,0.0,0.0
2024-12-06,8932,52038,0,0,268000,0,48918,0,0,-100000,0,3120,0,0,368000,0,395663.0,565098.0,0.0,0.0,0.0,0.0,-554000.0,-1838384.0,0.0,0.0
2024-12-09,8932,349926,0,0,389000,0,286753,0,0,131000,0,63173,0,0,258000,0,630913.0,811846.0,0.0,0.0,0.0,0.0,-237000.0,-1769556.0,0.0,0.0
2024-12-10,8932,48103,0,0,163000,0,5103,-1000,0,-93000,0,43000,1000,0,256000,0,522007.0,1306280.0,-1000.0,-1000.0,0.0,0.0,-435000.0,-1927556.0,0.0,0.0
2024-12-11,8932,25342,0,0,174065,0,18342,0,0,50613,0,7000,0,0,123452,0,543349.0,1378622.0,-1000.0,-21000.0,0.0,0.0,-196387.0,-1827629.0,0.0,0.0
2024-12-12,8932,74236,0,0,289000,0,-19764,0,0,203000,0,94000,0,0,86000,0,339352.0,1526900.0,-1000.0,-9000.0,0.0,0.0,191613.0,-1409629.0,0.0,0.0
2024-12-13,8932,279,0,0,109000,0,-31398,0,0,23624,0,31677,0,0,85376,0,259036.0,1481745.0,-1000.0,-1000.0,0.0,0.0,315237.0,-1215005.0,0.0,0.0
2024-12-16,8932,11884,0,0,118001,0,-3616,-140,0,7819,0,15500,140,0,110182,0,-31333.0,1516812.0,-1140.0,-1140.0,0.0,0.0,192056.0,-930182.0,0.0,0.0
2024-12-17,8932,7077,0,0,180000,0,-27953,0,0,-25002,0,35030,0,0,205002,0,-64389.0,1475605.0,-140.0,-1140.0,0.0,0.0,260054.0,-1336184.0,0.0,0.0
2024-12-18,8932,72431,0,0,238339,0,-5205,0,0,51105,0,77636,0,0,187234,0,-87936.0,1553539.0,-140.0,-1140.0,0.0,0.0,260546.0,-1142528.0,0.0,0.0
2024-12-19,8932,47858,0,0,424000,0,-2142,0,0,161895,0,50000,0,0,262105,0,-70314.0,1398644.0,-140.0,-1140.0,0.0,0.0,219441.0,-783633.0,0.0,0.0
2024-12-20,8932,2010,0,0,135000,0,-16589,0,0,43888,0,18599,0,0,91112,0,-55505.0,1295700.0,-140.0,-1140.0,0.0,0.0,239705.0,-551745.0,0.0,0.0
2024-12-23,8932,2015,0,0,178364,0,-2991,0,0,-89636,0,5006,0,0,268000,0,-54880.0,1231828.0,0.0,-1140.0,0.0,0.0,142250.0,-606381.0,0.0,0.0
2024-12-24,8932,1007,0,0,91000,0,-21142,0,0,-39991,0,22149,0,0,130991,0,-48069.0,1230623.0,0.0,-1140.0,0.0,0.0,127261.0,-385372.0,0.0,0.0
2024-12-25,8932,2171,0,0,114000,0,-7911,0,0,-19000,0,10082,0,0,133000,0,-50775.0,930375.0,0.0,-1140.0,0.0,0.0,57156.0,-150372.0,0.0,0.0
2024-12-26,8932,4000,0,0,278000,0,-319274,0,0,99000,0,323274,0,0,179000,0,-367907.0,366898.0,0.0,-1140.0,0.0,0.0,-5739.0,-685.0,0.0,0.0
2024-12-27,8932,2000,0,0,113000,0,-195555,0,0,4000,0,197555,0,0,109000,0,-546873.0,52321.0,0.0,-1140.0,0.0,0.0,-45627.0,-44685.0,0.0,0.0
2024-12-30,8932,155000,0,0,117898,0,117118,0,0,-59102,0,37882,0,0,177000,0,-426764.0,117936.0,0.0,-1140.0,0.0,0.0,-15093.0,82213.0,0.0,0.0
2024-12-31,8932,242050,0,0,121542,0,231599,0,0,-133458,0,10451,0,0,255000,0,-174023.0,235526.0,0.0,-1140.0,0.0,0.0,-108560.0,-156245.0,0.0,0.0
2025-01-02,8932,54000,0,0,146741,0,44000,0,0,-138259,0,10000,0,0,285000,0,-122112.0,282526.0,0.0,-1140.0,0.0,0.0,-227819.0,-106504.0,0.0,0.0
2025-01-03,8932,44396,7000,0,519966,0,34826,6922,0,370966,0,9570,78,0,149000,0,231988.0,133119.0,6922.0,5782.0,0.0,0.0,44147.0,449462.0,0.0,0.0
2025-01-06,8932,19000,0,0,314000,0,15000,0,0,252000,0,4000,0,0,62000,0,442543.0,99201.0,6922.0,5782.0,0.0,0.0,292147.0,801462.0,0.0,0.0
2025-01-07,8932,2153,0,0,114190,0,-1847,0,0,24190,0,4000,0,0,90000,0,323578.0,-189399.0,6922.0,5782.0,0.0,0.0,375439.0,694652.0,0.0,0.0
2025-01-08,8932,2013,0,0,66339,0,1013,0,0,32337,0,1000,0,0,34002,0,92992.0,-193489.0,6922.0,6782.0,0.0,0.0,541234.0,819989.0,0.0,0.0
2025-01-09,8932,52002,0,0,116666,0,50447,0,0,-92438,0,1555,0,0,209104,0,99439.0,-161384.0,6922.0,6782.0,0.0,0.0,587055.0,676938.0,0.0,0.0
2025-01-10,8932,56237,0,0,415000,0,37173,0,0,380896,0,19064,0,0,34104,0,101786.0,-104447.0,0.0,6782.0,0.0,0.0,596985.0,854834.0,0.0,0.0
2025-01-13,8932,8804,0,0,138000,0,-2196,0,0,12000,0,11000,0,0,126000,0,84590.0,-75245.0,0.0,6782.0,0.0,0.0,356985.0,843210.0,0.0,0.0
2025-01-14,8932,5472,0,0,256000,0,5472,0,0,213000,0,0,0,0,43000,0,91909.0,-66157.0,0.0,6922.0,0.0,0.0,545795.0,1048391.0,0.0,0.0
2025-01-15,8932,17050,0,0,143102,0,16050,0,0,95102,0,1000,0,0,48000,0,106946.0,-22154.0,0.0,6922.0,0.0,0.0,608560.0,1168495.0,0.0,0.0
2025-01-16,8932,58100,0,0,250167,0,-28900,0,0,-51833,0,87000,0,0,302000,0,27599.0,-45849.0,0.0,6922.0,0.0,0.0,649165.0,1065557.0,0.0,0.0
2025-01-17,8932,46618,0,0,368000,0,24618,0,0,261000,0,22000,0,0,107000,0,15044.0,-19089.0,0.0,6922.0,0.0,0.0,529269.0,1164662.0,0.0,0.0
2025-01-20,8932,17992,0,0,124000,0,9992,0,0,25818,0,8000,0,0,98182,0,27232.0,7492.0,0.0,6922.0,0.0,0.0,543087.0,1146592.0,0.0,0.0
2025-01-21,8932,18000,0,0,112000,0,-3103,0,0,17000,0,21103,0,0,95000,0,18657.0,7380.0,0.0,6922.0,0.0,0.0,347087.0,1253228.0,0.0,0.0
2025-01-22,8932,2000,0,0,135000,0,-27000,0,0,103000,0,29000,0,0,32000,0,-24393.0,1522.0,0.0,6922.0,0.0,0.0,354985.0,1396219.0,0.0,0.0
2025-02-03,8932,77496,0,0,287000,0,43496,0,0,160000,0,34000,0,0,127000,0,48003.0,52929.0,0.0,6922.0,0.0,0.0,566818.0,1575219.0,0.0,0.0
2025-02-04,8932,135912,0,0,519000,0,119632,0,0,368000,0,16280,0,0,151000,0,143017.0,491835.0,0.0,6922.0,0.0,0.0,673818.0,1844219.0,0.0,0.0
2025-02-05,8932,21000,0,0,216000,0,-70155,0,0,116000,0,91155,0,0,100000,0,62870.0,617235.0,0.0,6922.0,0.0,0.0,764000.0,1956219.0,0.0,0.0
2025-02-06,8932,48034,0,0,234000,0,-266907,0,0,124000,0,314941,0,0,110000,0,-200934.0,233210.0,0.0,6922.0,0.0,0.0,871000.0,2139321.0,0.0,0.0
2025-02-07,8932,40074,0,0,178000,0,-51803,0,0,138000,0,91877,0,0,40000,0,-225737.0,-50192.0,0.0,6922.0,0.0,0.0,906000.0,2410779.0,0.0,0.0
2025-02-10,8932,83000,0,0,390000,0,36553,0,0,319000,0,46447,0,0,71000,0,-232680.0,-57639.0,0.0,6922.0,0.0,0.0,1065000.0,2868038.0,0.0,0.0
2025-02-11,8932,10999,9000,0,111000,0,-35605,9000,0,-147000,0,46604,0,0,258000,0,-387917.0,-128070.0,9000.0,9000.0,0.0,0.0,550000.0,2350072.0,0.0,0.0
2025-02-12,8932,43266,0,0,203000,0,-164787,0,0,-114000,0,208053,0,0,317000,0,-482549.0,-307857.0,9000.0,9000.0,0.0,0.0,320000.0,1984072.0,0.0,0.0
2025-02-13,8932,1000,0,0,37000,0,-25471,0,0,-83000,0,26471,0,0,120000,0,-241113.0,-331481.0,9000.0,9000.0,0.0,0.0,113000.0,1876882.0,0.0,0.0
2025-02-14,8932,40000,0,0,15000,0,-20659,0,0,-138000,0,60659,0,0,153000,0,-209969.0,-353153.0,9000.0,9000.0,0.0,0.0,-163000.0,1706545.0,0.0,0.0
2025-02-17,8932,227290,0,0,71000,0,213690,0,0,-165000,0,13600,0,0,236000,0,-32832.0,-189910.0,9000.0,9000.0,0.0,0.0,-647000.0,1633983.0,0.0,0.0
2025-02-18,8932,15000,0,0,160000,0,6000,0,0,-124000,0,9000,0,0,284000,0,8773.0,-221083.0,0.0,9000.0,0.0,0.0,-624000.0,1129087.0,0.0,0.0
2025-02-19,8932,28000,0,0,88000,0,25613,0,0,24477,0,2387,0,0,63523,0,199173.0,-193274.0,0.0,9000.0,0.0,0.0,-485523.0,1141564.0,0.0,0.0
2025-02-20,8932,22823,0,0,66000,0,18889,0,0,-5000,0,3934,0,0,71000,0,243533.0,-179857.0,0.0,9000.0,0.0,0.0,-407523.0,923564.0,0.0,0.0
2025-02-21,8932,191549,0,0,208859,0,185378,0,0,156859,0,6171,0,0,52000,0,449570.0,-10529.0,0.0,9000.0,0.0,0.0,-112664.0,985321.0,0.0,0.0
2025-02-24,8932,47000,0,0,48000,0,27502,-7000,0,-85000,0,19498,7000,0,133000,0,263382.0,45873.0,-7000.0,2000.0,0.0,0.0,-32664.0,952154.0,0.0,0.0
2025-02-25,8932,21000,0,0,134000,0,-54852,0,0,-167000,0,75852,0,0,301000,0,202530.0,-33597.0,-7000.0,2000.0,0.0,0.0,-75664.0,524154.0,0.0,0.0
2025-02-26,8932,22000,0,0,64000,0,-50392,0,0,-42000,0,72392,0,0,106000,0,126525.0,-93981.0,-7000.0,2000.0,0.0,0.0,-142141.0,456336.0,0.0,0.0
2025-02-27,8932,19998,0,0,49000,0,-128735,0,0,-81000,0,148733,0,0,130000,0,-21099.0,-219613.0,-7000.0,2000.0,0.0,0.0,-218141.0,358336.0,0.0,0.0
2025-03-03,8932,14000,0,0,175000,0,-73678,0,0,21000,0,87678,0,0,154000,0,-280155.0,-266291.0,-7000.0,2000.0,0.0,0.0,-354000.0,276336.0,0.0,0.0
2025-03-04,8932,31428,0,0,195000,0,6701,0,0,-236000,0,24727,0,0,431000,0,-300956.0,-303086.0,0.0,2000.0,0.0,0.0,-505000.0,-119664.0,0.0,0.0
2025-03-05,8932,154000,5000,0,285000,0,-12739,5000,0,211000,0,166739,0,0,74000,0,-258843.0,-435457.0,5000.0,7000.0,0.0,0.0,-127000.0,-276664.0,0.0,0.0
2025-03-06,8932,165208,0,0,236000,0,106932,0,0,28000,0,58276,0,0,208000,0,-101519.0,-258370.0,5000.0,7000.0,0.0,0.0,-57000.0,-364664.0,0.0,0.0
2025-03-07,8932,3000,0,0,80000,0,-138009,0,0,-14925,0,141009,0,0,94925,0,-110793.0,-129472.0,5000.0,7000.0,0.0,0.0,9075.0,-503589.0,0.0,0.0
2025-03-10,8932,2050,0,0,82000,0,-19989,0,0,-8000,0,22039,0,0,90000,0,-57104.0,-97658.0,5000.0,7000.0,0.0,0.0,-19925.0,-649589.0,0.0,0.0
2025-03-11,8932,11000,0,0,59000,0,-133952,-9000,0,-296859,0,144952,9000,0,355859,0,-197757.0,-268163.0,-4000.0,-2000.0,0.0,0.0,-80784.0,-1265448.0,0.0,0.0
2025-03-12,8932,24000,0,0,90000,0,-20146,0,0,-23317,0,44146,0,0,113317,0,-205164.0,-252704.0,-9000.0,-11000.0,0.0,0.0,-315101.0,-1141765.0,0.0,0.0
2025-03-13,8932,23000,0,0,132000,0,-15573,0,0,6000,0,38573,0,0,126000,0,-327669.0,-103490.0,-9000.0,-11000.0,0.0,0.0,-337101.0,-1021765.0,0.0,0.0
2025-03-14,8932,3000,0,0,8000,0,-26182,0,0,-114000,0,29182,0,0,122000,0,-215842.0,-104201.0,-9000.0,-11000.0,0.0,0.0,-436176.0,-1052765.0,0.0,0.0
2025-03-17,8932,6144,0,0,26000,0,5356,0,0,-69000,0,788,0,0,95000,0,-190497.0,-78186.0,-9000.0,-11000.0,0.0,0.0,-497176.0,-983765.0,0.0,0.0
2025-03-18,8932,2000,0,0,11124,0,2000,0,0,-171876,0,0,0,0,183000,0,-54545.0,-289876.0,0.0,-11000.0,0.0,0.0,-372193.0,-990641.0,0.0,0.0
2025-03-19,8932,0,0,0,12000,0,-20714,0,0,-110000,0,20714,0,0,122000,0,-55113.0,-316590.0,0.0,-11000.0,0.0,0.0,-458876.0,-976641.0,0.0,0.0
2025-03-20,8932,12525,0,0,109000,0,10702,0,0,17000,0,1823,0,0,92000,0,-28838.0,-331501.0,0.0,-11000.0,0.0,0.0,-447876.0,-984118.0,0.0,0.0
2025-03-21,8932,1000,0,0,49000,0,-5042,0,0,-235653,0,6042,0,0,284653,0,-7698.0,-355432.0,0.0,-11000.0,0.0,0.0,-569529.0,-1214771.0,0.0,0.0
2025-03-24,8932,4000,0,0,53000,0,-85057,0,0,-54012,0,89057,0,0,107012,0,-98111.0,-625867.0,0.0,-11000.0,0.0,0.0,-554541.0,-1425642.0,0.0,0.0
2025-03-25,8932,450,0,0,18012,0,-6600,0,0,-32988,0,7050,0,0,51000,0,-106711.0,-659969.0,0.0,-4000.0,0.0,0.0,-415653.0,-1373630.0,0.0,0.0
2025-03-26,8932,15059,0,0,88177,0,15059,-20000,0,32184,0,0,20000,0,55993,0,-70938.0,-590058.0,-20000.0,-24000.0,0.0,0.0,-273469.0,-1174446.0,0.0,0.0
2025-03-27,8932,38222,0,0,34000,0,34222,-30000,0,3104,0,4000,30000,0,30896,0,-47418.0,-505444.0,-50000.0,-54000.0,0.0,0.0,-287365.0,-1129342.0,0.0,0.0
2025-03-28,8932,5,0,0,52000,0,-11396,-7000,0,23000,0,11401,7000,0,29000,0,-53772.0,-388105.0,-57000.0,-61000.0,0.0,0.0,-28712.0,-1025342.0,0.0,0.0
2025-03-31,8932,13225,0,0,35000,0,-71574,-2000,0,-123000,0,84799,2000,0,158000,0,-40289.0,-386001.0,-59000.0,-63000.0,0.0,0.0,-97700.0,-1169342.0,0.0,0.0
2025-04-01,8932,22370,0,0,128000,0,22370,-3000,0,115000,0,0,3000,0,13000,0,-11319.0,-370332.0,-62000.0,-66000.0,0.0,0.0,50288.0,-818342.0,0.0,0.0
2025-04-02,8932,21000,0,0,93171,0,10883,0,0,50171,0,10117,0,0,43000,0,-15495.0,-346710.0,-42000.0,-71000.0,0.0,0.0,68275.0,-979171.0,0.0,0.0
2025-04-07,8932,0,0,0,1000,0,-39001,0,0,1000,0,39001,0,0,0,0,-88718.0,-492643.0,-12000.0,-71000.0,0.0,0.0,66171.0,-1006171.0,0.0,0.0
2025-04-08,8932,1000,0,0,661000,0,-368043,-3000,0,494000,0,369043,3000,0,167000,0,-445365.0,-722677.0,-8000.0,-74000.0,0.0,0.0,537171.0,-497246.0,0.0,0.0
2025-04-09,8932,4867,0,0,1057000,0,-527215,0,0,687000,0,532082,0,0,370000,0,-901006.0,-1229903.0,-6000.0,-74000.0,0.0,0.0,1347171.0,197754.0,0.0,0.0
2025-04-10,8932,90001,0,0,351630,0,77396,0,0,3592,0,12605,0,0,348038,0,-845980.0,-1018555.0,-3000.0,-65000.0,0.0,0.0,1235763.0,498205.0,0.0,0.0
2025-04-11,8932,78157,0,0,272000,0,-17615,0,0,3921,0,95772,0,0,268079,0,-874478.0,-1016024.0,-3000.0,-65000.0,0.0,0.0,1189513.0,525443.0,0.0,0.0
2025-04-14,8932,134224,0,0,382000,0,102604,0,0,1000,0,31620,0,0,381000,0,-732873.0,-897847.0,-3000.0,-65000.0,0.0,0.0,1189513.0,520443.0,0.0,0.0
2025-04-15,8932,1075,0,0,93000,0,-12925,0,0,-49000,0,14000,0,0,142000,0,-377755.0,-884590.0,0.0,-65000.0,0.0,0.0,646513.0,585443.0,0.0,0.0
2025-04-16,8932,2000,0,0,82000,0,-189152,-179,0,-144000,0,191152,179,0,226000,0,-39692.0,-1079098.0,-179.0,-65179.0,0.0,0.0,-184487.0,510443.0,0.0,0.0
2025-04-17,8932,23000,0,0,49000,0,-20201,0,0,-23000,0,43201,0,0,72000,0,-137289.0,-1101299.0,-179.0,-65179.0,0.0,0.0,-211079.0,659319.0,0.0,0.0
2025-04-18,8932,1000,0,0,14000,0,-3719,0,0,-58000,0,4719,0,0,72000,0,-123393.0,-1084304.0,-179.0,-65179.0,0.0,0.0,-273000.0,711319.0,0.0,0.0
2025-04-21,8932,15156,0,0,105000,0,-36332,0,0,-88000,0,51488,0,0,193000,0,-262329.0,-1131338.0,-179.0,-65179.0,0.0,0.0,-362000.0,606319.0,0.0,0.0
2025-04-22,8932,10000,0,0,85000,0,-6000,0,0,-37000,0,16000,0,0,122000,0,-255404.0,-1132296.0,-179.0,-65179.0,0.0,0.0,-350000.0,804972.0,0.0,0.0
2025-04-23,8932,21827,0,0,97000,0,16737,0,0,-34000,0,5090,0,0,131000,0,-49515.0,-1030502.0,0.0,-65179.0,0.0,0.0,-240000.0,824984.0,0.0,0.0
2025-04-24,8932,6000,0,0,32000,0,-24795,0,0,-4000,0,30795,0,0,36000,0,-54109.0,-1048697.0,0.0,-65179.0,0.0,0.0,-221000.0,853972.0,0.0,0.0
2025-04-25,8932,17571,0,0,82000,0,-5446,0,0,-11208,0,23017,0,0,93208,0,-55836.0,-1069202.0,0.0,-45179.0,0.0,0.0,-174208.0,810580.0,0.0,0.0
2025-04-28,8932,8353,0,0,86000,0,4100,0,0,46000,0,4253,0,0,40000,0,-15404.0,-1099324.0,0.0,-15179.0,0.0,0.0,-40208.0,853476.0,0.0,0.0
2025-04-29,8932,107345,0,0,106000,0,86892,0,0,4000,0,20453,0,0,102000,0,77488.0,-1001036.0,0.0,-8179.0,0.0,0.0,792.0,834476.0,0.0,0.0
2025-04-30,8932,53000,0,0,55000,0,40000,0,0,-87000,0,13000,0,0,142000,0,100751.0,-889462.0,0.0,-6179.0,0.0,0.0,-52208.0,870476.0,0.0,0.0
2025-05-02,8932,396082,3000,0,1271000,0,95657,3000,0,452000,0,300425,0,0,819000,0,221203.0,-816175.0,3000.0,-179.0,0.0,0.0,403792.0,1207476.0,0.0,0.0
2025-05-05,8932,95292,13000,0,468000,0,-293978,13000,0,-155000,0,389270,0,0,623000,0,-67329.0,-1121036.0,16000.0,12821.0,0.0,0.0,260000.0,1002305.0,0.0,0.0
2025-05-06,8932,19551,3000,0,193000,0,-209942,3000,0,-161000,0,229493,0,0,354000,0,-281371.0,-1291977.0,19000.0,15821.0,0.0,0.0,53000.0,840305.0,0.0,0.0
2025-05-07,8932,48318,2000,0,182000,0,-33149,2000,0,-104000,0,81467,0,0,286000,0,-401412.0,-957083.0,21000.0,20821.0,0.0,0.0,-55000.0,242305.0,0.0,0.0
2025-05-08,8932,229669,1000,0,265000,0,205267,1000,0,4000,0,24402,0,0,261000,0,-236145.0,-224601.0,22000.0,21821.0,0.0,0.0,36000.0,-440695.0,0.0,0.0
2025-05-09,8932,12000,0,0,90000,0,-74006,0,0,-232000,0,86006,0,0,322000,0,-405808.0,-376003.0,19000.0,21821.0,0.0,0.0,-648000.0,-676287.0,0.0,0.0
2025-05-12,8932,127983,0,0,169000,0,74278,0,0,-27000,0,53705,0,0,196000,0,-37552.0,-284110.0,6000.0,21821.0,0.0,0.0,-520000.0,-707208.0,0.0,0.0
2025-05-13,8932,13916,0,0,222000,0,-77389,0,0,6000,0,91305,0,0,216000,0,95001.0,-464103.0,3000.0,21821.0,0.0,0.0,-353000.0,-702208.0,0.0,0.0
2025-05-14,8932,57377,0,0,2283393,0,49076,0,0,360000,0,8301,0,0,1923393,0,177226.0,-402102.0,1000.0,21821.0,0.0,0.0,111000.0,-293208.0,0.0,0.0
2025-05-15,8932,4273,0,0,288000,0,-12425,-5000,0,231000,0,16698,5000,0,57000,0,-40466.0,-225375.0,-5000.0,17000.0,0.0,0.0,338000.0,81792.0,0.0,0.0
2025-05-16,8932,462,0,0,353000,0,-120101,-6000,0,227000,0,120563,6000,0,126000,0,-86561.0,-325275.0,-11000.0,11000.0,0.0,0.0,797000.0,331792.0,0.0,0.0
2025-05-19,8932,11654,0,0,63000,0,-44930,-2000,0,-171000,0,56584,2000,0,234000,0,-205769.0,-366486.0,-13000.0,9000.0,0.0,0.0,653000.0,218792.0,0.0,0.0
2025-05-20,8932,101862,0,0,110063,0,95512,0,0,1063,0,6350,0,0,109000,0,-32868.0,-234642.0,-13000.0,9000.0,0.0,0.0,648063.0,307855.0,0.0,0.0
2025-05-21,8932,135982,0,0,57000,0,116008,0,0,-204000,0,19974,0,0,261000,0,34064.0,-112634.0,-13000.0,9000.0,0.0,0.0,84063.0,140855.0,0.0,0.0
2025-05-22,8932,966,0,0,88882,0,-5622,-4000,0,29882,0,6588,4000,0,59000,0,40867.0,-134993.0,-12000.0,5000.0,0.0,0.0,-117055.0,204737.0,0.0,0.0
2025-05-23,8932,289815,0,0,625000,0,265523,0,0,387845,0,24292,0,0,237155,0,426491.0,155325.0,-6000.0,5000.0,0.0,0.0,43790.0,596582.0,0.0,0.0
2025-05-26,8932,5000,11000,0,104000,0,-23187,9000,0,-60000,0,28187,2000,0,164000,0,448234.0,137584.0,5000.0,14000.0,0.0,0.0,154790.0,547790.0,0.0,0.0
2025-05-27,8932,31000,21000,0,95000,0,26998,21000,0,-138000,0,4002,0,0,233000,0,379720.0,160482.0,26000.0,35000.0,0.0,0.0,15727.0,363790.0,0.0,0.0
2025-05-28,8932,94377,1000,0,1045901,0,38377,1000,0,685901,0,56000,0,0,360000,0,302089.0,111967.0,27000.0,36000.0,0.0,0.0,905628.0,1045691.0,0.0,0.0
2025-05-29,8932,147723,22000,0,825000,0,120512,22000,0,434000,0,27211,0,0,391000,0,428223.0,192479.0,53000.0,58000.0,0.0,0.0,1309746.0,1566691.0,0.0,0.0
2025-06-02,8932,26097,0,0,236000,0,-106388,0,0,-53329,0,132485,0,0,289329,0,56312.0,-9566.0,53000.0,55000.0,0.0,0.0,868572.0,1061362.0,0.0,0.0
2025-06-03,8932,22604,0,0,130000,0,-73802,-22000,0,12000,0,96406,22000,0,118000,0,5697.0,210610.0,22000.0,20000.0,0.0,0.0,940572.0,1228362.0,0.0,0.0
2025-06-04,8932,72852,0,0,431000,0,13531,0,0,156814,0,59321,0,0,274186,0,-7770.0,434083.0,1000.0,17000.0,0.0,0.0,1235386.0,1546176.0,0.0,0.0
2025-06-05,8932,79213,13000,0,100000,0,14212,13000,0,-100000,0,65001,0,0,200000,0,-31935.0,481444.0,13000.0,28000.0,0.0,0.0,449485.0,1550176.0,0.0,0.0
2025-06-06,8932,65922,0,0,1588100,0,-286049,0,0,977087,0,351971,0,0,611013,0,-438496.0,-9872.0,-9000.0,27000.0,0.0,0.0,992572.0,2523263.0,0.0,0.0
2025-06-09,8932,205969,115000,0,1951000,0,-576891,115000,0,-1827000,0,782860,0,0,3778000,0,-908999.0,-512757.0,106000.0,142000.0,0.0,0.0,-781099.0,928263.0,0.0,0.0
2025-06-10,8932,76627,52000,0,3925000,0,-522977,-44000,0,642000,0,599604,96000,0,3283000,0,-1358174.0,-1110012.0,84000.0,98000.0,0.0,0.0,-151099.0,1597263.0,0.0,0.0
2025-06-11,8932,241674,58000,0,4850080,0,-292660,45000,0,811697,0,534334,13000,0,4038383,0,-1664365.0,-1325283.0,129000.0,143000.0,0.0,0.0,503784.0,2402960.0,0.0,0.0
2025-06-12,8932,181776,0,0,2595000,0,-290971,-3000,0,8492,0,472747,3000,0,2586508,0,-1969548.0,-1665330.0,113000.0,140000.0,0.0,0.0,612276.0,2051452.0,0.0,0.0
2025-06-13,8932,324825,8000,0,1849019,0,-64023,6000,0,-1221486,0,388848,2000,0,3070505,0,-1747522.0,-1716928.0,119000.0,151000.0,0.0,0.0,-1586297.0,598966.0,0.0,0.0
2025-06-16,8932,95460,0,0,1301150,0,-43209,0,0,-125850,0,138669,0,0,1427000,0,-1213840.0,-1640036.0,4000.0,157000.0,0.0,0.0,114853.0,246116.0,0.0,0.0
2025-06-17,8932,73816,54000,0,2515005,0,-901963,-107000,0,-63095,0,975779,161000,0,2578100,0,-1592826.0,-2497069.0,-59000.0,52000.0,0.0,0.0,-590242.0,354021.0,0.0,0.0
2025-06-18,8932,105731,2000,0,1157397,0,-12708,0,0,-205603,0,118439,2000,0,1363000,0,-1312874.0,-2605289.0,-104000.0,52000.0,0.0,0.0,-1607542.0,147355.0,0.0,0.0
2025-06-19,8932,101792,4000,0,1063045,0,-63026,-4000,0,-355956,0,164818,8000,0,1419001,0,-1084929.0,-2784323.0,-105000.0,48000.0,0.0,0.0,-1971990.0,-4601.0,0.0,0.0
2025-06-20,8932,111000,0,0,1049025,0,-94720,-10000,0,-685054,0,205720,10000,0,1734079,0,-1115626.0,-2873421.0,-121000.0,42000.0,0.0,0.0,-1435558.0,-719537.0,0.0,0.0
2025-06-23,8932,38527,0,0,436000,0,-87897,0,0,-390200,0,126424,0,0,826200,0,-1160314.0,-3226841.0,-121000.0,42000.0,0.0,0.0,-1699908.0,-1497582.0,0.0,0.0
2025-06-24,8932,39136,8000,0,610038,0,-31943,8000,0,-1801962,0,71079,0,0,2412000,0,-290294.0,-3235597.0,-6000.0,41000.0,0.0,0.0,-3438775.0,-3239544.0,0.0,0.0
2025-06-25,8932,22300,2000,0,754467,0,11253,2000,0,439467,0,11047,0,0,315000,0,-266333.0,-3251342.0,-4000.0,22000.0,0.0,0.0,-2793705.0,-2662077.0,0.0,0.0
2025-06-26,8932,4000,0,0,442000,0,-35555,0,0,161922,0,39555,0,0,280078,0,-238862.0,-3325274.0,0.0,21000.0,0.0,0.0,-2275827.0,-3186056.0,0.0,0.0
2025-06-27,8932,78848,0,0,644000,0,28731,0,0,-1033193,0,50117,0,0,1677193,0,-115411.0,-3417055.0,10000.0,-1000.0,0.0,0.0,-2623966.0,-4653249.0,0.0,0.0
2025-06-30,8932,33098,0,0,715000,0,-2999,0,0,183000,0,36097,0,0,532000,0,-30513.0,-3313666.0,10000.0,-1000.0,0.0,0.0,-2050766.0,-4416920.0,0.0,0.0
2025-07-01,8932,18000,3000,0,298000,0,-85683,3000,0,-7548,0,103683,0,0,305548,0,-84253.0,-3325547.0,5000.0,24000.0,0.0,0.0,-256352.0,-4436468.0,0.0,0.0
2025-07-02,8932,336187,10000,0,2690768,0,-72603,10000,0,-2126382,0,408790,0,0,4817150,0,-168109.0,-3411681.0,13000.0,34000.0,0.0,0.0,-2822201.0,-6719664.0,0.0,0.0
2025-07-03,8932,98526,9000,0,3223500,0,-162123,3000,0,-1041713,0,260649,6000,0,4265213,0,-294677.0,-3588016.0,16000.0,24000.0,0.0,0.0,-4025836.0,-7661377.0,0.0,0.0
2025-07-04,8932,72579,2000,0,3587243,0,-153608,-14000,0,809243,0,226187,16000,0,2778000,0,-477016.0,-3455575.0,2000.0,10000.0,0.0,0.0,-2183400.0,-7829221.0,0.0,0.0
2025-07-07,8932,87009,0,0,1279618,0,11095,0,0,522618,0,75914,0,0,757000,0,-462922.0,-2867589.0,2000.0,-105000.0,0.0,0.0,-1843782.0,-5479603.0,0.0,0.0
2025-07-08,8932,22907,0,0,393695,0,-1750,0,0,-58305,0,24657,0,0,452000,0,-378989.0,-2346362.0,-1000.0,-61000.0,0.0,0.0,-1894539.0,-6179908.0,0.0,0.0
2025-07-09,8932,132208,0,0,639531,0,120573,0,0,4531,0,11635,0,0,635000,0,-185813.0,-1933129.0,-11000.0,-106000.0,0.0,0.0,236374.0,-6987074.0,0.0,0.0
2025-07-10,8932,426095,0,0,691000,0,305691,0,0,-57000,0,120404,0,0,748000,0,282001.0,-1336467.0,-14000.0,-103000.0,0.0,0.0,1221087.0,-7052566.0,0.0,0.0
2025-07-11,8932,19427,14000,0,926000,0,-247115,14000,0,-227000,0,266542,0,0,1153000,0,188494.0,-1519559.0,14000.0,-95000.0,0.0,0.0,184844.0,-6058080.0,0.0,0.0
2025-07-14,8932,9150,0,0,576000,0,-105779,-10000,0,132000,0,114929,10000,0,444000,0,71620.0,-1582129.0,4000.0,-105000.0,0.0,0.0,-205774.0,-5800230.0,0.0,0.0
2025-07-15,8932,118096,6000,0,1258001,21000,-14830,3000,0,310001,21000,132926,3000,0,948000,0,58540.0,-694996.0,7000.0,5000.0,0.0,0.0,162532.0,-5427134.0,21000.0,21000.0
2025-07-16,8932,351869,61000,0,3363306,0,75586,45000,0,33521,0,276283,16000,0,3329785,0,13553.0,-606702.0,52000.0,50000.0,0.0,0.0,191522.0,-5188010.0,21000.0,21000.0
2025-07-17,8932,47715,25000,0,1854230,3000,-195835,-3000,0,866230,3000,243550,28000,0,988000,0,-487973.0,-739511.0,49000.0,51000.0,0.0,0.0,1114752.0,-3965824.0,24000.0,24000.0
2025-07-18,8932,75773,30000,0,1610000,1000,32546,-35000,0,-668000,1000,43227,65000,0,2278000,0,-208312.0,-612245.0,0.0,26000.0,0.0,0.0,673752.0,-3948770.0,25000.0,25000.0
2025-07-21,8932,33441,8000,0,838000,0,-74946,-7000,0,207961,0,108387,15000,0,630039,0,-177479.0,-599294.0,3000.0,19000.0,0.0,0.0,749713.0,-3350609.0,25000.0,25000.0
2025-07-22,8932,17904,0,0,1014000,0,-54088,-20000,0,417000,0,71992,20000,0,597000,0,-216737.0,-621439.0,-20000.0,-9000.0,0.0,0.0,856712.0,-1131647.0,4000.0,25000.0
2025-07-23,8932,24425,0,0,740000,0,11780,-1000,0,197000,0,12645,1000,0,543000,0,-280543.0,-620912.0,-66000.0,-12000.0,0.0,0.0,1020191.0,-1374114.0,4000.0,25000.0
2025-07-24,8932,209673,0,0,791000,0,193494,-10000,0,-130000,0,16179,10000,0,921000,0,108786.0,-391863.0,-73000.0,-22000.0,0.0,0.0,23961.0,-1666036.0,1000.0,25000.0
2025-07-25,8932,49336,0,0,2152000,0,-111470,-10000,0,78961,0,160806,10000,0,2073039,0,-35230.0,-532064.0,-48000.0,-32000.0,0.0,0.0,770922.0,-553882.0,0.0,25000.0
2025-07-28,8932,449448,10000,0,1853126,0,387732,-6000,0,-162874,0,61716,16000,0,2016000,0,427448.0,-141333.0,-47000.0,-38000.0,0.0,0.0,400087.0,-899756.0,0.0,25000.0
2025-07-29,8932,31463,1000,0,2188000,3000,-365922,-5000,0,339000,3000,397385,6000,0,1849000,0,115614.0,-421572.0,-32000.0,-46000.0,0.0,0.0,322087.0,-553208.0,3000.0,28000.0
2025-07-30,8932,151135,0,0,1681000,0,84008,-8000,0,-321000,0,67127,8000,0,2002000,0,187842.0,-264961.0,-39000.0,-64000.0,0.0,0.0,-195913.0,1252174.0,3000.0,28000.0
2025-07-31,8932,271392,20000,0,3494000,0,89381,7000,0,1068374,0,182011,13000,0,2425626,0,83729.0,-13457.0,-22000.0,-60000.0,0.0,0.0,1002461.0,3362261.0,3000.0,28000.0
2025-08-01,8932,99004,0,0,1338000,5000,-134701,-2000,0,-114000,5000,233705,2000,0,1452000,0,60498.0,5450.0,-14000.0,-48000.0,0.0,0.0,809500.0,2439018.0,8000.0,33000.0
2025-08-04,8932,157277,0,0,1370000,2000,-116019,-5000,0,497000,2000,273296,5000,0,873000,0,-443253.0,-121664.0,-13000.0,-53000.0,0.0,0.0,1469374.0,2413400.0,10000.0,35000.0
2025-08-05,8932,84618,0,0,1827000,3000,-282466,-3000,0,727000,3000,367084,3000,0,1100000,0,-359797.0,-402380.0,-11000.0,-56000.0,0.0,0.0,1857374.0,3198705.0,10000.0,38000.0
2025-08-06,8932,93548,0,0,1267091,7000,-269751,-1000,0,-75464,7000,363299,1000,0,1342555,0,-713556.0,-792704.0,-4000.0,-57000.0,0.0,0.0,2102910.0,3118710.0,17000.0,45000.0
2025-08-07,8932,3999,0,0,1199000,2000,-144237,-8000,0,518000,2000,148236,8000,0,681000,0,-947174.0,-1242632.0,-19000.0,-65000.0,0.0,0.0,1552536.0,3693710.0,19000.0,47000.0
2025-08-08,8932,18193,30000,0,1523000,0,-46348,30000,0,116000,0,64541,0,0,1407000,0,-858821.0,-1041865.0,13000.0,-49000.0,0.0,0.0,1782536.0,4036710.0,14000.0,47000.0
2025-08-11,8932,21669,0,0,1723000,0,-53098,-55000,0,606839,0,74767,55000,0,1116161,0,-795900.0,-989184.0,-37000.0,-94000.0,0.0,0.0,1892375.0,4511549.0,12000.0,47000.0
2025-08-12,8932,190044,10000,0,1309000,0,181374,10000,0,312681,0,8670,0,0,996319,0,-332060.0,-792980.0,-24000.0,-87000.0,0.0,0.0,1478056.0,4514229.0,9000.0,26000.0
2025-08-13,8932,171539,0,0,1748100,0,15182,0,0,38100,0,156357,0,0,1710000,0,-47127.0,-853384.0,-23000.0,-132000.0,0.0,0.0,1591620.0,4518808.0,2000.0,26000.0
2025-08-14,8932,34093,10000,0,1131000,0,-155512,-15000,0,-287000,0,189605,25000,0,1418000,0,-58402.0,-813061.0,-30000.0,-144000.0,0.0,0.0,786620.0,3365578.0,0.0,23000.0
2025-08-15,8932,74490,0,0,927000,3000,-23129,-30000,0,95000,3000,97619,30000,0,832000,0,-35183.0,-868736.0,-90000.0,-139000.0,0.0,0.0,765620.0,4128578.0,3000.0,25000.0
2025-08-18,8932,258661,0,0,2745676,0,-3386,-19000,0,76676,0,262047,19000,0,2669000,0,14529.0,-797176.0,-54000.0,-151000.0,0.0,0.0,235457.0,3997293.0,3000.0,25000.0
2025-08-19,8932,13015,0,0,1297072,0,-211554,0,0,-401928,0,224569,0,0,1699000,0,-378399.0,-954642.0,-64000.0,-131000.0,0.0,0.0,-479152.0,3178365.0,3000.0,25000.0
2025-08-20,8932,36902,0,0,1224670,0,11163,-2742,0,490670,0,25739,2742,0,734000,0,-382418.0,-955259.0,-66742.0,-132742.0,0.0,0.0,-26582.0,3472035.0,3000.0,25000.0
2025-08-21,8932,237451,3000,0,2032742,0,-295535,2000,0,380742,0,532986,1000,0,1652000,0,-522441.0,-1444288.0,-49742.0,-120742.0,0.0,0.0,641160.0,3982777.0,3000.0,25000.0
2025-08-22,8932,35953,0,0,780000,0,-203530,0,0,-134022,0,239483,0,0,914022,0,-702842.0,-1536348.0,-19742.0,-110742.0,0.0,0.0,412138.0,3769794.0,0.0,25000.0
2025-08-25,8932,120017,0,0,1417423,0,-187294,-1000,0,16423,0,307311,1000,0,1401000,0,-886750.0,-2111374.0,-1742.0,-105742.0,0.0,0.0,351885.0,3949091.0,0.0,25000.0
2025-08-26,8932,100826,0,0,4519414,0,7459,-1000,0,743669,0,93367,1000,0,3775745,0,-667737.0,-1737993.0,-2742.0,-101742.0,0.0,0.0,1497482.0,4353760.0,0.0,22000.0
2025-08-27,8932,45778,0,0,934000,0,-76734,-2000,0,-619341,0,122512,2000,0,1553341,0,-755634.0,-1898735.0,-2000.0,-95742.0,0.0,0.0,387471.0,4055419.0,0.0,22000.0
2025-08-28,8932,21352,0,0,493000,0,-27087,0,0,124206,0,48439,0,0,368794,0,-487186.0,-2015203.0,-4000.0,-102742.0,0.0,0.0,130935.0,3111251.0,0.0,22000.0
2025-08-29,8932,226527,6000,0,2020279,0,-239527,6000,0,550140,0,466054,0,0,1470139,0,-523183.0,-2120029.0,2000.0,-94742.0,0.0,0.0,815097.0,3775391.0,0.0,17000.0
2025-09-01,8932,31151,0,0,1228000,0,-219925,-1000,0,-360720,-7000,251076,1000,0,1588720,7000,-555814.0,-2223935.0,2000.0,-90742.0,0.0,0.0,437954.0,2917671.0,-7000.0,8000.0
2025-09-02,8932,29476,3000,0,2284080,0,-66043,-3000,0,524120,-4000,95519,6000,0,1759960,4000,-629316.0,-2007512.0,0.0,-90742.0,0.0,0.0,218405.0,2714791.0,-11000.0,1000.0
2025-09-03,8932,90534,0,0,937000,0,31629,0,0,-32112,-7000,58905,0,0,969112,7000,-520953.0,-1706132.0,2000.0,-89742.0,0.0,0.0,805634.0,2758143.0,-18000.0,-13000.0
2025-09-04,8932,11885,0,0,554250,0,-81716,0,0,-440778,0,93601,0,0,995028,0,-575582.0,-1643611.0,2000.0,-81742.0,0.0,0.0,240650.0,1799365.0,-18000.0,-15000.0
2025-09-05,8932,196313,5000,0,1869000,0,188614,0,0,1167935,0,7699,5000,0,701065,0,-147441.0,-1408649.0,-4000.0,-111742.0,0.0,0.0,858445.0,2851300.0,-18000.0,-15000.0
2025-09-08,8932,77628,5000,0,804427,0,-72571,5000,0,-949573,0,150199,0,0,1754000,0,-87.0,-1428122.0,2000.0,-51742.0,0.0,0.0,269592.0,1294888.0,-11000.0,-15000.0
2025-09-09,8932,58540,3000,0,1798020,0,-269380,3000,0,-717989,0,327920,0,0,2516009,0,-203424.0,-1878876.0,8000.0,-58742.0,0.0,0.0,-972517.0,264218.0,-7000.0,-15000.0
2025-09-10,8932,20526,0,0,780051,0,-61995,0,0,-799366,0,82521,0,0,1579417,0,-297048.0,-1956053.0,8000.0,-58742.0,0.0,0.0,-1739771.0,-573248.0,0.0,-15000.0
2025-09-11,8932,36127,0,0,1491405,0,-83356,-7000,0,248405,0,119483,7000,0,1243000,0,-298688.0,-1883897.0,1000.0,-50742.0,0.0,0.0,-1050588.0,-37843.0,0.0,-15000.0
2025-09-12,8932,54123,0,0,1722110,0,-17784,0,0,738080,0,71907,0,0,984030,0,-505086.0,-1878552.0,1000.0,-20742.0,0.0,0.0,-1480443.0,605237.0,0.0,-18000.0
2025-09-15,8932,177960,1000,0,1646120,1000,104082,1000,0,659830,1000,73878,0,0,986290,0,-328433.0,-1771084.0,-3000.0,-742.0,0.0,0.0,128960.0,1188391.0,1000.0,-17000.0
2025-09-16,8932,147172,8000,0,1015030,0,121720,8000,0,-961714,0,25452,0,0,1976744,0,62667.0,-1437810.0,2000.0,7258.0,0.0,0.0,-114765.0,628605.0,1000.0,-17000.0
2025-09-17,8932,11174,1000,0,1125000,1000,-56115,1000,0,252000,1000,67289,0,0,873000,0,68547.0,-1505088.0,3000.0,11000.0,0.0,0.0,936601.0,389935.0,2000.0,-16000.0
2025-09-18,8932,24815,0,0,636000,1000,-134025,0,0,-156000,1000,158840,0,0,792000,0,17878.0,-1343578.0,10000.0,9000.0,0.0,0.0,532196.0,-146807.0,3000.0,-15000.0
2025-09-19,8932,6135,0,0,4940005,0,-33061,0,0,-55995,0,39196,0,0,4996000,0,2601.0,-1173109.0,10000.0,9000.0,0.0,0.0,-261879.0,-68780.0,3000.0,-15000.0
