date,stock_id,MarginPurchaseBuy,MarginPurchaseCashRepayment,MarginPurchaseLimit,MarginPurchaseSell,MarginPurchaseTodayBalance,MarginPurchaseYesterdayBalance,Note,OffsetLoanAndShort,ShortSaleBuy,ShortSaleCashRepayment,ShortSaleLimit,ShortSaleSell,ShortSaleTodayBalance,ShortSaleYesterdayBalance,MarginPurchaseTodayBalance_delta,ShortSaleTodayBalance_delta
2024-09-23,2308,81,5,649385,62,3466,3452, ,0,3,0,649385,23,282,262,14,20
2024-09-24,2308,62,1,649385,134,3393,3466, ,0,4,0,649385,20,298,282,-73,16
2024-09-25,2308,186,1,649385,191,3387,3393, ,1,18,0,649385,17,297,298,-6,-1
2024-09-26,2308,282,2,649385,86,3581,3387, ,1,5,0,649385,9,301,297,194,4
2024-09-27,2308,651,23,649385,319,3890,3581, ,1,11,0,649385,27,317,301,309,16
2024-09-30,2308,306,0,649385,328,3868,3890, ,0,78,0,649385,9,248,317,-22,-69
2024-10-01,2308,166,0,649385,208,3826,3868, ,1,32,0,649385,15,231,248,-42,-17
2024-10-04,2308,789,0,649385,283,4332,3826, ,1,87,0,649385,5,149,231,506,-82
2024-10-07,2308,280,5,649385,183,4424,4332, ,11,16,0,649385,13,146,149,92,-3
2024-10-08,2308,82,0,649385,440,4066,4424, ,4,7,0,649385,34,173,146,-358,27
2024-10-09,2308,162,1,649385,147,4080,4066, ,1,8,0,649385,7,172,173,14,-1
2024-10-11,2308,151,0,649385,141,4090,4080, ,0,1,1,649385,2,172,172,10,0
2024-10-14,2308,282,0,649385,281,4091,4090, ,0,1,0,649385,29,200,172,1,28
2024-10-15,2308,814,1,649385,485,4419,4091, ,5,14,0,649385,46,232,200,328,32
2024-10-16,2308,352,0,649385,921,3850,4419, ,0,30,0,649385,8,210,232,-569,-22
2024-10-17,2308,76,0,649385,162,3764,3850, ,0,10,0,649385,5,205,210,-86,-5
2024-10-18,2308,678,0,649385,871,3571,3764, ,0,2,0,649385,56,259,205,-193,54
2024-10-21,2308,170,1,649385,97,3643,3571, ,0,9,0,649385,82,332,259,72,73
2024-10-22,2308,169,0,649385,102,3710,3643, ,0,81,0,649385,20,271,332,67,-61
2024-10-23,2308,147,0,649385,60,3797,3710, ,0,14,0,649385,1,258,271,87,-13
2024-10-24,2308,101,3,649385,101,3794,3797, ,2,18,0,649385,13,253,258,-3,-5
2024-10-25,2308,59,2,649385,137,3714,3794, ,2,1,0,649385,40,292,253,-80,39
2024-10-28,2308,315,0,649385,335,3694,3714, ,1,4,0,649385,15,303,292,-20,11
2024-10-29,2308,132,1,649385,404,3421,3694, ,2,13,0,649385,17,307,303,-273,4
2024-10-30,2308,109,1,649385,176,3353,3421, ,5,7,1,649385,8,307,307,-68,0
2024-11-01,2308,318,1,649385,581,3089,3353, ,8,96,0,649385,8,219,307,-264,-88
2024-11-04,2308,342,0,649385,148,3283,3089, ,3,8,0,649385,5,216,219,194,-3
2024-11-05,2308,26,0,649385,120,3189,3283, ,0,1,0,649385,47,262,216,-94,46
2024-11-06,2308,32,0,649385,88,3133,3189, ,0,2,0,649385,31,291,262,-56,29
2024-11-07,2308,118,0,649385,101,3150,3133, ,0,21,0,649385,2,272,291,17,-19
2024-11-08,2308,217,0,649385,205,3162,3150, ,0,5,0,649385,4,271,272,12,-1
2024-11-11,2308,57,0,649385,44,3175,3162, ,0,0,0,649385,0,271,271,13,0
2024-11-12,2308,338,1,649385,220,3292,3175, ,3,9,0,649385,7,269,271,117,-2
2024-11-13,2308,95,0,649385,61,3326,3292, ,3,71,0,649385,4,202,269,34,-67
2024-11-14,2308,106,0,649385,55,3377,3326, ,2,13,0,649385,12,201,202,51,-1
2024-11-15,2308,79,0,649385,47,3409,3377, ,0,23,0,649385,4,182,201,32,-19
2024-11-18,2308,41,0,649385,25,3425,3409, ,0,2,0,649385,16,196,182,16,14
2024-11-19,2308,87,1,649385,57,3454,3425, ,1,14,0,649385,5,187,196,29,-9
2024-11-20,2308,58,0,649385,30,3482,3454, ,0,1,0,649385,5,191,187,28,4
2024-11-21,2308,498,1,649385,122,3857,3482, ,2,37,0,649385,7,161,191,375,-30
2024-11-22,2308,73,0,649385,674,3256,3857, ,0,5,0,649385,34,190,161,-601,29
2024-11-25,2308,89,0,649385,198,3147,3256, ,0,4,0,649385,2,188,190,-109,-2
2024-11-26,2308,110,0,649385,130,3127,3147, ,1,8,0,649385,4,184,188,-20,-4
2024-11-27,2308,45,5,649385,87,3080,3127, ,0,4,0,649385,34,214,184,-47,30
2024-11-28,2308,52,0,649385,55,3077,3080, ,0,31,0,649385,16,199,214,-3,-15
2024-11-29,2308,84,3,649385,41,3117,3077, ,2,10,0,649385,19,208,199,40,9
2024-12-02,2308,35,1,649385,70,3081,3117, ,0,6,0,649385,32,234,208,-36,26
2024-12-03,2308,53,0,649385,136,2998,3081, ,0,3,0,649385,41,272,234,-83,38
2024-12-04,2308,76,0,649385,62,3012,2998, ,0,13,0,649385,4,263,272,14,-9
2024-12-05,2308,113,0,649385,74,3051,3012, ,0,6,0,649385,8,265,263,39,2
2024-12-06,2308,103,2,649385,295,2857,3051, ,1,3,0,649385,34,296,265,-194,31
2024-12-09,2308,131,1,649385,200,2787,2857, ,0,11,0,649385,25,310,296,-70,14
2024-12-10,2308,40,6,649385,114,2707,2787, ,0,10,0,649385,6,306,310,-80,-4
2024-12-11,2308,439,0,649385,442,2704,2707, ,8,8,0,649385,109,407,306,-3,101
2024-12-12,2308,143,0,649385,296,2551,2704, ,2,22,0,649385,27,412,407,-153,5
2024-12-13,2308,232,0,649385,250,2533,2551, ,8,16,0,649385,63,459,412,-18,47
2024-12-16,2308,169,1,649385,534,2167,2533, ,5,14,0,649385,33,478,459,-366,19
2024-12-17,2308,136,0,649385,331,1972,2167, ,0,49,0,649385,21,450,478,-195,-28
2024-12-18,2308,47,0,649385,90,1929,1972, ,2,10,0,649385,26,466,450,-43,16
2024-12-19,2308,186,0,649385,52,2063,1929, ,0,50,0,649385,4,420,466,134,-46
2024-12-20,2308,59,0,649385,203,1919,2063, ,2,50,0,649385,16,386,420,-144,-34
2024-12-23,2308,65,1,649385,93,1890,1919, ,0,4,10,649385,11,383,386,-29,-3
2024-12-24,2308,67,0,649385,197,1760,1890, ,0,6,0,649385,12,389,383,-130,6
2024-12-25,2308,126,0,649385,60,1826,1760, ,1,6,0,649385,6,389,389,66,0
2024-12-26,2308,39,1,649385,78,1786,1826, ,2,6,0,649385,7,390,389,-40,1
2024-12-27,2308,113,3,649385,84,1812,1786, ,0,7,0,649385,14,397,390,26,7
2024-12-30,2308,99,1,649385,111,1799,1812, ,1,4,0,649385,10,403,397,-13,6
2024-12-31,2308,75,0,649385,50,1824,1799, ,2,8,0,649385,6,401,403,25,-2
2025-01-02,2308,412,0,649385,211,2025,1824, ,1,53,0,649385,9,357,401,201,-44
2025-01-03,2308,124,0,649385,99,2050,2025, ,1,25,0,649385,4,336,357,25,-21
2025-01-06,2308,134,1,649385,32,2151,2050, ,0,8,0,649385,2,330,336,101,-6
2025-01-07,2308,116,0,649385,204,2063,2151, ,2,10,0,649385,65,385,330,-88,55
2025-01-08,2308,161,0,649385,116,2108,2063, ,5,19,0,649385,9,375,385,45,-10
2025-01-09,2308,99,0,649385,74,2133,2108, ,0,51,0,649385,4,328,375,25,-47
2025-01-10,2308,53,0,649385,59,2127,2133, ,0,18,0,649385,1,311,328,-6,-17
2025-01-13,2308,178,0,649385,75,2230,2127, ,1,106,0,649385,4,209,311,103,-102
2025-01-14,2308,66,0,649385,86,2210,2230, ,0,2,0,649385,9,216,209,-20,7
2025-01-15,2308,134,4,649385,21,2319,2210, ,1,15,0,649385,0,201,216,109,-15
2025-01-16,2308,85,2,649385,396,2006,2319, ,7,1,0,649385,69,269,201,-313,68
2025-01-17,2308,39,1,649385,177,1867,2006, ,2,4,0,649385,46,311,269,-139,42
2025-01-20,2308,75,1,649385,83,1858,1867, ,0,71,0,649385,17,257,311,-9,-54
2025-01-21,2308,67,0,649385,15,1910,1858, ,1,17,0,649385,3,243,257,52,-14
2025-01-22,2308,157,6,649385,308,1753,1910, ,5,1,0,649385,65,307,243,-157,64
2025-02-03,2308,608,2,649385,207,2151,1752, ,0,128,0,649385,3,182,307,399,-125
2025-02-04,2308,284,0,649385,91,2344,2151, ,2,3,0,649385,4,183,182,193,1
2025-02-05,2308,90,0,649385,234,2200,2344, ,0,5,0,649385,2,180,183,-144,-3
2025-02-06,2308,64,1,649385,346,1917,2200, ,2,0,0,649385,27,207,180,-283,27
2025-02-07,2308,143,0,649385,34,2026,1917, ,0,15,0,649385,4,196,207,109,-11
2025-02-10,2308,158,0,649385,57,2127,2026, ,0,16,0,649385,1,181,196,101,-15
2025-02-11,2308,171,1,649385,76,2221,2127, ,0,4,0,649385,2,179,181,94,-2
2025-02-12,2308,50,5,649385,45,2221,2221, ,0,2,0,649385,3,180,179,0,1
2025-02-13,2308,85,0,649385,72,2234,2221, ,0,1,0,649385,14,193,180,13,13
2025-02-14,2308,113,1,649385,42,2304,2234, ,3,10,0,649385,1,184,193,70,-9
2025-02-17,2308,74,1,649385,141,2236,2304, ,0,12,0,649385,8,180,184,-68,-4
2025-02-18,2308,1097,1,649385,109,3223,2236, ,2,20,0,649385,8,168,180,987,-12
2025-02-19,2308,201,1,649385,165,3258,3223, ,2,8,0,649385,4,164,168,35,-4
2025-02-20,2308,133,1,649385,77,3313,3258, ,0,1,0,649385,1,164,164,55,0
2025-02-21,2308,298,2,649385,199,3410,3313, ,2,3,0,649385,8,169,164,97,5
2025-02-24,2308,155,2,649385,103,3460,3410, ,2,8,0,649385,2,163,169,50,-6
2025-02-25,2308,96,4,649385,206,3346,3460, ,2,2,0,649385,7,168,163,-114,5
2025-02-26,2308,1326,7,649385,232,4433,3346, ,2,3,0,649385,77,242,168,1087,74
2025-02-27,2308,197,0,649385,868,3762,4433, ,4,66,0,649385,46,222,242,-671,-20
2025-03-03,2308,203,0,649385,378,3587,3762, ,0,60,0,649385,4,166,222,-175,-56
2025-03-04,2308,559,0,649385,191,3955,3587, ,0,42,0,649385,55,179,166,368,13
2025-03-05,2308,136,0,649385,83,4008,3955, ,0,25,0,649385,2,156,179,53,-23
2025-03-06,2308,59,1,649385,278,3788,4008, ,4,2,0,649385,40,194,156,-220,38
2025-03-07,2308,269,5,649385,56,3996,3788, ,0,21,1,649385,3,175,194,208,-19
2025-03-10,2308,24,0,649385,80,3940,3996, ,0,5,0,649385,6,176,175,-56,1
2025-03-11,2308,91,0,649385,205,3826,3940, ,0,54,0,649385,3,125,176,-114,-51
2025-03-12,2308,50,2,649385,357,3517,3826, ,8,4,0,649385,45,166,125,-309,41
2025-03-13,2308,56,1,649385,174,3398,3517, ,3,7,0,649385,47,206,166,-119,40
2025-03-14,2308,219,0,649385,40,3577,3398, ,2,92,5,649385,14,123,206,179,-83
2025-03-17,2308,53,0,649385,296,3334,3577, ,1,26,0,649385,54,151,123,-243,28
2025-03-18,2308,41,0,649385,128,3247,3334, ,3,16,1,649385,20,154,151,-87,3
2025-03-19,2308,184,0,649385,55,3376,3247, ,5,42,0,649385,2,114,154,129,-40
2025-03-20,2308,126,0,649385,80,3422,3376,X ,2,30,2,649385,2,84,114,46,-30
2025-03-21,2308,146,0,649385,43,3525,3422,X ,0,81,1,649385,0,2,84,103,-82
2025-03-24,2308,148,0,649385,467,3206,3525,X ,0,0,2,649385,0,0,2,-319,-2
2025-03-25,2308,108,0,649385,26,3288,3206,X ,0,0,0,649385,0,0,0,82,0
2025-03-26,2308,72,1,649385,256,3103,3288, ,0,0,0,649385,0,0,0,-185,0
2025-03-27,2308,245,0,649385,775,2573,3103, ,5,0,0,649385,48,48,0,-530,48
2025-03-28,2308,301,0,649385,97,2777,2573, ,5,44,0,649385,49,53,48,204,5
2025-03-31,2308,185,3,649385,126,2833,2777, ,5,1,0,649385,139,191,53,56,138
2025-04-01,2308,33,2,649385,79,2786,2834, ,1,110,0,649385,45,126,191,-48,-65
2025-04-02,2308,58,2,649385,47,2795,2786, ,9,48,0,649385,8,86,126,9,-40
2025-04-07,2308,27,18,649385,36,2768,2795, ,0,1,0,649385,2,87,86,-27,1
2025-04-08,2308,475,16,649385,449,2778,2768, ,0,39,0,649385,0,48,87,10,-39
2025-04-09,2308,255,19,649385,753,2261,2778, ,5,13,0,649385,47,82,48,-517,34
2025-04-10,2308,577,8,649385,53,2777,2261, ,0,10,0,649385,1,73,82,516,-9
2025-04-11,2308,313,2,649385,883,2205,2777, ,21,45,0,649385,41,69,73,-572,-4
2025-04-14,2308,385,2,649385,212,2376,2205, ,23,6,0,649385,15,78,69,171,9
2025-04-15,2308,217,8,649385,129,2456,2376, ,8,25,1,649385,14,66,78,80,-12
2025-04-16,2308,202,5,649385,88,2565,2456, ,12,23,1,649385,19,61,66,109,-5
2025-04-17,2308,173,0,649385,42,2696,2565, ,13,26,0,649385,16,51,61,131,-10
2025-04-18,2308,37,3,649385,112,2618,2696, ,9,1,0,649385,13,63,51,-78,12
2025-04-21,2308,128,0,649385,114,2632,2618, ,2,6,0,649385,5,62,63,14,-1
2025-04-22,2308,32,0,649385,58,2606,2632, ,1,9,0,649385,8,61,62,-26,-1
2025-04-23,2308,136,1,649385,226,2515,2606, ,5,11,0,649385,26,76,61,-91,15
2025-04-24,2308,81,0,649385,135,2461,2515, ,2,11,0,649385,12,77,76,-54,1
2025-04-25,2308,181,1,649385,174,2467,2461, ,0,18,0,649385,5,64,77,6,-13
2025-04-28,2308,92,0,649385,276,2283,2467, ,2,0,0,649385,32,96,64,-184,32
2025-04-29,2308,373,1,649385,104,2551,2283, ,1,27,0,649385,3,72,96,268,-24
2025-04-30,2308,169,2,649385,128,2590,2551, ,0,8,0,649385,5,69,72,39,-3
2025-05-02,2308,92,3,649385,511,2168,2590, ,0,2,0,649385,38,105,69,-422,36
2025-05-05,2308,108,0,649385,262,2014,2168, ,3,6,0,649385,38,137,105,-154,32
2025-05-06,2308,82,0,649385,119,1977,2014, ,2,6,0,649385,11,142,137,-37,5
2025-05-07,2308,75,0,649385,145,1907,1977, ,1,6,0,649385,20,156,142,-70,14
2025-05-08,2308,72,0,649385,213,1766,1907, ,4,8,0,649385,22,170,156,-141,14
2025-05-09,2308,90,0,649385,90,1766,1766, ,3,21,0,649385,2,151,170,0,-19
2025-05-12,2308,177,0,649385,83,1860,1766, ,1,15,0,649385,7,143,151,94,-8
2025-05-13,2308,202,1,649385,53,2008,1860, ,0,9,2,649385,4,136,143,148,-7
2025-05-14,2308,84,6,649385,107,1979,2008, ,1,14,0,649385,2,124,136,-29,-12
2025-05-15,2308,51,0,649385,40,1990,1979, ,0,3,0,649385,5,126,124,11,2
2025-05-16,2308,44,0,649385,45,1989,1990, ,0,3,0,649385,10,133,126,-1,7
2025-05-19,2308,93,3,649385,39,2040,1989, ,0,15,0,649385,2,120,133,51,-13
2025-05-20,2308,31,0,649385,23,2048,2040, ,0,3,0,649385,13,130,120,8,10
2025-05-21,2308,39,0,649385,254,1833,2048, ,2,9,0,649385,30,151,130,-215,21
2025-05-22,2308,98,1,649385,95,1835,1833, ,1,4,0,649385,0,147,151,2,-4
2025-05-23,2308,135,0,649385,61,1909,1835, ,2,13,1,649385,12,145,147,74,-2
2025-05-26,2308,63,0,649385,29,1943,1909, ,0,6,0,649385,3,142,145,34,-3
2025-05-27,2308,66,10,649385,15,1984,1943, ,0,9,0,649385,22,155,142,41,13
2025-05-28,2308,34,0,649385,31,1987,1984, ,0,1,0,649385,3,157,155,3,2
2025-05-29,2308,80,5,649385,232,1830,1987, ,2,24,0,649385,19,152,157,-157,-5
2025-06-02,2308,90,0,649385,34,1886,1830, ,0,24,0,649385,6,134,152,56,-18
2025-06-03,2308,233,3,649385,229,1887,1886, ,1,11,0,649385,25,148,134,1,14
2025-06-04,2308,828,0,649385,150,2565,1887, ,0,8,0,649385,9,149,148,678,1
2025-06-05,2308,136,0,649385,412,2289,2565, ,2,12,0,649385,34,171,149,-276,22
2025-06-06,2308,240,0,649385,39,2490,2289, ,0,21,0,649385,21,171,171,201,0
2025-06-09,2308,129,0,649385,143,2476,2490, ,1,18,1,649385,9,161,171,-14,-10
2025-06-10,2308,255,0,649385,204,2527,2476,X ,1,50,3,649385,14,122,161,51,-39
2025-06-11,2308,53,0,649385,467,2113,2527,X ,0,99,1,649385,0,22,122,-414,-100
2025-06-12,2308,44,0,649385,180,1977,2113,X ,0,0,22,649385,0,0,22,-136,-22
2025-06-13,2308,18,1,649385,115,1879,1977,X ,0,0,0,649385,0,0,0,-98,0
2025-06-16,2308,109,2,649385,118,1868,1879, ,0,0,0,649385,0,0,0,-11,0
2025-06-17,2308,72,1,649385,74,1865,1868, ,0,0,0,649385,30,30,0,-3,30
2025-06-18,2308,113,0,649385,97,1881,1865, ,2,1,0,649385,25,54,30,16,24
2025-06-19,2308,372,0,649385,152,2101,1881, ,0,2,0,649385,40,92,54,220,38
2025-06-20,2308,110,0,649385,103,2108,2101, ,1,10,0,649385,12,94,92,7,2
2025-06-23,2308,25,0,649385,100,2033,2108, ,1,3,0,649385,10,101,94,-75,7
2025-06-24,2308,375,0,649385,375,2033,2033, ,3,7,0,649385,76,170,101,0,69
2025-06-25,2308,276,0,649385,245,2064,2033, ,2,8,0,649385,25,187,170,31,17
2025-06-26,2308,109,0,649385,264,1909,2064, ,0,10,0,649385,7,184,187,-155,-3
2025-06-27,2308,57,1,649385,128,1837,1909, ,0,5,0,649385,26,205,184,-72,21
2025-06-30,2308,127,3,649385,87,1874,1837, ,0,6,0,649385,8,207,205,37,2
2025-07-01,2308,115,0,649385,152,1837,1874, ,5,14,0,649385,46,239,207,-37,32
2025-07-02,2308,119,1,649385,41,1914,1837, ,5,6,0,649385,30,263,239,77,24
2025-07-03,2308,248,0,649385,189,1973,1914, ,3,0,10,649385,134,387,263,59,124
2025-07-04,2308,176,0,649385,197,1952,1973, ,2,16,0,649385,14,385,387,-21,-2
2025-07-07,2308,135,0,649385,262,1825,1952, ,2,21,0,649385,24,388,385,-127,3
2025-07-08,2308,131,0,649385,77,1879,1825, ,2,11,0,649385,9,386,388,54,-2
2025-07-09,2308,86,2,649385,148,1815,1879, ,30,16,0,649385,19,389,386,-64,3
2025-07-10,2308,371,8,649385,286,1892,1815, ,7,28,0,649385,114,475,389,77,86
2025-07-11,2308,327,2,649385,201,2016,1892, ,0,16,0,649385,29,488,475,124,13
2025-07-14,2308,189,1,649385,151,2053,2016, ,5,35,0,649385,9,462,488,37,-26
2025-07-15,2308,299,0,649385,264,2088,2053, ,3,9,0,649385,44,497,462,35,35
2025-07-16,2308,322,0,649385,317,2093,2088, ,3,16,0,649385,28,509,497,5,12
2025-07-17,2308,133,0,649385,138,2088,2093, ,0,12,0,649385,9,506,509,-5,-3
2025-07-18,2308,79,1,649385,265,1901,2088, ,0,2,0,649385,15,519,506,-187,13
2025-07-21,2308,153,0,649385,267,1787,1901, ,0,3,0,649385,18,534,519,-114,15
2025-07-22,2308,386,2,649385,215,1956,1787, ,6,14,0,649385,23,543,534,169,9
2025-07-23,2308,249,0,649385,266,1939,1956, ,3,6,0,649385,16,553,543,-17,10
2025-07-24,2308,197,0,649385,218,1918,1939, ,3,17,0,649385,12,548,553,-21,-5
2025-07-25,2308,25,1,649385,120,1822,1918, ,1,4,0,649385,9,553,548,-96,5
2025-07-28,2308,270,0,649385,167,1925,1822, ,0,5,0,649385,15,563,553,103,10
2025-07-29,2308,104,0,649385,157,1872,1925, ,0,4,0,649385,14,573,563,-53,10
2025-07-30,2308,79,1,649385,126,1824,1872, ,2,2,0,649385,13,584,573,-48,11
2025-07-31,2308,386,9,649385,244,1957,1824, ,2,26,0,649385,32,590,584,133,6
2025-08-01,2308,561,1,649385,243,2274,1957, ,2,16,0,649385,33,607,590,317,17
2025-08-04,2308,156,1,649385,269,2160,2274, ,3,4,5,649385,43,641,607,-114,34
2025-08-05,2308,882,0,649385,242,2800,2160, ,9,54,0,649385,122,709,641,640,68
2025-08-06,2308,425,2,649385,690,2533,2800, ,10,40,0,649385,67,736,709,-267,27
2025-08-07,2308,413,0,649385,292,2654,2533, ,0,62,0,649385,4,678,736,121,-58
2025-08-08,2308,409,0,649385,320,2743,2654, ,3,9,2,649385,63,730,678,89,52
2025-08-11,2308,252,8,649385,344,2643,2743, ,2,18,0,649385,26,738,730,-100,8
2025-08-12,2308,246,101,649385,288,2500,2643, ,1,14,0,649385,14,738,738,-143,0
2025-08-13,2308,614,2,649385,384,2728,2500, ,15,43,0,649385,61,756,738,228,18
2025-08-14,2308,404,3,649385,428,2701,2728, ,3,26,1,649385,20,749,756,-27,-7
2025-08-15,2308,595,0,649385,393,2903,2701, ,8,22,0,649385,60,787,749,202,38
2025-08-18,2308,346,4,649385,386,2859,2903, ,0,11,0,649385,14,790,787,-44,3
2025-08-19,2308,408,0,649385,570,2697,2859, ,6,79,0,649385,17,728,790,-162,-62
2025-08-20,2308,326,1,649385,439,2583,2697, ,5,109,0,649385,18,637,728,-114,-91
2025-08-21,2308,401,52,649385,249,2683,2583, ,16,11,0,649385,55,681,637,100,44
2025-08-22,2308,268,0,649385,394,2557,2683, ,4,0,0,649385,30,711,681,-126,30
2025-08-25,2308,406,1,649385,263,2699,2557, ,4,6,0,649385,14,719,711,142,8
2025-08-26,2308,414,0,649385,267,2846,2699, ,0,5,0,649385,31,745,719,147,26
2025-08-27,2308,2050,2,649385,352,4542,2846, ,6,100,0,649385,89,734,745,1696,-11
2025-08-28,2308,536,1,649385,251,4826,4542, ,2,33,0,649385,8,709,734,284,-25
2025-08-29,2308,246,93,649385,338,4641,4826, ,1,5,0,649385,19,723,709,-185,14
2025-09-01,2308,364,32,649385,2314,2659,4641, ,9,67,0,649385,17,673,723,-1982,-50
2025-09-02,2308,277,0,649385,257,2679,2659, ,7,17,0,649385,10,666,673,20,-7
2025-09-03,2308,188,0,649385,163,2704,2679, ,1,18,0,649385,7,655,666,25,-11
2025-09-04,2308,334,4,649385,325,2709,2704, ,3,23,0,649385,21,653,655,5,-2
2025-09-05,2308,622,0,649385,461,2870,2709, ,4,14,0,649385,77,716,653,161,63
2025-09-08,2308,496,1,649385,294,3071,2870, ,2,19,0,649385,15,712,716,201,-4
2025-09-09,2308,1171,2,649385,479,3761,3071, ,23,27,1,649385,213,897,712,690,185
2025-09-10,2308,1100,9,649385,586,4266,3761, ,17,96,3,649385,105,903,897,505,6
2025-09-11,2308,605,1,649385,1050,3820,4266, ,15,22,0,649385,78,959,903,-446,56
2025-09-12,2308,583,0,649385,375,4028,3820, ,8,19,1,649385,28,967,959,208,8
2025-09-15,2308,364,1,649385,516,3875,4028, ,2,27,0,649385,17,957,967,-153,-10
2025-09-16,2308,258,1,649385,345,3787,3875, ,4,40,0,649385,28,945,957,-88,-12
2025-09-17,2308,380,1,649385,227,3939,3787, ,1,30,0,649385,26,941,945,152,-4
2025-09-18,2308,1209,2,649385,518,4628,3939, ,4,81,0,649385,113,973,941,689,32
2025-09-19,2308,662,1,649385,536,4753,4628, ,5,43,2,649385,8,936,973,125,-37
2024-09-23,2344,862,1,1125000,565,56591,56295, ,0,49,0,1125000,30,882,901,296,-19
2024-09-24,2344,1906,24,1125000,1222,57251,56591, ,3,57,1,1125000,40,864,882,660,-18
2024-09-25,2344,1344,6,1125000,1515,57074,57251, ,80,76,3,1125000,56,841,864,-177,-23
2024-09-26,2344,4311,14,1125000,1296,60075,57074, ,6,133,0,1125000,63,771,841,3001,-70
2024-09-27,2344,1150,37,1125000,3821,57367,60075, ,2,48,0,1125000,69,792,771,-2708,21
2024-09-30,2344,987,3,1125000,1982,56369,57367, ,11,244,0,1125000,36,584,792,-998,-208
2024-10-01,2344,1402,10,1125000,1662,56099,56369, ,2,72,0,1125000,32,544,584,-270,-40
2024-10-04,2344,880,0,1125000,255,56724,56099, ,0,17,0,1125000,45,572,544,625,28
2024-10-07,2344,964,32,1125000,559,57097,56724, ,0,69,0,1125000,19,522,572,373,-50
2024-10-08,2344,1131,20,1125000,555,57653,57097, ,0,33,0,1125000,143,632,522,556,110
2024-10-09,2344,1211,53,1125000,287,58524,57653, ,0,19,0,1125000,37,650,632,871,18
2024-10-11,2344,1632,21,1125000,745,59390,58524, ,1,76,0,1125000,64,638,650,866,-12
2024-10-14,2344,611,88,1125000,752,59161,59390, ,0,78,0,1125000,4,564,638,-229,-74
2024-10-15,2344,363,35,1125000,1195,58294,59161, ,3,60,0,1125000,16,520,564,-867,-44
2024-10-16,2344,1323,102,1125000,239,59276,58294, ,0,17,0,1125000,960,1463,520,982,943
2024-10-17,2344,529,2,1125000,603,59200,59276, ,1,14,1,1125000,826,2274,1463,-76,811
2024-10-18,2344,745,9,1125000,476,59460,59200, ,0,130,150,1125000,8,2002,2274,260,-272
2024-10-21,2344,1024,31,1125000,856,59597,59460, ,2,4,515,1125000,14,1497,2002,137,-505
2024-10-22,2344,1717,6,1125000,190,61118,59597, ,0,22,151,1125000,0,1324,1497,1521,-173
2024-10-23,2344,263,6,1125000,330,61045,61118, ,2,1,40,1125000,17,1300,1324,-73,-24
2024-10-24,2344,1066,3,1125000,894,61214,61045, ,1,21,20,1125000,257,1516,1300,169,216
2024-10-25,2344,1235,82,1125000,1294,61073,61214, ,0,214,0,1125000,81,1383,1516,-141,-133
2024-10-28,2344,519,0,1125000,993,60599,61073, ,3,18,220,1125000,16,1161,1383,-474,-222
2024-10-29,2344,1037,36,1125000,1390,60210,60599, ,10,30,483,1125000,2,650,1161,-389,-511
2024-10-30,2344,382,40,1125000,1643,58909,60210, ,8,124,20,1125000,84,590,650,-1301,-60
2024-11-01,2344,746,58,1125000,1080,58517,58909, ,17,143,0,1125000,36,483,590,-392,-107
2024-11-04,2344,587,15,1125000,403,58686,58517, ,0,13,0,1125000,73,543,483,169,60
2024-11-05,2344,708,1,1125000,172,59221,58686, ,1,77,0,1125000,1135,1601,543,535,1058
2024-11-06,2344,1212,2,1125000,655,59776,59221, ,1,1109,0,1125000,16,508,1601,555,-1093
2024-11-07,2344,1856,20,1125000,2094,59518,59776, ,20,70,0,1125000,746,1184,508,-258,676
2024-11-08,2344,1164,30,1125000,812,59840,59518, ,6,25,0,1125000,649,1808,1184,322,624
2024-11-11,2344,944,15,1125000,934,59835,59840, ,1,7,0,1125000,466,2267,1808,-5,459
2024-11-12,2344,1087,32,1125000,1773,59117,59835, ,1,35,0,1125000,440,2672,2267,-718,405
2024-11-13,2344,1609,7,1125000,1299,59420,59117, ,2,135,0,1125000,143,2680,2672,303,8
2024-11-14,2344,1435,27,1125000,1602,59226,59420, ,0,31,0,1125000,309,2958,2680,-194,278
2024-11-15,2344,453,60,1125000,813,58806,59226, ,2,56,0,1125000,69,2971,2958,-420,13
2024-11-18,2344,753,78,1125000,455,59026,58806, ,1,42,0,1125000,59,2988,2971,220,17
2024-11-19,2344,518,19,1125000,770,58755,59026, ,3,14,0,1125000,80,3054,2988,-271,66
2024-11-20,2344,533,14,1125000,538,58736,58755, ,12,32,0,1125000,233,3255,3054,-19,201
2024-11-21,2344,665,24,1125000,282,59095,58736, ,9,74,0,1125000,144,3325,3255,359,70
2024-11-22,2344,166,2,1125000,583,58676,59095, ,2,5,0,1125000,167,3487,3325,-419,162
2024-11-25,2344,1725,19,1125000,266,60116,58676, ,0,2958,0,1125000,11,540,3487,1440,-2947
2024-11-26,2344,1719,1,1125000,400,61434,60116, ,0,75,0,1125000,50,515,540,1318,-25
2024-11-27,2344,2894,43,1125000,4311,59974,61434, ,7,6,0,1125000,479,988,515,-1460,473
2024-11-28,2344,2594,88,1125000,2692,59788,59974, ,1,429,0,1125000,220,779,988,-186,-209
2024-11-29,2344,691,60,1125000,985,59434,59788, ,8,111,0,1125000,51,719,779,-354,-60
2024-12-02,2344,1528,37,1125000,843,60082,59434, ,0,30,0,1125000,395,1084,719,648,365
2024-12-03,2344,814,31,1125000,396,60469,60082, ,6,46,0,1125000,49,1087,1084,387,3
2024-12-04,2344,1678,12,1125000,366,61769,60469, ,5,141,0,1125000,71,1017,1087,1300,-70
2024-12-05,2344,788,14,1125000,545,61998,61769, ,0,42,0,1125000,41,1016,1017,229,-1
2024-12-06,2344,3404,4,1125000,2201,63197,61998, ,21,399,0,1125000,350,967,1016,1199,-49
2024-12-09,2344,1071,1,1125000,408,63859,63197, ,0,68,0,1125000,1,900,967,662,-67
2024-12-10,2344,866,33,1125000,744,63948,63859, ,5,80,0,1125000,7,827,900,89,-73
2024-12-11,2344,2443,53,1125000,2906,63432,63948, ,20,37,0,1125000,429,1219,827,-516,392
2024-12-12,2344,1511,59,1125000,1225,63659,63432, ,27,258,0,1125000,107,1068,1219,227,-151
2024-12-13,2344,670,61,1125000,1983,62285,63659, ,23,394,0,1125000,124,798,1068,-1374,-270
2024-12-16,2344,2587,143,1125000,4347,60382,62285, ,22,115,0,1125000,106,789,798,-1903,-9
2024-12-17,2344,2089,229,1125000,1958,60284,60382, ,3,129,0,1125000,400,1060,789,-98,271
2024-12-18,2344,2053,63,1125000,2363,59911,60284, ,8,121,0,1125000,462,1401,1060,-373,341
2024-12-19,2344,1557,61,1125000,2252,59155,59911, ,27,293,20,1125000,140,1228,1401,-756,-173
2024-12-20,2344,2048,2,1125000,1146,60055,59155, ,5,463,0,1125000,396,1161,1228,900,-67
2024-12-23,2344,513,1,1125000,1010,59557,60055, ,0,3,0,1125000,45,1203,1161,-498,42
2024-12-24,2344,2760,4,1125000,1495,60818,59557, ,11,426,0,1125000,295,1072,1203,1261,-131
2024-12-25,2344,506,1,1125000,336,60987,60818, ,32,214,0,1125000,583,1441,1072,169,369
2024-12-26,2344,399,80,1125000,244,61062,60987, ,0,598,0,1125000,18,861,1441,75,-580
2024-12-27,2344,660,28,1125000,2327,59367,61062, ,0,78,0,1125000,197,980,861,-1695,119
2024-12-30,2344,408,8,1125000,291,59476,59367, ,0,201,0,1125000,19,798,980,109,-182
2024-12-31,2344,702,18,1125000,690,59470,59476, ,0,146,0,1125000,264,916,798,-6,118
2025-01-02,2344,911,10,1125000,941,59430,59470, ,12,90,0,1125000,187,1013,916,-40,97
2025-01-03,2344,819,77,1125000,1222,58950,59430, ,1,8,0,1125000,96,1101,1013,-480,88
2025-01-06,2344,528,5,1125000,941,58532,58950, ,3,148,0,1125000,158,1111,1101,-418,10
2025-01-07,2344,1106,29,1125000,802,58807,58532, ,7,393,0,1125000,93,811,1111,275,-300
2025-01-08,2344,425,2,1125000,608,58622,58807, ,2,59,0,1125000,34,786,811,-185,-25
2025-01-09,2344,2235,58,1125000,3141,57658,58622, ,36,93,0,1125000,1014,1707,786,-964,921
2025-01-10,2344,307,102,1125000,1167,56696,57658, ,4,773,0,1125000,183,1117,1707,-962,-590
2025-01-13,2344,1642,141,1125000,4663,53534,56696, ,5,250,0,1125000,244,1111,1117,-3162,-6
2025-01-14,2344,355,151,1125000,601,53137,53534, ,3,211,0,1125000,183,1083,1111,-397,-28
2025-01-15,2344,992,127,1125000,322,53680,53137, ,18,120,0,1125000,105,1068,1083,543,-15
2025-01-16,2344,1326,7,1125000,1424,53575,53680, ,111,225,0,1125000,98,941,1068,-105,-127
2025-01-17,2344,294,7,1125000,614,53248,53575, ,21,12,0,1125000,24,953,941,-327,12
2025-01-20,2344,1098,22,1125000,322,54002,53248, ,6,44,0,1125000,2,911,953,754,-42
2025-01-21,2344,298,95,1125000,675,53530,54002, ,0,120,0,1125000,28,819,911,-472,-92
2025-01-22,2344,270,57,1125000,746,52997,53530, ,0,37,0,1125000,44,826,819,-533,7
2025-02-03,2344,706,23,1125000,941,52700,52958, ,29,46,0,1125000,80,860,826,-258,34
2025-02-04,2344,651,11,1125000,333,53007,52700, ,1,60,0,1125000,41,841,860,307,-19
2025-02-05,2344,973,14,1125000,681,53285,53007, ,3,6,0,1125000,16,851,841,278,10
2025-02-06,2344,471,22,1125000,482,53252,53285, ,1,0,0,1125000,419,1270,851,-33,419
2025-02-07,2344,778,20,1125000,272,53738,53252, ,1,38,0,1125000,4,1236,1270,486,-34
2025-02-10,2344,879,9,1125000,407,54201,53738, ,4,55,0,1125000,3,1184,1236,463,-52
2025-02-11,2344,535,1,1125000,258,54477,54201, ,3,1,0,1125000,2,1185,1184,276,1
2025-02-12,2344,1439,3,1125000,893,55020,54477, ,8,11,0,1125000,83,1257,1185,543,72
2025-02-13,2344,10502,0,1125000,3742,61780,55020, ,52,56,0,1125000,586,1787,1257,6760,530
2025-02-14,2344,29319,0,1125000,7941,83158,61780, ,680,1111,0,1125000,1206,1882,1787,21378,95
2025-02-17,2344,28931,13,1125000,16811,95265,83158, ,406,164,0,1125000,2286,4004,1882,12107,2122
2025-02-18,2344,25633,0,1125000,8110,112788,95265, ,355,477,0,1125000,1399,4926,4004,17523,922
2025-02-19,2344,34254,25,1125000,12786,134231,112788, ,450,733,1,1125000,1166,5358,4926,21443,432
2025-02-20,2344,20836,1,1125000,30777,124289,134231, ,323,1966,0,1125000,1197,4589,5358,-9942,-769
2025-02-21,2344,13389,11,1125000,11866,125801,124289, ,272,767,1,1125000,1091,4912,4589,1512,323
2025-02-24,2344,3520,23,1125000,7813,121485,125801, ,114,668,0,1125000,520,4764,4912,-4316,-148
2025-02-25,2344,11181,100,1125000,12893,119673,121485, ,262,960,0,1125000,707,4511,4764,-1812,-253
2025-02-26,2344,6199,10,1125000,15592,110270,119673, ,72,621,0,1125000,190,4080,4511,-9403,-431
2025-02-27,2344,3046,0,1125000,8497,104819,110270, ,80,435,0,1125000,289,3934,4080,-5451,-146
2025-03-03,2344,1821,15,1125000,9799,96826,104819, ,32,282,0,1125000,595,4247,3934,-7993,313
2025-03-04,2344,2677,20,1125000,2622,96861,96826, ,9,902,10,1125000,118,3453,4247,35,-794
2025-03-05,2344,8029,0,1125000,2361,102529,96861, ,63,243,0,1125000,367,3577,3453,5668,124
2025-03-06,2344,3958,4,1125000,2887,103596,102529, ,107,651,0,1125000,47,2973,3577,1067,-604
2025-03-07,2344,5996,2,1125000,3060,106530,103596, ,169,129,0,1125000,235,3079,2973,2934,106
2025-03-10,2344,35986,155,1125000,10884,131477,106530, ,368,126,2,1125000,537,3488,3079,24947,409
2025-03-11,2344,7454,81,1125000,15602,123248,131477, ,169,697,0,1125000,286,3077,3488,-8229,-411
2025-03-12,2344,15596,1,1125000,15340,123503,123248, ,369,227,7,1125000,4073,6916,3077,255,3839
2025-03-13,2344,20996,2,1125000,16222,128275,123503, ,651,2270,1,1125000,1252,5897,6916,4772,-1019
2025-03-14,2344,9832,8,1125000,19823,118276,128275, ,316,943,0,1125000,599,5553,5897,-9999,-344
2025-03-17,2344,8151,5,1125000,11795,114627,118276, ,60,1427,47,1125000,67,4146,5553,-3649,-1407
2025-03-18,2344,4225,8,1125000,8680,110164,114627, ,63,625,2,1125000,152,3671,4146,-4463,-475
2025-03-19,2344,8636,2,1125000,7269,111529,110164, ,262,812,0,1125000,229,3088,3671,1365,-583
2025-03-20,2344,14951,13,1125000,7477,118990,111529,X ,245,671,4,1125000,223,2636,3088,7461,-452
2025-03-21,2344,7056,25,1125000,9703,116318,118990,X ,0,2583,21,1125000,0,32,2636,-2672,-2604
2025-03-24,2344,8201,3,1125000,11918,112598,116318,X ,0,0,32,1125000,0,0,32,-3720,-32
2025-03-25,2344,3285,3,1125000,12797,103083,112598,X ,0,0,0,1125000,0,0,0,-9515,0
2025-03-26,2344,4667,0,1125000,4269,103481,103083, ,0,0,0,1125000,0,0,0,398,0
2025-03-27,2344,1988,16,1125000,3697,101756,103481, ,1315,0,0,1125000,370,370,0,-1725,370
2025-03-28,2344,2568,54,1125000,6126,98144,101756, ,1577,159,0,1125000,247,458,370,-3612,88
2025-03-31,2344,3149,121,1125000,9054,92118,98144, ,102,116,0,1125000,1393,1735,458,-6026,1277
2025-04-01,2344,2941,99,1125000,2135,92825,92118, ,27,205,0,1125000,169,1699,1735,707,-36
2025-04-02,2344,2393,58,1125000,4854,90306,92825, ,47,1081,0,1125000,766,1384,1699,-2519,-315
2025-04-07,2344,392,557,1125000,1000,89141,90306, ,0,145,0,1125000,1361,2600,1384,-1165,1216
2025-04-08,2344,5027,444,1125000,24538,69176,89131, ,0,1822,0,1125000,792,1570,2600,-19955,-1030
2025-04-09,2344,5555,216,1125000,17046,57469,69176, ,0,93,0,1125000,0,1477,1570,-11707,-93
2025-04-10,2344,8002,754,1125000,1079,63638,57469, ,0,185,5,1125000,18,1305,1477,6169,-172
2025-04-11,2344,2624,127,1125000,6599,59536,63638, ,119,63,0,1125000,742,1984,1305,-4102,679
2025-04-14,2344,2686,46,1125000,3365,58811,59536, ,51,396,0,1125000,325,1913,1984,-725,-71
2025-04-15,2344,1558,2,1125000,2427,57940,58811, ,9,75,0,1125000,206,2044,1913,-871,131
2025-04-16,2344,2784,1,1125000,1420,59303,57940, ,8,294,0,1125000,161,1911,2044,1363,-133
2025-04-17,2344,1930,1,1125000,715,60517,59303, ,19,141,0,1125000,369,2139,1911,1214,228
2025-04-18,2344,5551,28,1125000,2571,63469,60517, ,90,63,1,1125000,372,2447,2139,2952,308
2025-04-21,2344,5879,10,1125000,9126,60212,63469, ,102,146,2,1125000,706,3005,2447,-3257,558
2025-04-22,2344,6624,14,1125000,9410,57412,60212, ,170,249,0,1125000,367,3123,3005,-2800,118
2025-04-23,2344,4142,14,1125000,3530,58010,57412, ,81,232,0,1125000,2746,5637,3123,598,2514
2025-04-24,2344,2145,12,1125000,2230,57913,58010, ,37,3573,0,1125000,64,2128,5637,-97,-3509
2025-04-25,2344,1283,9,1125000,5419,53768,57913, ,31,107,0,1125000,78,2099,2128,-4145,-29
2025-04-28,2344,2423,4,1125000,1123,55064,53768, ,6,80,0,1125000,33,2052,2099,1296,-47
2025-04-29,2344,1583,11,1125000,2278,54358,55064, ,3,64,0,1125000,135,2123,2052,-706,71
2025-04-30,2344,2615,31,1125000,2178,54764,54358, ,102,103,0,1125000,214,2234,2123,406,111
2025-05-02,2344,1530,2,1125000,2914,53378,54764, ,222,19,0,1125000,216,2431,2234,-1386,197
2025-05-05,2344,3149,212,1125000,2100,54215,53378, ,21,534,0,1125000,42,1939,2431,837,-492
2025-05-06,2344,479,24,1125000,1707,52963,54215, ,12,63,0,1125000,84,1960,1939,-1252,21
2025-05-07,2344,1082,0,1125000,1632,52413,52963, ,1,17,0,1125000,16,1959,1960,-550,-1
2025-05-08,2344,2328,7,1125000,1442,53292,52413, ,14,11,0,1125000,21,1969,1959,879,10
2025-05-09,2344,889,4,1125000,942,53235,53292, ,6,30,0,1125000,6,1945,1969,-57,-24
2025-05-12,2344,4162,15,1125000,6830,50552,53235, ,33,21,0,1125000,569,2493,1945,-2683,548
2025-05-13,2344,8900,31,1125000,8413,51008,50552, ,274,360,0,1125000,1967,4100,2493,456,1607
2025-05-14,2344,10706,16,1125000,5600,56098,51008, ,163,203,0,1125000,421,4318,4100,5090,218
2025-05-15,2344,5750,22,1125000,8311,53515,56098, ,61,305,60,1125000,67,4020,4318,-2583,-298
2025-05-16,2344,3998,1,1125000,1474,56038,53515, ,46,707,0,1125000,412,3725,4020,2523,-295
2025-05-19,2344,1691,45,1125000,3169,54515,56038, ,7,125,0,1125000,54,3654,3725,-1523,-71
2025-05-20,2344,6653,23,1125000,6814,54331,54515, ,59,285,6,1125000,665,4028,3654,-184,374
2025-05-21,2344,4971,8,1125000,4139,55155,54331, ,36,549,0,1125000,133,3612,4028,824,-416
2025-05-22,2344,2751,189,1125000,2115,55602,55155, ,14,451,0,1125000,51,3212,3612,447,-400
2025-05-23,2344,1448,2,1125000,2232,54816,55602, ,27,457,4,1125000,47,2798,3212,-786,-414
2025-05-26,2344,1891,9,1125000,2015,54683,54816, ,6,271,0,1125000,142,2669,2798,-133,-129
2025-05-27,2344,1770,2,1125000,1568,54883,54683, ,5,179,0,1125000,214,2704,2669,200,35
2025-05-28,2344,3381,1,1125000,2420,55843,54883, ,66,469,0,1125000,51,2286,2704,960,-418
2025-05-29,2344,2294,13,1125000,2537,55587,55843, ,24,79,60,1125000,264,2411,2286,-256,125
2025-06-02,2344,2378,23,1125000,2008,55934,55587, ,8,414,0,1125000,46,2043,2411,347,-368
2025-06-03,2344,1669,3,1125000,1099,56501,55934, ,20,132,0,1125000,21,1932,2043,567,-111
2025-06-04,2344,3022,15,1125000,4065,55443,56501, ,83,36,0,1125000,829,2725,1932,-1058,793
2025-06-05,2344,5253,11,1125000,7416,53269,55443, ,98,226,0,1125000,552,3051,2725,-2174,326
2025-06-06,2344,1803,4,1125000,3137,51931,53269, ,8,103,0,1125000,347,3295,3051,-1338,244
2025-06-09,2344,4179,4,1125000,2802,53304,51931, ,29,86,4,1125000,193,3398,3295,1373,103
2025-06-10,2344,5040,5,1125000,4642,53697,53304, ,70,127,2,1125000,376,3645,3398,393,247
2025-06-11,2344,2199,17,1125000,5151,50728,53697, ,9,93,2,1125000,77,3627,3645,-2969,-18
2025-06-12,2344,1238,19,1125000,3096,48851,50728, ,6,63,4,1125000,82,3642,3627,-1877,15
2025-06-13,2344,3127,8,1125000,1485,50485,48851, ,17,427,0,1125000,164,3379,3642,1634,-263
2025-06-16,2344,2184,39,1125000,3332,49298,50485, ,23,93,0,1125000,309,3595,3379,-1187,216
2025-06-17,2344,3077,5,1125000,5084,47286,49298, ,49,25,3,1125000,316,3883,3595,-2012,288
2025-06-18,2344,14470,272,1125000,7572,53912,47286, ,227,391,33,1125000,2806,6265,3883,6626,2382
2025-06-19,2344,6671,6,1125000,5909,54668,53912, ,58,1864,10,1125000,218,4609,6265,756,-1656
2025-06-20,2344,5869,56,1125000,4415,56066,54668, ,53,1056,0,1125000,250,3803,4609,1398,-806
2025-06-23,2344,2488,17,1125000,6517,52020,56066, ,97,393,2,1125000,854,4262,3803,-4046,459
2025-06-24,2344,9557,85,1125000,9334,52158,52020, ,446,477,2,1125000,2432,6215,4262,138,1953
2025-06-25,2344,4422,7,1125000,4894,51679,52158, ,331,90,0,1125000,503,6628,6215,-479,413
2025-06-26,2344,6445,23,1125000,8948,49153,51679, ,403,196,0,1125000,743,7175,6628,-2526,547
2025-06-27,2344,5698,15,1125000,4502,50334,49153, ,124,1794,2,1125000,569,5948,7175,1181,-1227
2025-06-30,2344,3809,15,1125000,6282,47846,50334, ,102,829,3,1125000,339,5455,5948,-2488,-493
2025-07-01,2344,2700,71,1125000,2621,47854,47846, ,102,994,3,1125000,342,4800,5455,8,-655
2025-07-02,2344,4560,60,1125000,1265,51089,47854, ,38,556,5,1125000,118,4357,4800,3235,-443
2025-07-03,2344,1239,29,1125000,1726,50573,51089, ,15,136,0,1125000,722,4943,4357,-516,586
2025-07-04,2344,2475,17,1125000,2675,50356,50573, ,29,1139,0,1125000,128,3932,4943,-217,-1011
2025-07-07,2344,692,11,1125000,696,50341,50356, ,39,126,0,1125000,1122,4928,3932,-15,996
2025-07-08,2344,1303,13,1125000,1786,49845,50341, ,9,1276,3,1125000,101,3750,4928,-496,-1178
2025-07-09,2344,475,28,1125000,930,49362,49845, ,2,150,0,1125000,53,3653,3750,-483,-97
2025-07-10,2344,1601,0,1125000,3497,47466,49362, ,8,346,0,1125000,37,3344,3653,-1896,-309
2025-07-11,2344,629,20,1125000,3163,44912,47466, ,139,365,0,1125000,275,3254,3344,-2554,-90
2025-07-14,2344,931,8,1125000,320,45515,44912, ,15,234,35,1125000,54,3039,3254,603,-215
2025-07-15,2344,2020,147,1125000,1287,46101,45515, ,2,455,0,1125000,122,2706,3039,586,-333
2025-07-16,2344,2496,7,1125000,1341,47249,46101, ,2,138,0,1125000,62,2630,2706,1148,-76
2025-07-17,2344,1312,38,1125000,1117,47406,47249, ,4,217,0,1125000,127,2540,2630,157,-90
2025-07-18,2344,1124,21,1125000,337,48172,47406, ,21,141,0,1125000,47,2446,2540,766,-94
2025-07-21,2344,919,145,1125000,548,48398,48172, ,31,127,10,1125000,53,2362,2446,226,-84
2025-07-22,2344,1098,23,1125000,911,48566,48402, ,15,114,0,1125000,99,2346,2361,164,-15
2025-07-23,2344,1069,14,1125000,1838,47783,48566, ,3,63,0,1125000,197,2480,2346,-783,134
2025-07-24,2344,2071,14,1125000,270,49570,47783, ,63,94,1,1125000,44,2429,2480,1787,-51
2025-07-25,2344,352,36,1125000,775,49111,49570, ,0,21,0,1125000,37,2445,2429,-459,16
2025-07-28,2344,634,6,1125000,378,49361,49111, ,10,89,0,1125000,13,2369,2445,250,-76
2025-07-29,2344,1778,3,1125000,967,50169,49361, ,23,114,0,1125000,49,2304,2369,808,-65
2025-07-30,2344,954,9,1125000,1471,49643,50169, ,2,43,0,1125000,151,2412,2304,-526,108
2025-07-31,2344,1056,41,1125000,507,50151,49643, ,6,185,0,1125000,21,2248,2412,508,-164
2025-08-01,2344,1124,4,1125000,1283,49988,50151, ,0,77,0,1125000,142,2313,2248,-163,65
2025-08-04,2344,1799,53,1125000,516,51218,49988, ,6,185,0,1125000,20,2148,2313,1230,-165
2025-08-05,2344,579,0,1125000,955,50842,51218, ,4,38,0,1125000,625,2735,2148,-376,587
2025-08-06,2344,3474,523,1125000,878,52915,50842, ,2,376,0,1125000,115,2474,2735,2073,-261
2025-08-07,2344,2772,14,1125000,3123,52550,52915, ,17,492,0,1125000,1430,3412,2474,-365,938
2025-08-08,2344,6596,2,1125000,5833,53311,52550, ,195,1367,0,1125000,389,2434,3412,761,-978
2025-08-11,2344,2051,8,1125000,2108,53246,53311, ,14,82,0,1125000,30,2382,2434,-65,-52
2025-08-12,2344,8457,4,1125000,6337,55362,53246, ,159,106,50,1125000,459,2685,2382,2116,303
2025-08-13,2344,4270,34,1125000,10072,49526,55362, ,22,363,0,1125000,85,2407,2685,-5836,-278
2025-08-14,2344,2183,15,1125000,693,51001,49526, ,15,40,1,1125000,48,2414,2407,1475,7
2025-08-15,2344,2374,6,1125000,2484,50885,51001, ,43,82,0,1125000,142,2474,2414,-116,60
2025-08-18,2344,12045,16,1125000,6122,56792,50885, ,263,29,1,1125000,273,2717,2474,5907,243
2025-08-19,2344,3012,1,1125000,5846,53957,56792, ,7,149,0,1125000,31,2599,2717,-2835,-118
2025-08-20,2344,4027,36,1125000,4636,53312,53957, ,34,129,0,1125000,13,2483,2599,-645,-116
2025-08-21,2344,1147,46,1125000,2269,52144,53312, ,16,8,0,1125000,28,2503,2483,-1168,20
2025-08-22,2344,1239,1,1125000,1459,51923,52144, ,0,98,0,1125000,20,2425,2503,-221,-78
2025-08-25,2344,2111,1,1125000,2410,51623,51923, ,20,12,0,1125000,68,2481,2425,-300,56
2025-08-26,2344,3369,7,1125000,1722,53263,51623, ,6,50,0,1125000,126,2557,2481,1640,76
2025-08-27,2344,4458,1,1125000,9110,48610,53263, ,283,104,0,1125000,421,2874,2557,-4653,317
2025-08-28,2344,3316,55,1125000,3915,47956,48610, ,54,206,0,1125000,67,2735,2874,-654,-139
2025-08-29,2344,3840,116,1125000,6139,45541,47956, ,178,27,1,1125000,76,2783,2735,-2415,48
2025-09-01,2344,6268,55,1125000,4270,47484,45541, ,117,59,1,1125000,467,3190,2783,1943,407
2025-09-02,2344,5580,4,1125000,4732,48328,47484, ,51,275,1,1125000,114,3028,3190,844,-162
2025-09-03,2344,2349,65,1125000,2778,47834,48328, ,45,23,0,1125000,132,3137,3028,-494,109
2025-09-04,2344,3192,43,1125000,3668,47315,47834, ,45,131,0,1125000,168,3174,3137,-519,37
2025-09-05,2344,7454,10,1125000,8587,46172,47315, ,186,117,2,1125000,2347,5402,3174,-1143,2228
2025-09-08,2344,43561,24,1125000,9814,79895,46172, ,349,556,1,1125000,1393,6238,5402,33723,836
2025-09-09,2344,17701,9,1125000,10853,86734,79895, ,277,614,35,1125000,933,6522,6238,6839,284
2025-09-10,2344,31877,29,1125000,20083,98499,86734, ,240,487,2,1125000,476,6509,6522,11765,-13
2025-09-11,2344,17760,9,1125000,19436,96814,98499, ,876,296,0,1125000,427,6640,6509,-1685,131
2025-09-12,2344,18184,21,1125000,32889,82088,96814, ,377,229,1,1125000,769,7179,6640,-14726,539
2025-09-15,2344,42052,39,1125000,16485,107616,82088, ,655,429,1,1125000,2463,9212,7179,25528,2033
2025-09-16,2344,41047,0,1125000,32543,116120,107616, ,806,1311,859,1125000,4775,11817,9212,8504,2605
2025-09-17,2344,29226,60,1125000,34999,110287,116120, ,542,1416,7,1125000,4431,14825,11817,-5833,3008
2025-09-18,2344,23461,1,1125000,16199,117548,110287, ,568,746,58,1125000,10088,24109,14825,7261,9284
2025-09-19,2344,26296,120,1125000,25415,118309,117548, ,875,3513,10,1125000,4009,24595,24109,761,486
2024-09-23,2379,63,9,128215,143,3451,3540, ,0,1,0,128215,3,17,15,-89,2
2024-09-24,2379,18,0,128215,62,3407,3451, ,2,0,0,128215,3,20,17,-44,3
2024-09-25,2379,27,19,128215,97,3318,3407, ,2,4,0,128215,0,16,20,-89,-4
2024-09-26,2379,59,0,128215,20,3357,3318, ,0,1,0,128215,0,15,16,39,-1
2024-09-27,2379,16,1,128215,28,3344,3357, ,0,0,0,128215,1,16,15,-13,1
2024-09-30,2379,120,18,128215,51,3395,3344, ,0,1,0,128215,20,35,16,51,19
2024-10-01,2379,44,0,128215,69,3370,3395, ,0,20,0,128215,1,16,35,-25,-19
2024-10-04,2379,19,2,128215,208,3179,3370, ,0,0,0,128215,1,17,16,-191,1
2024-10-07,2379,44,3,128215,16,3204,3179, ,0,1,0,128215,0,16,17,25,-1
2024-10-08,2379,21,2,128215,31,3192,3204, ,0,1,0,128215,2,17,16,-12,1
2024-10-09,2379,68,1,128215,93,3166,3192, ,0,1,0,128215,1,17,17,-26,0
2024-10-11,2379,23,2,128215,35,3152,3166, ,0,1,0,128215,0,16,17,-14,-1
2024-10-14,2379,5,3,128215,45,3109,3152, ,0,0,0,128215,1,17,16,-43,1
2024-10-15,2379,26,5,128215,41,3089,3109, ,2,0,0,128215,26,43,17,-20,26
2024-10-16,2379,120,42,128215,51,3116,3089, ,1,2,0,128215,50,91,43,27,48
2024-10-17,2379,153,6,128215,94,3169,3116, ,5,73,0,128215,8,26,91,53,-65
2024-10-18,2379,45,0,128215,38,3176,3169, ,0,10,0,128215,1,17,26,7,-9
2024-10-21,2379,26,0,128215,81,3121,3176, ,0,0,0,128215,2,19,17,-55,2
2024-10-22,2379,25,0,128215,68,3078,3121, ,0,1,0,128215,1,19,19,-43,0
2024-10-23,2379,62,0,128215,26,3114,3078, ,0,1,0,128215,26,44,19,36,25
2024-10-24,2379,52,0,128215,87,3079,3114, ,1,29,0,128215,5,20,44,-35,-24
2024-10-25,2379,34,0,128215,34,3079,3079, ,0,3,0,128215,2,19,20,0,-1
2024-10-28,2379,75,0,128215,22,3132,3079, ,0,2,0,128215,0,17,19,53,-2
2024-10-29,2379,18,0,128215,20,3130,3132, ,1,2,0,128215,0,15,17,-2,-2
2024-10-30,2379,17,0,128215,81,3066,3130, ,0,0,0,128215,28,43,15,-64,28
2024-11-01,2379,35,0,128215,32,3069,3066, ,2,33,0,128215,5,15,43,3,-28
2024-11-04,2379,8,0,128215,9,3068,3069, ,1,1,0,128215,26,40,15,-1,25
2024-11-05,2379,21,0,128215,3,3086,3068, ,0,10,0,128215,1,31,40,18,-9
2024-11-06,2379,27,0,128215,94,3019,3086, ,2,18,0,128215,3,16,31,-67,-15
2024-11-07,2379,99,0,128215,29,3089,3019, ,0,2,0,128215,11,25,16,70,9
2024-11-08,2379,16,0,128215,164,2941,3089, ,0,11,0,128215,3,17,25,-148,-8
2024-11-11,2379,51,0,128215,16,2976,2941, ,0,2,0,128215,0,15,17,35,-2
2024-11-12,2379,45,0,128215,22,2999,2976, ,0,3,0,128215,0,12,15,23,-3
2024-11-13,2379,59,24,128215,24,3010,2999, ,0,0,0,128215,2,14,12,11,2
2024-11-14,2379,63,25,128215,18,3030,3010, ,0,2,0,128215,0,12,14,20,-2
2024-11-15,2379,87,0,128215,13,3104,3030, ,0,1,0,128215,4,15,12,74,3
2024-11-18,2379,42,0,128215,87,3059,3104, ,0,0,0,128215,17,32,15,-45,17
2024-11-19,2379,120,0,128215,230,2949,3059, ,1,2,0,128215,3,33,32,-110,1
2024-11-20,2379,193,1,128215,31,3110,2949, ,0,3,0,128215,0,30,33,161,-3
2024-11-21,2379,26,0,128215,38,3098,3110, ,0,0,0,128215,46,76,30,-12,46
2024-11-22,2379,201,0,128215,33,3266,3098, ,0,5,0,128215,26,97,76,168,21
2024-11-25,2379,16,0,128215,45,3237,3266, ,1,69,0,128215,2,30,97,-29,-67
2024-11-26,2379,53,5,128215,58,3227,3237, ,4,0,0,128215,3,33,30,-10,3
2024-11-27,2379,32,0,128215,26,3233,3227, ,0,0,0,128215,0,33,33,6,0
2024-11-28,2379,33,0,128215,30,3236,3233, ,1,4,0,128215,3,32,33,3,-1
2024-11-29,2379,52,0,128215,20,3268,3236, ,0,0,0,128215,1,33,32,32,1
2024-12-02,2379,7,1,128215,140,3134,3268, ,0,0,0,128215,16,49,33,-134,16
2024-12-03,2379,34,0,128215,27,3141,3134, ,0,17,0,128215,1,33,49,7,-16
2024-12-04,2379,27,0,128215,232,2936,3141, ,0,2,0,128215,14,45,33,-205,12
2024-12-05,2379,17,0,128215,89,2864,2936, ,0,3,0,128215,9,51,45,-72,6
2024-12-06,2379,232,0,128215,104,2992,2864, ,1,4,0,128215,10,57,51,128,6
2024-12-09,2379,231,0,128215,184,3039,2992, ,0,5,0,128215,4,56,57,47,-1
2024-12-10,2379,52,0,128215,37,3054,3039, ,0,1,0,128215,5,60,56,15,4
2024-12-11,2379,89,0,128215,91,3052,3054, ,0,2,0,128215,11,69,60,-2,9
2024-12-12,2379,99,0,128215,44,3107,3052, ,0,12,0,128215,2,59,69,55,-10
2024-12-13,2379,26,0,128215,201,2932,3107, ,0,0,0,128215,11,70,59,-175,11
2024-12-16,2379,451,0,128215,127,3256,2932, ,1,0,0,128215,2,72,70,324,2
2024-12-17,2379,142,0,128215,323,3075,3256, ,2,1,0,128215,9,80,72,-181,8
2024-12-18,2379,65,4,128215,119,3017,3075, ,0,2,0,128215,2,80,80,-58,0
2024-12-19,2379,139,0,128215,210,2946,3017, ,0,11,0,128215,1,70,80,-71,-10
2024-12-20,2379,112,0,128215,106,2952,2946, ,1,5,0,128215,1,66,70,6,-4
2024-12-23,2379,17,0,128215,60,2909,2952, ,0,1,0,128215,3,68,66,-43,2
2024-12-24,2379,19,0,128215,14,2914,2909, ,0,2,0,128215,0,66,68,5,-2
2024-12-25,2379,20,0,128215,124,2810,2914, ,0,1,0,128215,0,65,66,-104,-1
2024-12-26,2379,121,1,128215,241,2689,2810, ,0,0,0,128215,9,74,65,-121,9
2024-12-27,2379,52,0,128215,71,2670,2689, ,0,3,0,128215,2,73,74,-19,-1
2024-12-30,2379,181,0,128215,37,2814,2670, ,1,1,0,128215,4,76,73,144,3
2024-12-31,2379,25,1,128215,160,2678,2814, ,0,3,0,128215,3,76,76,-136,0
2025-01-02,2379,276,0,128215,69,2885,2678, ,1,8,0,128215,3,71,76,207,-5
2025-01-03,2379,82,0,128215,43,2924,2885, ,0,4,0,128215,1,68,71,39,-3
2025-01-06,2379,62,0,128215,57,2929,2924, ,0,19,0,128215,1,50,68,5,-18
2025-01-07,2379,54,23,128215,43,2917,2929, ,0,0,0,128215,0,50,50,-12,0
2025-01-08,2379,12,26,128215,28,2875,2917, ,0,0,0,128215,0,50,50,-42,0
2025-01-09,2379,42,0,128215,124,2793,2875, ,0,4,0,128215,0,46,50,-82,-4
2025-01-10,2379,11,5,128215,16,2783,2793, ,0,1,0,128215,0,45,46,-10,-1
2025-01-13,2379,25,5,128215,55,2748,2783, ,0,5,0,128215,5,45,45,-35,0
2025-01-14,2379,16,1,128215,8,2755,2748, ,0,0,0,128215,0,45,45,7,0
2025-01-15,2379,17,0,128215,18,2754,2755, ,1,4,0,128215,1,42,45,-1,-3
2025-01-16,2379,31,0,128215,29,2756,2754, ,0,0,0,128215,2,44,42,2,2
2025-01-17,2379,24,0,128215,83,2697,2756, ,0,3,0,128215,16,57,44,-59,13
2025-01-20,2379,17,4,128215,8,2702,2697, ,0,14,0,128215,0,43,57,5,-14
2025-01-21,2379,8,0,128215,19,2691,2702, ,0,0,0,128215,0,43,43,-11,0
2025-01-22,2379,9,1,128215,18,2681,2691, ,0,0,0,128215,1,44,43,-10,1
2025-02-03,2379,61,0,128215,6,2736,2681, ,0,2,0,128215,0,42,44,55,-2
2025-02-04,2379,59,0,128215,244,2551,2736, ,1,0,0,128215,14,56,42,-185,14
2025-02-05,2379,121,0,128215,175,2497,2551, ,2,2,0,128215,27,81,56,-54,25
2025-02-06,2379,424,0,128215,79,2842,2497, ,0,9,0,128215,7,79,81,345,-2
2025-02-07,2379,114,2,128215,169,2785,2842, ,0,0,0,128215,18,97,79,-57,18
2025-02-10,2379,79,0,128215,45,2819,2785, ,0,0,0,128215,1,98,97,34,1
2025-02-11,2379,133,0,128215,174,2778,2819, ,1,1,0,128215,0,97,98,-41,-1
2025-02-12,2379,42,0,128215,83,2737,2778, ,0,4,0,128215,0,93,97,-41,-4
2025-02-13,2379,124,0,128215,63,2798,2737, ,1,12,0,128215,0,81,93,61,-12
2025-02-14,2379,54,25,128215,104,2723,2798, ,0,37,0,128215,0,44,81,-75,-37
2025-02-17,2379,206,2,128215,46,2881,2723, ,0,0,0,128215,0,44,44,158,0
2025-02-18,2379,104,0,128215,22,2963,2881, ,0,0,0,128215,1,45,44,82,1
2025-02-19,2379,97,26,128215,268,2766,2963, ,0,1,0,128215,0,44,45,-197,-1
2025-02-20,2379,21,0,128215,43,2744,2766, ,1,0,0,128215,0,44,44,-22,0
2025-02-21,2379,44,0,128215,136,2652,2744, ,0,1,0,128215,2,45,44,-92,1
2025-02-24,2379,87,0,128215,67,2672,2652, ,0,1,0,128215,2,46,45,20,1
2025-02-25,2379,95,0,128215,23,2744,2672, ,0,1,0,128215,0,45,46,72,-1
2025-02-26,2379,53,0,128215,29,2768,2744, ,2,0,0,128215,3,48,45,24,3
2025-02-27,2379,99,26,128215,69,2772,2768, ,0,0,0,128215,3,51,48,4,3
2025-03-03,2379,34,1,128215,55,2750,2772, ,0,0,0,128215,0,51,51,-22,0
2025-03-04,2379,110,0,128215,6,2854,2750, ,0,4,0,128215,4,51,51,104,0
2025-03-05,2379,50,0,128215,56,2848,2854, ,2,0,0,128215,5,56,51,-6,5
2025-03-06,2379,81,45,128215,25,2859,2848, ,2,1,0,128215,0,55,56,11,-1
2025-03-07,2379,15,0,128215,61,2813,2859, ,0,2,0,128215,0,53,55,-46,-2
2025-03-10,2379,66,1,128215,67,2811,2813, ,0,0,0,128215,0,53,53,-2,0
2025-03-11,2379,53,0,128215,41,2823,2811, ,0,9,0,128215,1,45,53,12,-8
2025-03-12,2379,11,22,128215,50,2762,2823, ,0,0,0,128215,0,45,45,-61,0
2025-03-13,2379,73,1,128215,38,2796,2762, ,0,1,0,128215,0,44,45,34,-1
2025-03-14,2379,60,0,128215,25,2831,2796, ,0,6,0,128215,0,38,44,35,-6
2025-03-17,2379,79,5,128215,6,2899,2831, ,0,3,0,128215,0,35,38,68,-3
2025-03-18,2379,14,1,128215,44,2868,2899, ,0,3,0,128215,0,32,35,-31,-3
2025-03-19,2379,40,24,128215,19,2865,2868, ,0,1,0,128215,0,31,32,-3,-1
2025-03-20,2379,29,0,128215,44,2850,2865,X ,0,5,0,128215,2,28,31,-15,-3
2025-03-21,2379,18,27,128215,90,2751,2850,X ,0,22,0,128215,0,6,28,-99,-22
2025-03-24,2379,66,0,128215,59,2758,2751,X ,0,0,6,128215,0,0,6,7,-6
2025-03-25,2379,28,0,128215,26,2760,2758,X ,0,0,0,128215,0,0,0,2,0
2025-03-26,2379,32,25,128215,16,2751,2760, ,0,0,0,128215,0,0,0,-9,0
2025-03-27,2379,33,0,128215,43,2741,2751, ,0,0,0,128215,0,0,0,-10,0
2025-03-28,2379,23,24,128215,39,2701,2741, ,2,0,0,128215,3,3,0,-40,3
2025-03-31,2379,28,0,128215,77,2652,2701, ,1,1,0,128215,16,18,3,-49,15
2025-04-01,2379,86,0,128215,3,2735,2652, ,1,1,0,128215,0,17,18,83,-1
2025-04-02,2379,98,2,128215,19,2812,2735, ,0,0,0,128215,3,20,17,77,3
2025-04-07,2379,11,23,128215,94,2706,2812, ,0,0,0,128215,55,75,20,-106,55
2025-04-08,2379,110,3,128215,145,2668,2706, ,0,58,0,128215,0,17,75,-38,-58
2025-04-09,2379,29,0,128215,120,2577,2668, ,1,9,0,128215,11,19,17,-91,2
2025-04-10,2379,133,19,128215,12,2679,2577, ,0,1,0,128215,7,25,19,102,6
2025-04-11,2379,34,0,128215,163,2550,2679, ,0,5,0,128215,2,22,25,-129,-3
2025-04-14,2379,88,0,128215,38,2600,2550, ,0,9,0,128215,7,20,22,50,-2
2025-04-15,2379,54,0,128215,23,2631,2600, ,4,1,0,128215,0,19,20,31,-1
2025-04-16,2379,46,24,128215,17,2636,2631, ,1,0,0,128215,1,20,19,5,1
2025-04-17,2379,12,0,128215,65,2583,2636, ,2,5,0,128215,10,25,20,-53,5
2025-04-18,2379,35,15,128215,17,2586,2583, ,0,0,0,128215,0,25,25,3,0
2025-04-21,2379,25,0,128215,19,2592,2586, ,0,0,0,128215,3,28,25,6,3
2025-04-22,2379,34,24,128215,9,2593,2592, ,0,3,0,128215,2,27,28,1,-1
2025-04-23,2379,63,24,128215,28,2604,2593, ,0,0,0,128215,5,32,27,11,5
2025-04-24,2379,35,20,128215,4,2615,2604, ,0,3,0,128215,0,29,32,11,-3
2025-04-25,2379,17,29,128215,56,2547,2615, ,3,1,0,128215,5,33,29,-68,4
2025-04-28,2379,49,19,128215,11,2566,2547, ,0,0,0,128215,0,33,33,19,0
2025-04-29,2379,134,0,128215,7,2693,2566, ,1,2,0,128215,0,31,33,127,-2
2025-04-30,2379,78,42,128215,61,2668,2693, ,0,0,0,128215,2,33,31,-25,2
2025-05-02,2379,293,18,128215,19,2924,2668, ,0,5,0,128215,1,29,33,256,-4
2025-05-05,2379,73,55,128215,90,2852,2924, ,0,1,0,128215,7,35,29,-72,6
2025-05-06,2379,30,0,128215,7,2875,2852, ,0,2,0,128215,3,36,35,23,1
2025-05-07,2379,89,35,128215,26,2903,2875, ,0,0,0,128215,3,39,36,28,3
2025-05-08,2379,70,0,128215,41,2932,2903, ,0,0,0,128215,2,41,39,29,2
2025-05-09,2379,156,30,128215,63,2995,2932, ,0,6,0,128215,1,36,41,63,-5
2025-05-12,2379,95,0,128215,6,3084,2995, ,0,0,0,128215,0,36,36,89,0
2025-05-13,2379,83,26,128215,116,3025,3084, ,10,1,0,128215,4,39,36,-59,3
2025-05-14,2379,57,0,128215,22,3060,3025, ,0,2,0,128215,0,37,39,35,-2
2025-05-15,2379,116,0,128215,9,3167,3060, ,0,0,0,128215,0,37,37,107,0
2025-05-16,2379,60,24,128215,18,3185,3167, ,1,0,0,128215,1,38,37,18,1
2025-05-19,2379,21,0,128215,27,3179,3185, ,0,0,0,128215,0,38,38,-6,0
2025-05-20,2379,66,0,128215,35,3210,3179, ,0,0,0,128215,4,42,38,31,4
2025-05-21,2379,82,24,128215,41,3227,3210, ,1,0,0,128215,0,42,42,17,0
2025-05-22,2379,91,0,128215,43,3275,3227, ,1,0,0,128215,2,44,42,48,2
2025-05-23,2379,84,24,128215,24,3311,3275, ,0,1,4,128215,1,40,44,36,-4
2025-05-26,2379,60,0,128215,113,3258,3311, ,1,1,0,128215,6,45,40,-53,5
2025-05-27,2379,92,23,128215,27,3300,3258, ,0,2,0,128215,2,45,45,42,0
2025-05-28,2379,101,0,128215,149,3252,3300, ,0,6,0,128215,3,42,45,-48,-3
2025-05-29,2379,25,0,128215,47,3230,3252, ,0,1,0,128215,2,43,42,-22,1
2025-06-02,2379,37,0,128215,30,3237,3230, ,0,4,0,128215,3,42,43,7,-1
2025-06-03,2379,32,0,128215,38,3231,3237, ,0,0,0,128215,21,63,42,-6,21
2025-06-04,2379,71,0,128215,47,3255,3231, ,0,22,0,128215,4,45,63,24,-18
2025-06-05,2379,81,2,128215,39,3295,3255, ,0,2,0,128215,3,46,45,40,1
2025-06-06,2379,56,0,128215,11,3340,3295, ,0,0,0,128215,2,48,46,45,2
2025-06-09,2379,30,22,128215,115,3233,3340, ,0,1,0,128215,5,52,48,-107,4
2025-06-10,2379,19,20,128215,31,3201,3233, ,0,1,0,128215,3,54,52,-32,2
2025-06-11,2379,15,20,128215,43,3153,3201, ,0,2,0,128215,1,53,54,-48,-1
2025-06-12,2379,98,0,128215,25,3226,3153, ,0,11,0,128215,0,42,53,73,-11
2025-06-13,2379,17,1,128215,9,3233,3226, ,0,1,0,128215,0,41,42,7,-1
2025-06-16,2379,36,20,128215,14,3235,3233, ,0,1,0,128215,1,41,41,2,0
2025-06-17,2379,36,20,128215,32,3219,3235, ,0,0,0,128215,2,43,41,-16,2
2025-06-18,2379,14,18,128215,8,3207,3219, ,0,2,0,128215,1,42,43,-12,-1
2025-06-19,2379,186,2,128215,92,3299,3207, ,1,3,0,128215,3,42,42,92,0
2025-06-20,2379,63,3,128215,41,3318,3299, ,0,4,0,128215,5,43,42,19,1
2025-06-23,2379,22,12,128215,51,3277,3318, ,0,3,0,128215,0,40,43,-41,-3
2025-06-24,2379,9,0,128215,30,3256,3277, ,1,5,0,128215,3,38,40,-21,-2
2025-06-25,2379,22,0,128215,230,3048,3256, ,0,2,0,128215,4,40,38,-208,2
2025-06-26,2379,4,1,128215,23,3028,3048, ,0,0,0,128215,2,42,40,-20,2
2025-06-27,2379,10,0,128215,164,2874,3028, ,0,2,0,128215,3,43,42,-154,1
2025-06-30,2379,8,0,128215,19,2863,2874, ,0,0,0,128215,1,44,43,-11,1
2025-07-01,2379,29,0,128215,63,2829,2863, ,0,3,0,128215,0,41,44,-34,-3
2025-07-02,2379,45,0,128215,155,2719,2829, ,0,0,0,128215,7,48,41,-110,7
2025-07-03,2379,32,0,128215,23,2728,2719, ,0,0,0,128215,0,48,48,9,0
2025-07-04,2379,14,0,128215,66,2676,2728, ,0,0,0,128215,3,51,48,-52,3
2025-07-07,2379,32,0,128215,15,2693,2676, ,1,8,0,128215,2,45,51,17,-6
2025-07-08,2379,25,0,128215,68,2650,2693, ,0,3,0,128215,0,42,45,-43,-3
2025-07-09,2379,18,0,128215,143,2525,2650, ,0,0,0,128215,2,44,42,-125,2
2025-07-10,2379,7,0,128215,63,2469,2525, ,0,2,0,128215,0,42,44,-56,-2
2025-07-11,2379,20,1,128215,99,2389,2469, ,0,0,0,128215,1,43,42,-80,1
2025-07-14,2379,3,0,128215,10,2382,2389, ,0,0,0,128215,2,45,43,-7,2
2025-07-15,2379,57,1,128215,17,2421,2382, ,0,1,0,128215,0,44,45,39,-1
2025-07-16,2379,40,1,128215,39,2421,2421, ,0,0,0,128215,4,48,44,0,4
2025-07-17,2379,2,22,128215,12,2389,2421, ,0,0,0,128215,1,49,48,-32,1
2025-07-18,2379,3,0,128215,88,2304,2389, ,0,1,0,128215,0,48,49,-85,-1
2025-07-21,2379,58,0,128215,7,2355,2304, ,0,4,0,128215,0,44,48,51,-4
2025-07-22,2379,34,0,128215,138,2252,2356, ,0,0,0,128215,14,58,44,-104,14
2025-07-23,2379,62,22,128215,7,2285,2252, ,0,7,0,128215,0,51,58,33,-7
2025-07-24,2379,16,0,128215,7,2294,2285, ,0,1,0,128215,0,50,51,9,-1
2025-07-25,2379,17,0,128215,7,2304,2294, ,2,2,0,128215,0,48,50,10,-2
2025-07-28,2379,1,0,128215,16,2289,2304, ,0,0,0,128215,0,48,48,-15,0
2025-07-29,2379,14,0,128215,13,2290,2289, ,0,0,0,128215,0,48,48,1,0
2025-07-30,2379,4,0,128215,11,2283,2290, ,0,0,0,128215,1,49,48,-7,1
2025-07-31,2379,19,0,128215,5,2297,2283, ,0,0,0,128215,33,82,49,14,33
2025-08-01,2379,173,0,128215,19,2451,2297, ,0,38,0,128215,37,81,82,154,-1
2025-08-04,2379,29,0,128215,21,2459,2451, ,5,39,0,128215,1,43,81,8,-38
2025-08-05,2379,27,1,128215,51,2434,2459, ,2,6,0,128215,4,41,43,-25,-2
2025-08-06,2379,80,1,128215,11,2502,2434, ,0,6,0,128215,1,36,41,68,-5
2025-08-07,2379,56,23,128215,26,2509,2502, ,0,3,0,128215,1,34,36,7,-2
2025-08-08,2379,38,0,128215,46,2501,2509, ,0,4,0,128215,1,31,34,-8,-3
2025-08-11,2379,31,16,128215,18,2498,2501, ,0,1,0,128215,0,30,31,-3,-1
2025-08-12,2379,22,0,128215,24,2496,2498, ,2,0,0,128215,1,31,30,-2,1
2025-08-13,2379,27,5,128215,10,2508,2496, ,0,1,0,128215,1,31,31,12,0
2025-08-14,2379,78,5,128215,39,2542,2508, ,0,1,0,128215,3,33,31,34,2
2025-08-15,2379,64,1,128215,25,2580,2542, ,0,4,0,128215,0,29,33,38,-4
2025-08-18,2379,16,1,128215,17,2578,2580, ,1,0,0,128215,3,32,29,-2,3
2025-08-19,2379,24,0,128215,8,2594,2578, ,0,6,0,128215,0,26,32,16,-6
2025-08-20,2379,35,0,128215,29,2600,2594, ,0,2,0,128215,2,26,26,6,0
2025-08-21,2379,47,2,128215,18,2627,2600, ,0,0,0,128215,5,31,26,27,5
2025-08-22,2379,10,0,128215,6,2631,2627, ,0,1,0,128215,0,30,31,4,-1
2025-08-25,2379,18,3,128215,28,2618,2631, ,0,5,0,128215,4,29,30,-13,-1
2025-08-26,2379,42,2,128215,35,2623,2618, ,0,1,0,128215,2,30,29,5,1
2025-08-27,2379,10,0,128215,16,2617,2623, ,0,2,1,128215,0,27,30,-6,-3
2025-08-28,2379,62,0,128215,16,2663,2617, ,0,0,0,128215,1,28,27,46,1
2025-08-29,2379,80,1,128215,25,2717,2663, ,0,10,0,128215,1,19,28,54,-9
2025-09-01,2379,26,21,128215,21,2701,2717, ,0,9,0,128215,3,13,19,-16,-6
2025-09-02,2379,13,0,128215,110,2604,2701, ,0,0,0,128215,1,14,13,-97,1
2025-09-03,2379,11,15,128215,4,2596,2604,X ,0,4,0,128215,0,10,14,-8,-4
2025-09-04,2379,36,0,128215,7,2625,2596,X ,0,10,0,128215,0,0,10,29,-10
2025-09-05,2379,26,1,128215,35,2615,2625,X ,0,0,0,128215,0,0,0,-10,0
2025-09-08,2379,11,0,128215,38,2588,2615,X ,0,0,0,128215,0,0,0,-27,0
2025-09-09,2379,99,2,128215,44,2641,2588, ,0,0,0,128215,0,0,0,53,0
2025-09-10,2379,89,10,128215,32,2688,2641, ,10,0,0,128215,20,20,0,47,20
2025-09-11,2379,45,1,128215,79,2653,2688, ,3,0,0,128215,2,22,20,-35,2
2025-09-12,2379,61,4,128215,15,2695,2653, ,0,21,0,128215,0,1,22,42,-21
2025-09-15,2379,17,1,128215,14,2697,2695, ,0,1,0,128215,2,2,1,2,1
2025-09-16,2379,40,1,128215,89,2647,2697, ,0,1,0,128215,9,10,2,-50,8
2025-09-17,2379,10,0,128215,26,2631,2647, ,0,3,0,128215,1,8,10,-16,-2
2025-09-18,2379,34,16,128215,39,2610,2631, ,0,1,0,128215,1,8,8,-21,0
2025-09-19,2379,34,2,128215,35,2607,2610, ,0,0,0,128215,1,9,8,-3,1
2024-09-23,2383,172,0,86162,237,7804,7869, ,0,18,2,86162,2,128,146,-65,-18
2024-09-24,2383,375,2,86162,131,8046,7804, ,2,22,0,86162,5,111,128,242,-17
2024-09-25,2383,239,1,86162,285,7999,8046, ,1,8,0,86162,27,130,111,-47,19
2024-09-26,2383,466,1,86162,249,8215,7999, ,1,22,0,86162,71,179,130,216,49
2024-09-27,2383,327,1,86162,389,8152,8215, ,1,3,0,86162,18,194,179,-63,15
2024-09-30,2383,569,4,86162,370,8347,8152, ,4,35,0,86162,5,164,194,195,-30
2024-10-01,2383,589,0,86162,313,8623,8347, ,9,21,0,86162,13,156,164,276,-8
2024-10-04,2383,1316,11,86162,218,9710,8623, ,4,37,0,86162,10,129,156,1087,-27
2024-10-07,2383,227,3,86162,633,9301,9710, ,6,13,0,86162,32,148,129,-409,19
2024-10-08,2383,265,0,86162,728,8838,9301, ,1,11,0,86162,15,152,148,-463,4
2024-10-09,2383,693,0,86162,853,8678,8838, ,4,87,0,86162,14,79,152,-160,-73
2024-10-11,2383,359,5,86162,290,8742,8678, ,3,23,0,86162,6,62,79,64,-17
2024-10-14,2383,283,2,86305,147,8876,8742, ,4,4,0,86305,3,61,62,134,-1
2024-10-15,2383,474,1,86305,178,9171,8876, ,2,3,0,86305,1,59,61,295,-2
2024-10-16,2383,304,3,86305,62,9410,9171, ,7,4,1,86305,14,68,59,239,9
2024-10-17,2383,354,1,86305,585,9178,9410, ,1,2,0,86305,19,85,68,-232,17
2024-10-18,2383,718,4,86305,269,9623,9178, ,1,13,0,86305,21,93,85,445,8
2024-10-21,2383,248,2,86305,623,9246,9623, ,0,3,0,86305,27,117,93,-377,24
2024-10-22,2383,372,1,86305,572,9045,9246, ,0,11,0,86305,27,133,117,-201,16
2024-10-23,2383,363,0,86305,763,8645,9045, ,5,6,3,86305,13,137,133,-400,4
2024-10-24,2383,1516,1,86305,333,9827,8645, ,2,23,3,86305,261,372,137,1182,235
2024-10-25,2383,306,4,86305,189,9940,9827, ,2,1,13,86305,3,361,372,113,-11
2024-10-28,2383,321,2,86305,291,9968,9940, ,0,1,4,86305,19,375,361,28,14
2024-10-29,2383,487,1,86305,191,10263,9968, ,0,38,0,86305,3,340,375,295,-35
2024-10-30,2383,129,2,86305,145,10245,10263, ,0,14,0,86305,22,348,340,-18,8
2024-11-01,2383,182,2,86305,407,10018,10245, ,3,12,0,86305,28,364,348,-227,16
2024-11-04,2383,30,2,86305,243,9803,10018, ,1,1,4,86305,28,387,364,-215,23
2024-11-05,2383,225,0,86305,312,9716,9803, ,0,2,4,86305,7,388,387,-87,1
2024-11-06,2383,208,0,86305,664,9260,9716, ,3,2,14,86305,18,390,388,-456,2
2024-11-07,2383,166,0,86305,587,8839,9260, ,0,3,26,86305,10,371,390,-421,-19
2024-11-08,2383,120,6,86305,278,8675,8839, ,0,9,10,86305,6,358,371,-164,-13
2024-11-11,2383,94,0,86305,177,8592,8675, ,1,2,58,86305,7,305,358,-83,-53
2024-11-12,2383,123,5,86305,200,8510,8592, ,3,214,3,86305,2,90,305,-82,-215
2024-11-13,2383,228,0,86305,405,8333,8510, ,2,1,0,86305,38,127,90,-177,37
2024-11-14,2383,216,1,86318,291,8257,8333, ,2,8,0,86318,31,150,127,-76,23
2024-11-15,2383,131,2,86318,276,8110,8257, ,2,3,2,86318,13,158,150,-147,8
2024-11-18,2383,501,0,86318,239,8372,8110, ,3,35,10,86318,20,133,158,262,-25
2024-11-19,2383,142,1,86318,127,8386,8372, ,0,7,14,86318,10,122,133,14,-11
2024-11-20,2383,292,0,86318,645,8033,8386, ,2,2,12,86318,59,167,122,-353,45
2024-11-21,2383,602,1,86318,1089,7545,8033, ,8,11,0,86318,224,380,167,-488,213
2024-11-22,2383,794,0,86318,901,7438,7545, ,14,8,0,86318,120,492,380,-107,112
2024-11-25,2383,618,0,86318,214,7842,7438, ,6,31,3,86318,72,530,492,404,38
2024-11-26,2383,676,0,86318,168,8350,7842, ,3,98,43,86318,109,498,530,508,-32
2024-11-27,2383,150,0,86318,622,7878,8350, ,2,7,44,86318,11,458,498,-472,-40
2024-11-28,2383,421,0,86318,300,7999,7878, ,6,32,34,86318,23,415,458,121,-43
2024-11-29,2383,208,1,86318,176,8030,7999, ,8,110,23,86318,27,309,415,31,-106
2024-12-02,2383,977,1,86318,1630,7376,8030, ,9,4,0,86318,232,537,309,-654,228
2024-12-03,2383,689,2,86318,615,7448,7376, ,7,5,1,86318,48,579,537,72,42
2024-12-04,2383,639,2,86318,1134,6951,7448, ,6,7,14,86318,131,689,579,-497,110
2024-12-05,2383,459,1,86318,272,7137,6951, ,1,60,6,86318,9,632,689,186,-57
2024-12-06,2383,415,0,86318,533,7019,7137, ,1,8,5,86318,103,722,632,-118,90
2024-12-09,2383,1373,0,86318,571,7821,7019, ,17,7,4,86318,98,809,722,802,87
2024-12-10,2383,312,2,86318,544,7587,7821, ,5,12,5,86318,76,868,809,-234,59
2024-12-11,2383,742,1,86318,1104,7224,7587, ,7,36,0,86318,122,954,868,-363,86
2024-12-12,2383,364,1,86318,332,7255,7224, ,10,17,9,86318,24,952,954,31,-2
2024-12-13,2383,413,0,86397,624,7044,7255, ,16,21,7,86397,196,1120,952,-211,168
2024-12-16,2383,280,0,86397,648,6676,7044, ,4,27,11,86397,84,1166,1120,-368,46
2024-12-17,2383,399,0,86397,806,6269,6676, ,6,121,9,86397,246,1282,1166,-407,116
2024-12-18,2383,475,0,86397,557,6187,6269, ,6,41,4,86397,175,1412,1282,-82,130
2024-12-19,2383,389,0,86397,482,6094,6187, ,2,54,0,86397,76,1434,1412,-93,22
2024-12-20,2383,436,0,86397,620,5910,6094, ,3,189,0,86397,20,1265,1434,-184,-169
2024-12-23,2383,214,0,86397,519,5605,5910, ,10,10,0,86397,91,1346,1265,-305,81
2024-12-24,2383,325,0,86397,264,5666,5605, ,5,90,0,86397,32,1288,1346,61,-58
2024-12-25,2383,504,2,86397,404,5764,5666, ,3,52,3,86397,17,1250,1288,98,-38
2024-12-26,2383,336,0,86397,415,5685,5764, ,0,21,3,86397,49,1275,1250,-79,25
2024-12-27,2383,574,1,86397,709,5549,5685, ,3,18,1,86397,108,1364,1275,-136,89
2024-12-30,2383,170,0,86397,388,5331,5549, ,7,58,0,86397,54,1360,1364,-218,-4
2024-12-31,2383,236,1,86397,262,5304,5331, ,8,7,0,86397,5,1358,1360,-27,-2
2025-01-02,2383,453,200,86397,365,5192,5304, ,3,163,0,86397,7,1202,1358,-112,-156
2025-01-03,2383,66,4,86397,199,5055,5192, ,0,8,0,86397,22,1216,1202,-137,14
2025-01-06,2383,270,0,86397,254,5071,5055, ,1,6,2,86397,49,1257,1216,16,41
2025-01-07,2383,607,0,86397,286,5392,5071, ,3,172,0,86397,21,1106,1257,321,-151
2025-01-08,2383,356,3,86397,574,5171,5392, ,2,47,0,86397,39,1098,1106,-221,-8
2025-01-09,2383,316,0,86397,416,5071,5171, ,2,59,0,86397,27,1066,1098,-100,-32
2025-01-10,2383,104,1,86397,507,4667,5071, ,2,25,0,86397,67,1108,1066,-404,42
2025-01-13,2383,306,1,86397,257,4715,4667, ,6,163,2,86397,48,991,1108,48,-117
2025-01-14,2383,271,2,86658,111,4873,4715, ,1,59,0,86658,62,994,991,158,3
2025-01-15,2383,117,1,86658,226,4763,4873, ,0,31,0,86658,13,976,994,-110,-18
2025-01-16,2383,226,0,86658,312,4677,4763, ,5,51,2,86658,20,943,976,-86,-33
2025-01-17,2383,171,1,86658,152,4695,4677, ,2,6,0,86658,85,1022,943,18,79
2025-01-20,2383,67,2,86658,114,4646,4695, ,0,168,0,86658,7,861,1022,-49,-161
2025-01-21,2383,211,12,86658,148,4697,4646, ,1,98,4,86658,16,775,861,51,-86
2025-01-22,2383,133,4,86658,262,4564,4697, ,1,15,2,86658,27,785,775,-133,10
2025-02-03,2383,556,2,86658,378,4740,4564, ,0,188,5,86658,38,630,785,176,-155
2025-02-04,2383,341,0,86658,162,4919,4740, ,0,95,0,86658,3,538,630,179,-92
2025-02-05,2383,306,0,86658,428,4797,4919, ,2,6,0,86658,83,615,538,-122,77
2025-02-06,2383,188,1,86658,741,4243,4797, ,1,3,0,86658,136,748,615,-554,133
2025-02-07,2383,275,1,86658,382,4135,4243, ,1,2,0,86658,118,864,748,-108,116
2025-02-10,2383,169,0,86658,164,4140,4135, ,1,72,24,86658,11,779,864,5,-85
2025-02-11,2383,196,1,86658,213,4122,4140, ,1,9,38,86658,23,755,779,-18,-24
2025-02-12,2383,542,2,86658,291,4371,4122, ,2,103,34,86658,1,619,755,249,-136
2025-02-13,2383,142,0,86658,125,4388,4371, ,0,18,0,86658,10,611,619,17,-8
2025-02-14,2383,137,2,86662,39,4484,4388, ,2,32,0,86662,2,581,611,96,-30
2025-02-17,2383,201,0,86662,46,4639,4484, ,1,12,0,86662,2,571,581,155,-10
2025-02-18,2383,147,2,86662,355,4429,4639, ,0,3,0,86662,18,586,571,-210,15
2025-02-19,2383,159,2,86662,297,4289,4429, ,0,15,0,86662,2,573,586,-140,-13
2025-02-20,2383,184,1,86662,158,4314,4289, ,0,56,0,86662,1,518,573,25,-55
2025-02-21,2383,157,16,86662,154,4301,4314, ,0,16,0,86662,3,505,518,-13,-13
2025-02-24,2383,428,0,86662,185,4544,4301, ,6,54,0,86662,13,464,505,243,-41
2025-02-25,2383,505,1,86662,241,4807,4544, ,1,59,0,86662,6,411,464,263,-53
2025-02-26,2383,760,0,86662,1444,4123,4807, ,8,40,0,86662,192,563,411,-684,152
2025-02-27,2383,430,0,86662,970,3583,4123, ,6,149,0,86662,11,425,563,-540,-138
2025-03-03,2383,244,0,86662,214,3613,3583, ,3,90,3,86662,9,341,425,30,-84
2025-03-04,2383,617,6,86662,130,4094,3613, ,2,98,10,86662,6,239,341,481,-102
2025-03-05,2383,300,2,86662,203,4189,4094, ,0,34,0,86662,1,206,239,95,-33
2025-03-06,2383,326,1,86662,197,4317,4189,X ,3,77,0,86662,2,131,206,128,-75
2025-03-07,2383,537,0,86662,274,4580,4317,X ,0,130,0,86662,0,1,131,263,-130
2025-03-10,2383,199,0,86662,169,4610,4580,X ,0,0,1,86662,0,0,1,30,-1
2025-03-11,2383,312,0,86662,296,4626,4610,X ,0,0,0,86662,0,0,0,16,0
2025-03-12,2383,348,0,86662,251,4723,4626, ,0,0,0,86662,0,0,0,97,0
2025-03-13,2383,145,0,86662,251,4617,4723, ,74,0,0,86662,211,211,0,-106,211
2025-03-14,2383,126,0,86674,83,4660,4617, ,94,16,0,86674,61,256,211,43,45
2025-03-17,2383,185,0,86674,73,4772,4660, ,0,0,0,86674,72,328,256,112,72
2025-03-18,2383,351,0,86674,372,4751,4772, ,1,14,0,86674,136,450,328,-21,122
2025-03-19,2383,337,0,86674,402,4686,4751, ,1,102,0,86674,16,364,450,-65,-86
2025-03-20,2383,369,0,86674,240,4815,4686, ,1,25,0,86674,28,367,364,129,3
2025-03-21,2383,161,0,86674,261,4715,4815, ,2,15,0,86674,86,438,367,-100,71
2025-03-24,2383,192,0,86674,403,4504,4715, ,18,20,0,86674,94,512,438,-211,74
2025-03-25,2383,158,0,86674,263,4399,4504, ,3,9,0,86674,60,563,512,-105,51
2025-03-26,2383,91,0,86674,176,4314,4399, ,10,41,0,86674,24,546,563,-85,-17
2025-03-27,2383,158,0,86674,94,4378,4314, ,4,79,0,86674,24,491,546,64,-55
2025-03-28,2383,96,0,86674,94,4380,4378, ,5,56,0,86674,40,475,491,2,-16
2025-03-31,2383,293,0,86674,565,4108,4380, ,2,110,0,86674,52,417,475,-272,-58
2025-04-01,2383,299,0,86674,139,4268,4108, ,1,128,0,86674,58,347,417,160,-70
2025-04-02,2383,442,4,86674,109,4597,4268, ,1,73,0,86674,104,378,347,329,31
2025-04-07,2383,11,41,86674,246,4321,4597, ,0,0,0,86674,12,390,378,-276,12
2025-04-08,2383,543,23,86674,813,4028,4321, ,0,137,0,86674,40,293,390,-293,-97
2025-04-09,2383,312,10,86674,580,3750,4028, ,1,75,0,86674,94,312,293,-278,19
2025-04-10,2383,145,8,86674,40,3847,3750, ,0,9,0,86674,1,304,312,97,-8
2025-04-11,2383,531,2,86674,575,3801,3847, ,10,20,0,86674,307,591,304,-46,287
2025-04-14,2383,340,13,86693,503,3625,3801, ,4,21,0,86693,170,740,591,-176,149
2025-04-15,2383,253,0,86693,239,3639,3625, ,0,25,50,86693,110,775,740,14,35
2025-04-16,2383,315,0,86693,239,3715,3639, ,12,86,0,86693,35,724,775,76,-51
2025-04-17,2383,335,0,86693,45,4005,3715, ,3,18,0,86693,15,721,724,290,-3
2025-04-18,2383,129,2,86693,128,4004,4005, ,8,12,0,86693,45,754,721,-1,33
2025-04-21,2383,91,4,86693,126,3965,4004, ,9,20,0,86693,53,787,754,-39,33
2025-04-22,2383,133,0,86693,274,3824,3965, ,1,99,0,86693,18,706,787,-141,-81
2025-04-23,2383,231,0,86693,131,3924,3824, ,3,29,0,86693,26,703,706,100,-3
2025-04-24,2383,78,2,86693,102,3898,3924, ,0,24,40,86693,12,651,703,-26,-52
2025-04-25,2383,516,1,86693,657,3756,3898, ,18,30,0,86693,164,785,651,-142,134
2025-04-28,2383,307,0,86693,472,3591,3756, ,0,78,0,86693,1,708,785,-165,-77
2025-04-29,2383,135,0,86693,221,3505,3591, ,1,17,0,86693,14,705,708,-86,-3
2025-04-30,2383,224,1,86693,47,3681,3505, ,0,24,0,86693,69,750,705,176,45
2025-05-02,2383,318,1,86693,835,3163,3681, ,9,83,0,86693,133,800,750,-518,50
2025-05-05,2383,438,0,86693,328,3273,3163, ,2,12,0,86693,254,1042,800,110,242
2025-05-06,2383,499,1,86693,189,3582,3273, ,2,50,0,86693,88,1080,1042,309,38
2025-05-07,2383,199,0,86693,259,3522,3582, ,0,32,0,86693,88,1136,1080,-60,56
2025-05-08,2383,739,0,86693,1325,2936,3522, ,3,35,1,86693,337,1437,1136,-586,301
2025-05-09,2383,308,1,86693,320,2923,2936, ,5,75,0,86693,109,1471,1437,-13,34
2025-05-12,2383,276,0,86693,435,2764,2923, ,0,53,0,86693,16,1434,1471,-159,-37
2025-05-13,2383,359,14,86693,637,2472,2764, ,3,103,16,86693,4,1319,1434,-292,-115
2025-05-14,2383,361,0,86693,362,2471,2472, ,5,33,1,86693,22,1307,1319,-1,-12
2025-05-15,2383,171,1,86693,155,2486,2471, ,1,22,6,86693,2,1281,1307,15,-26
2025-05-16,2383,262,0,86693,163,2585,2486, ,20,24,7,86693,15,1265,1281,99,-16
2025-05-19,2383,152,1,86693,226,2510,2585, ,0,71,0,86693,18,1212,1265,-75,-53
2025-05-20,2383,87,0,86693,88,2509,2510, ,0,5,44,86693,14,1177,1212,-1,-35
2025-05-21,2383,748,0,86693,478,2779,2509, ,4,38,48,86693,97,1188,1177,270,11
2025-05-22,2383,179,1,86693,264,2693,2779, ,1,8,28,86693,30,1182,1188,-86,-6
2025-05-23,2383,251,0,86693,423,2521,2693, ,1,23,230,86693,3,932,1182,-172,-250
2025-05-26,2383,189,3,86693,142,2565,2521, ,0,20,57,86693,13,868,932,44,-64
2025-05-27,2383,170,0,86693,167,2568,2565, ,3,27,15,86693,18,844,868,3,-24
2025-05-28,2383,262,0,86693,200,2630,2568, ,2,21,0,86693,15,838,844,62,-6
2025-05-29,2383,506,3,86693,263,2870,2630, ,32,27,4,86693,79,886,838,240,48
2025-06-02,2383,267,0,86693,322,2815,2870, ,8,16,0,86693,153,1023,886,-55,137
2025-06-03,2383,339,0,86693,337,2817,2815, ,1,42,0,86693,44,1025,1023,2,2
2025-06-04,2383,364,0,86693,266,2915,2817, ,1,14,4,86693,13,1020,1025,98,-5
2025-06-05,2383,132,1,86693,178,2868,2915, ,0,25,10,86693,4,989,1020,-47,-31
2025-06-06,2383,171,0,86693,262,2777,2868, ,2,5,16,86693,7,975,989,-91,-14
2025-06-09,2383,289,7,86693,361,2698,2777, ,6,29,9,86693,94,1031,975,-79,56
2025-06-10,2383,367,0,86693,460,2605,2698, ,21,36,52,86693,168,1111,1031,-93,80
2025-06-11,2383,507,4,86693,270,2838,2605, ,2,12,154,86693,71,1016,1111,233,-95
2025-06-12,2383,404,1,86693,450,2791,2838, ,2,20,16,86693,60,1040,1016,-47,24
2025-06-13,2383,224,2,86971,193,2820,2791, ,2,16,25,86971,52,1051,1040,29,11
2025-06-16,2383,211,0,86971,224,2807,2820, ,0,8,156,86971,21,908,1051,-13,-143
2025-06-17,2383,627,2,86971,454,2978,2807, ,6,11,69,86971,89,917,908,171,9
2025-06-18,2383,556,1,86971,400,3133,2978, ,1,37,36,86971,107,951,917,155,34
2025-06-19,2383,109,0,86971,239,3003,3133, ,0,9,19,86971,85,1008,951,-130,57
2025-06-20,2383,192,4,86971,234,2957,3003, ,1,30,11,86971,291,1258,1008,-46,250
2025-06-23,2383,156,5,86971,130,2978,2957, ,0,48,59,86971,55,1206,1258,21,-52
2025-06-24,2383,251,1,86971,447,2781,2978, ,1,33,48,86971,54,1179,1206,-197,-27
2025-06-25,2383,277,4,86971,254,2800,2781, ,2,16,53,86971,47,1157,1179,19,-22
2025-06-26,2383,215,0,86971,171,2844,2800, ,0,16,98,86971,3,1046,1157,44,-111
2025-06-27,2383,248,0,86971,257,2835,2844, ,1,6,37,86971,13,1016,1046,-9,-30
2025-06-30,2383,506,1,86971,581,2759,2835, ,2,9,113,86971,47,941,1016,-76,-75
2025-07-01,2383,228,2,86971,382,2603,2759, ,1,0,37,86971,36,940,941,-156,-1
2025-07-02,2383,132,3,86971,237,2495,2603, ,1,2,34,86971,20,924,940,-108,-16
2025-07-03,2383,517,0,86971,196,2816,2495, ,4,15,4,86971,55,960,924,321,36
2025-07-04,2383,578,3,86971,316,3075,2816, ,6,8,8,86971,45,989,960,259,29
2025-07-07,2383,103,0,86971,572,2606,3075, ,1,21,59,86971,9,918,989,-469,-71
2025-07-08,2383,495,0,86971,305,2796,2606, ,6,7,19,86971,127,1019,918,190,101
2025-07-09,2383,253,0,86971,384,2665,2796, ,1,11,24,86971,17,1001,1019,-131,-18
2025-07-10,2383,505,1,86971,271,2898,2665, ,7,12,16,86971,28,1001,1001,233,0
2025-07-11,2383,191,1,86971,379,2709,2898, ,1,10,57,86971,51,985,1001,-189,-16
2025-07-14,2383,192,0,88118,213,2688,2709, ,1,14,51,88118,26,946,985,-21,-39
2025-07-15,2383,378,3,88118,315,2748,2688, ,5,38,3,88118,62,967,946,60,21
2025-07-16,2383,525,0,88118,383,2890,2748, ,7,9,32,88118,29,955,967,142,-12
2025-07-17,2383,238,0,88118,252,2876,2890, ,1,26,71,88118,5,863,955,-14,-92
2025-07-18,2383,723,7,88118,474,3118,2876, ,7,18,74,88118,49,820,863,242,-43
2025-07-21,2383,201,2,88118,151,3166,3118, ,0,10,64,88118,1,747,820,48,-73
2025-07-22,2383,174,1,88118,381,2959,3167, ,4,12,41,88118,14,708,747,-208,-39
2025-07-23,2383,196,0,88118,62,3093,2959, ,0,6,11,88118,4,695,708,134,-13
2025-07-24,2383,140,0,88118,96,3137,3093, ,2,6,0,88118,26,715,695,44,20
2025-07-25,2383,103,0,88118,86,3154,3137, ,0,6,2,88118,9,716,715,17,1
2025-07-28,2383,163,0,88118,332,2985,3154, ,0,4,0,88118,25,737,716,-169,21
2025-07-29,2383,120,1,88118,255,2849,2985, ,0,48,25,88118,4,668,737,-136,-69
2025-07-30,2383,171,0,88118,199,2821,2849, ,0,4,18,88118,7,653,668,-28,-15
2025-07-31,2383,186,0,88118,419,2588,2821, ,1,10,1,88118,60,702,653,-233,49
2025-08-01,2383,387,0,88118,219,2756,2588, ,8,15,5,88118,39,721,702,168,19
2025-08-04,2383,198,0,88118,415,2539,2756, ,0,6,2,88118,6,719,721,-217,-2
2025-08-05,2383,209,1,88118,185,2562,2539, ,0,24,67,88118,31,659,719,23,-60
2025-08-06,2383,123,1,88118,112,2572,2562, ,0,28,7,88118,8,632,659,10,-27
2025-08-07,2383,304,1,88118,178,2697,2572, ,3,11,2,88118,13,632,632,125,0
2025-08-08,2383,136,21,88118,174,2638,2697, ,0,14,60,88118,6,564,632,-59,-68
2025-08-11,2383,174,3,88118,166,2643,2638, ,2,14,7,88118,2,545,564,5,-19
2025-08-12,2383,97,0,88118,148,2592,2643, ,1,6,1,88118,6,544,545,-51,-1
2025-08-13,2383,160,1,88118,247,2504,2592, ,1,27,1,88118,4,520,544,-88,-24
2025-08-14,2383,156,0,88796,57,2603,2504, ,1,26,2,88796,8,500,520,99,-20
2025-08-15,2383,373,0,88796,211,2765,2603, ,0,73,27,88796,20,420,500,162,-80
2025-08-18,2383,473,0,88796,205,3033,2765, ,0,42,0,88796,1,379,420,268,-41
2025-08-19,2383,408,0,88796,277,3164,3033, ,4,57,4,88796,2,320,379,131,-59
2025-08-20,2383,230,0,88796,230,3164,3164, ,0,34,0,88796,59,345,320,0,25
2025-08-21,2383,435,0,88796,114,3485,3164,X ,5,94,34,88796,6,223,345,321,-122
2025-08-22,2383,134,1,88796,161,3457,3485,X ,0,126,92,88796,0,5,223,-28,-218
2025-08-25,2383,200,1,88796,232,3424,3457,X ,0,0,5,88796,0,0,5,-33,-5
2025-08-26,2383,193,0,88796,104,3513,3424,X ,0,0,0,88796,0,0,0,89,0
2025-08-27,2383,152,1,88796,193,3471,3513, ,0,0,0,88796,0,0,0,-42,0
2025-08-28,2383,115,0,88796,93,3493,3471, ,42,0,0,88796,9,9,0,22,9
2025-08-29,2383,166,0,88796,187,3472,3493, ,36,3,0,88796,70,76,9,-21,67
2025-09-01,2383,166,3,88796,160,3475,3472, ,6,4,0,88796,24,96,76,3,20
2025-09-02,2383,185,1,88796,88,3571,3475, ,0,11,0,88796,29,114,96,96,18
2025-09-03,2383,39,1,88796,111,3498,3571, ,0,4,0,88796,38,148,114,-73,34
2025-09-04,2383,309,1,88796,197,3609,3498, ,9,15,0,88796,39,172,148,111,24
2025-09-05,2383,416,0,88796,144,3881,3609, ,3,4,0,88796,26,194,172,272,22
2025-09-08,2383,246,0,88796,148,3979,3881, ,0,8,17,88796,38,207,194,98,13
2025-09-09,2383,787,0,88796,434,4332,3979, ,2,9,11,88796,60,247,207,353,40
2025-09-10,2383,347,0,88796,178,4501,4332, ,1,5,8,88796,31,265,247,169,18
2025-09-11,2383,677,1,88796,1041,4136,4501, ,5,24,0,88796,107,348,265,-365,83
2025-09-12,2383,160,1,88891,924,3371,4136, ,1,3,25,88891,16,336,348,-765,-12
2025-09-15,2383,62,0,88891,699,2734,3371, ,1,27,7,88891,16,318,336,-637,-18
2025-09-16,2383,71,0,88891,498,2307,2734, ,1,18,31,88891,5,274,318,-427,-44
2025-09-17,2383,54,1,88891,179,2181,2307, ,1,0,13,88891,9,270,274,-126,-4
2025-09-18,2383,94,0,88891,110,2165,2181, ,1,15,1,88891,14,268,270,-16,-2
2025-09-19,2383,123,0,88891,446,1842,2165, ,1,22,0,88891,8,254,268,-323,-14
2024-09-23,2454,45,22,399833,91,5445,5513, ,0,7,0,399833,15,144,136,-68,8
2024-09-24,2454,228,0,399833,353,5320,5445, ,0,22,0,399833,39,161,144,-125,17
2024-09-25,2454,263,3,399833,201,5379,5320, ,1,6,0,399833,8,163,161,59,2
2024-09-26,2454,210,0,399833,364,5225,5379, ,1,1,0,399833,38,200,163,-154,37
2024-09-27,2454,319,0,399833,239,5305,5225, ,0,13,0,399833,10,197,200,80,-3
2024-09-30,2454,483,1,400423,107,5680,5305, ,1,29,0,400423,12,180,197,375,-17
2024-10-01,2454,201,1,400423,164,5716,5680, ,1,12,0,400423,11,179,180,36,-1
2024-10-04,2454,135,3,400423,171,5677,5716, ,1,0,0,400423,8,187,179,-39,8
2024-10-07,2454,389,4,400423,284,5778,5677, ,1,26,0,400423,8,169,187,101,-18
2024-10-08,2454,156,5,400423,102,5827,5778, ,0,5,0,400423,1,165,169,49,-4
2024-10-09,2454,81,5,400423,209,5694,5827, ,0,2,0,400423,5,168,165,-133,3
2024-10-11,2454,270,2,400423,533,5429,5694, ,0,4,0,400423,40,204,168,-265,36
2024-10-14,2454,273,0,400423,193,5509,5429, ,1,3,0,400423,0,201,204,80,-3
2024-10-15,2454,255,2,400423,235,5527,5509, ,0,15,1,400423,8,193,201,18,-8
2024-10-16,2454,192,1,400423,173,5545,5527, ,1,15,0,400423,8,186,193,18,-7
2024-10-17,2454,160,6,400423,67,5632,5545, ,0,7,0,400423,3,182,186,87,-4
2024-10-18,2454,173,20,400423,512,5273,5632, ,0,4,0,400423,17,195,182,-359,13
2024-10-21,2454,417,18,400423,231,5441,5273, ,0,6,0,400423,40,229,195,168,34
2024-10-22,2454,235,0,400423,423,5253,5441, ,0,44,0,400423,21,206,229,-188,-23
2024-10-23,2454,157,2,400423,178,5230,5253, ,1,9,0,400423,7,204,206,-23,-2
2024-10-24,2454,161,1,400423,200,5190,5230, ,1,15,0,400423,11,200,204,-40,-4
2024-10-25,2454,294,0,400423,281,5203,5190, ,0,18,0,400423,41,223,200,13,23
2024-10-28,2454,98,1,400423,301,4999,5203, ,1,3,0,400423,12,232,223,-204,9
2024-10-29,2454,231,3,400423,150,5077,4999, ,0,23,0,400423,5,214,232,78,-18
2024-10-30,2454,135,0,400423,65,5147,5077, ,0,8,0,400423,44,250,214,70,36
2024-11-01,2454,73,0,400423,111,5109,5147, ,1,44,0,400423,9,215,250,-38,-35
2024-11-04,2454,74,1,400423,83,5099,5109, ,1,6,0,400423,12,221,215,-10,6
2024-11-05,2454,88,1,400423,37,5149,5099, ,0,9,0,400423,3,215,221,50,-6
2024-11-06,2454,59,0,400423,113,5095,5149, ,0,2,0,400423,22,235,215,-54,20
2024-11-07,2454,162,1,400423,88,5168,5095, ,0,9,1,400423,4,229,235,73,-6
2024-11-08,2454,215,0,400423,159,5224,5168, ,1,37,0,400423,1,193,229,56,-36
2024-11-11,2454,190,1,400423,78,5335,5224, ,0,0,0,400423,5,198,193,111,5
2024-11-12,2454,123,0,400423,96,5362,5335, ,0,7,0,400423,7,198,198,27,0
2024-11-13,2454,92,0,400423,49,5405,5362, ,0,9,0,400423,4,193,198,43,-5
2024-11-14,2454,125,1,400423,82,5447,5405, ,0,19,0,400423,4,178,193,42,-15
2024-11-15,2454,37,5,400423,212,5267,5447, ,0,0,0,400423,11,189,178,-180,11
2024-11-18,2454,76,2,400423,89,5252,5267, ,0,15,0,400423,4,178,189,-15,-11
2024-11-19,2454,66,4,400423,209,5105,5252, ,0,5,0,400423,22,195,178,-147,17
2024-11-20,2454,102,3,400423,59,5145,5105, ,0,8,0,400423,11,198,195,40,3
2024-11-21,2454,50,5,400423,44,5146,5145, ,0,5,0,400423,14,207,198,1,9
2024-11-22,2454,197,0,400423,329,5014,5146, ,1,19,0,400423,29,217,207,-132,10
2024-11-25,2454,232,0,400423,157,5089,5014, ,0,10,0,400423,1,208,217,75,-9
2024-11-26,2454,69,0,400423,123,5035,5089, ,0,19,0,400423,5,194,208,-54,-14
2024-11-27,2454,100,8,400423,52,5075,5035, ,0,43,0,400423,7,158,194,40,-36
2024-11-28,2454,89,0,400421,51,5113,5075, ,0,21,0,400421,5,142,158,38,-16
2024-11-29,2454,91,0,400421,103,5101,5113, ,2,8,0,400421,17,151,142,-12,9
2024-12-02,2454,165,0,400421,327,4939,5101, ,0,10,0,400421,51,192,151,-162,41
2024-12-03,2454,171,9,400421,230,4871,4939, ,0,12,0,400421,10,190,192,-68,-2
2024-12-04,2454,175,2,400421,65,4979,4871, ,0,5,0,400421,14,199,190,108,9
2024-12-05,2454,238,16,400421,251,4950,4979, ,1,7,0,400421,23,215,199,-29,16
2024-12-06,2454,228,3,400421,209,4966,4950, ,0,24,0,400421,3,194,215,16,-21
2024-12-09,2454,158,0,400421,143,4981,4966, ,2,2,0,400421,3,195,194,15,1
2024-12-10,2454,365,1,400421,301,5044,4981, ,0,10,0,400421,36,221,195,63,26
2024-12-11,2454,93,1,400421,346,4790,5044, ,0,11,0,400421,10,220,221,-254,-1
2024-12-12,2454,419,5,400421,316,4888,4790, ,1,7,0,400421,35,248,220,98,28
2024-12-13,2454,145,25,400421,387,4621,4888, ,1,5,0,400421,90,333,248,-267,85
2024-12-16,2454,455,1,400421,344,4731,4621, ,0,44,0,400421,11,300,333,110,-33
2024-12-17,2454,214,1,400421,462,4482,4731, ,1,93,0,400421,18,225,300,-249,-75
2024-12-18,2454,180,2,400421,144,4516,4482, ,0,14,0,400421,0,211,225,34,-14
2024-12-19,2454,84,1,400421,147,4452,4516, ,1,4,0,400421,21,228,211,-64,17
2024-12-20,2454,161,1,400421,182,4430,4452, ,1,50,0,400421,22,200,228,-22,-28
2024-12-23,2454,119,1,400421,96,4452,4430, ,1,29,0,400421,15,186,200,22,-14
2024-12-24,2454,69,0,400421,109,4412,4452, ,0,42,0,400421,2,146,186,-40,-40
2024-12-25,2454,42,6,400421,92,4356,4412,X ,0,20,0,400421,1,127,146,-56,-19
2024-12-26,2454,74,14,400421,160,4256,4356,X ,0,109,10,400421,0,8,127,-100,-119
2024-12-27,2454,101,3,400421,190,4164,4256,X ,0,0,8,400421,0,0,8,-92,-8
2024-12-30,2454,147,1,400421,64,4246,4164,X ,0,0,0,400421,0,0,0,82,0
2024-12-31,2454,208,3,400421,94,4357,4246, ,0,0,0,400421,0,0,0,111,0
2025-01-02,2454,404,37,400421,82,4642,4357, ,14,0,0,400421,20,20,0,285,20
2025-01-03,2454,63,1,400421,77,4627,4642, ,10,0,0,400421,52,72,20,-15,52
2025-01-06,2454,116,0,400421,459,4284,4627, ,1,32,0,400421,65,105,72,-343,33
2025-01-07,2454,583,58,400421,512,4297,4284, ,3,25,0,400421,61,141,105,13,36
2025-01-08,2454,443,53,400421,333,4354,4297, ,3,10,0,400421,22,153,141,57,12
2025-01-09,2454,235,1,400421,218,4370,4354, ,1,26,0,400421,4,131,153,16,-22
2025-01-10,2454,170,21,400421,212,4307,4370, ,2,3,0,400421,19,147,131,-63,16
2025-01-13,2454,419,15,400421,183,4528,4307, ,0,99,0,400421,7,55,147,221,-92
2025-01-14,2454,133,15,400421,99,4547,4528, ,0,6,0,400421,28,77,55,19,22
2025-01-15,2454,147,52,400421,171,4471,4547, ,0,12,0,400421,18,83,77,-76,6
2025-01-16,2454,159,0,400421,217,4413,4471, ,0,5,0,400421,16,94,83,-58,11
2025-01-17,2454,131,9,400421,113,4422,4413, ,0,13,0,400421,7,88,94,9,-6
2025-01-20,2454,147,5,400421,77,4487,4422, ,0,1,0,400421,6,93,88,65,5
2025-01-21,2454,109,3,400421,229,4364,4487, ,0,6,0,400421,30,117,93,-123,24
2025-01-22,2454,187,3,400421,125,4423,4364, ,0,1,0,400421,11,127,117,59,10
2025-02-03,2454,446,3,400421,497,4367,4421, ,3,12,0,400421,54,169,127,-54,42
2025-02-04,2454,289,1,400421,105,4550,4367, ,0,14,0,400421,21,176,169,183,7
2025-02-05,2454,272,0,400421,285,4537,4550, ,0,4,0,400421,22,194,176,-13,18
2025-02-06,2454,581,2,400421,302,4814,4537, ,4,5,0,400421,10,199,194,277,5
2025-02-07,2454,377,0,400421,283,4908,4814, ,0,6,0,400421,26,219,199,94,20
2025-02-10,2454,443,1,400421,278,5072,4908, ,1,53,0,400421,3,169,219,164,-50
2025-02-11,2454,197,0,400421,393,4876,5072, ,0,4,0,400421,22,187,169,-196,18
2025-02-12,2454,366,9,400421,189,5044,4876, ,2,15,0,400421,4,176,187,168,-11
2025-02-13,2454,65,1,400421,344,4764,5044, ,0,3,0,400421,16,189,176,-280,13
2025-02-14,2454,129,1,400421,165,4727,4764, ,0,5,0,400421,26,210,189,-37,21
2025-02-17,2454,332,4,400421,332,4723,4727, ,0,20,0,400421,23,213,210,-4,3
2025-02-18,2454,255,1,400421,119,4858,4723, ,0,10,0,400421,2,205,213,135,-8
2025-02-19,2454,71,2,400421,132,4795,4858, ,0,1,0,400421,5,209,205,-63,4
2025-02-20,2454,433,5,400421,208,5015,4795, ,0,27,0,400421,2,184,209,220,-25
2025-02-21,2454,77,4,400421,223,4865,5015, ,0,1,2,400421,3,184,184,-150,0
2025-02-24,2454,72,0,400421,405,4532,4865, ,0,6,0,400421,33,211,184,-333,27
2025-02-25,2454,109,1,400421,123,4517,4532, ,0,3,0,400421,15,223,211,-15,12
2025-02-26,2454,270,0,400421,147,4640,4517, ,1,8,0,400421,23,238,223,123,15
2025-02-27,2454,295,0,400421,270,4665,4640, ,2,44,0,400421,4,198,238,25,-40
2025-03-03,2454,384,1,400421,109,4939,4665, ,0,59,0,400421,3,142,198,274,-56
2025-03-04,2454,262,0,400415,226,4975,4939, ,0,10,0,400415,22,154,142,36,12
2025-03-05,2454,125,1,400415,197,4902,4975, ,0,5,0,400415,13,162,154,-73,8
2025-03-06,2454,133,1,400415,49,4985,4902, ,0,0,0,400415,1,163,162,83,1
2025-03-07,2454,241,1,400415,99,5126,4985, ,1,28,0,400415,1,136,163,141,-27
2025-03-10,2454,553,3,400415,289,5387,5126, ,0,66,0,400415,1,71,136,261,-65
2025-03-11,2454,221,0,400415,230,5378,5387, ,1,8,0,400415,36,99,71,-9,28
2025-03-12,2454,173,30,400415,156,5365,5378, ,2,1,1,400415,24,121,99,-13,22
2025-03-13,2454,273,61,400415,218,5359,5365, ,1,13,0,400415,10,118,121,-6,-3
2025-03-14,2454,86,1,400415,179,5265,5359, ,2,21,0,400415,30,127,118,-94,9
2025-03-17,2454,61,14,400415,237,5075,5265, ,0,13,1,400415,8,121,127,-190,-6
2025-03-18,2454,94,3,400415,407,4759,5075, ,4,38,0,400415,22,105,121,-316,-16
2025-03-19,2454,334,32,400415,209,4852,4759, ,1,28,2,400415,2,77,105,93,-28
2025-03-20,2454,182,2,400415,153,4879,4852,X ,1,4,0,400415,12,85,77,27,8
2025-03-21,2454,87,0,400415,115,4851,4879,X ,0,85,0,400415,0,0,85,-28,-85
2025-03-24,2454,91,20,400415,260,4662,4851,X ,0,0,0,400415,0,0,0,-189,0
2025-03-25,2454,173,0,400415,547,4288,4662,X ,0,0,0,400415,0,0,0,-374,0
2025-03-26,2454,167,2,400415,62,4391,4288, ,0,0,0,400415,0,0,0,103,0
2025-03-27,2454,207,0,400415,148,4450,4391, ,15,0,0,400415,21,21,0,59,21
2025-03-28,2454,197,0,400415,138,4509,4450, ,18,3,0,400415,20,38,21,59,17
2025-03-31,2454,313,30,400415,181,4611,4509, ,0,17,0,400415,32,53,38,102,15
2025-04-01,2454,122,27,400415,211,4495,4611, ,1,15,0,400415,46,84,53,-116,31
2025-04-02,2454,190,21,400415,56,4608,4495, ,0,26,0,400415,14,72,84,113,-12
2025-04-07,2454,48,40,400415,233,4383,4608, ,0,2,0,400415,243,313,72,-225,241
2025-04-08,2454,728,7,400415,500,4604,4383, ,1,287,0,400415,4,30,313,221,-283
2025-04-09,2454,675,20,400415,829,4430,4604, ,6,8,0,400415,27,49,30,-174,19
2025-04-10,2454,212,2,400415,125,4515,4430, ,0,7,0,400415,4,46,49,85,-3
2025-04-11,2454,540,1,400415,841,4213,4515, ,2,26,0,400415,68,88,46,-302,42
2025-04-14,2454,342,11,400415,464,4080,4213, ,6,6,0,400415,21,103,88,-133,15
2025-04-15,2454,243,15,400415,151,4157,4080, ,1,3,0,400415,8,108,103,77,5
2025-04-16,2454,115,48,400415,129,4095,4157, ,1,20,0,400415,10,98,108,-62,-10
2025-04-17,2454,205,19,400415,92,4189,4095, ,0,40,0,400415,19,77,98,94,-21
2025-04-18,2454,114,0,400415,141,4162,4189, ,2,8,0,400415,10,79,77,-27,2
2025-04-21,2454,105,19,400415,108,4140,4162, ,1,3,0,400415,24,99,78,-22,21
2025-04-22,2454,256,22,400415,116,4258,4140, ,0,33,0,400415,19,85,99,118,-14
2025-04-23,2454,144,36,400415,337,4029,4258, ,0,16,0,400415,33,102,85,-229,17
2025-04-24,2454,242,34,400415,100,4137,4029, ,0,17,0,400415,4,89,102,108,-13
2025-04-25,2454,157,19,400415,325,3950,4137, ,0,4,0,400415,23,108,89,-187,19
2025-04-28,2454,374,23,400415,21,4280,3950, ,1,8,0,400415,2,102,108,330,-6
2025-04-29,2454,205,35,400415,117,4333,4280, ,0,12,0,400415,23,113,102,53,11
2025-04-30,2454,306,17,400415,101,4521,4333, ,0,5,0,400415,69,177,113,188,64
2025-05-02,2454,1160,23,400415,211,5447,4521, ,1,124,0,400415,6,59,177,926,-118
2025-05-05,2454,175,0,400415,251,5371,5447, ,1,8,0,400415,69,120,59,-76,61
2025-05-06,2454,222,3,400415,61,5529,5371, ,2,14,0,400415,13,119,120,158,-1
2025-05-07,2454,148,4,400415,127,5546,5529, ,1,8,0,400415,26,137,119,17,18
2025-05-08,2454,152,18,400415,111,5569,5546, ,0,23,0,400415,14,128,137,23,-9
2025-05-09,2454,119,13,400415,351,5324,5569, ,1,63,0,400415,3,68,128,-245,-60
2025-05-12,2454,282,9,400415,143,5454,5324, ,0,5,0,400415,3,66,68,130,-2
2025-05-13,2454,351,8,400415,457,5340,5454, ,0,3,0,400415,18,81,66,-114,15
2025-05-14,2454,214,2,400415,151,5401,5340, ,1,3,0,400415,13,91,81,61,10
2025-05-15,2454,101,2,400415,314,5186,5401, ,1,1,0,400415,13,103,91,-215,12
2025-05-16,2454,234,1,400415,72,5347,5186, ,0,3,0,400415,1,101,103,161,-2
2025-05-19,2454,371,3,400415,204,5511,5347, ,0,26,0,400415,55,130,101,164,29
2025-05-20,2454,274,3,400415,294,5488,5511, ,1,1,0,400415,41,170,130,-23,40
2025-05-21,2454,240,2,400415,203,5523,5488, ,0,6,0,400415,13,177,170,35,7
2025-05-22,2454,79,7,400415,55,5540,5523, ,0,6,0,400415,3,174,177,17,-3
2025-05-23,2454,138,7,400415,39,5632,5540, ,0,5,0,400415,7,176,174,92,2
2025-05-26,2454,349,8,400415,137,5836,5632, ,0,11,0,400415,7,172,176,204,-4
2025-05-27,2454,95,9,400414,68,5854,5836, ,0,8,0,400414,3,167,172,18,-5
2025-05-28,2454,129,2,400414,81,5900,5854, ,0,39,0,400414,11,139,167,46,-28
2025-05-29,2454,237,11,400414,146,5980,5900, ,2,12,0,400414,3,130,139,80,-9
2025-06-02,2454,202,5,400414,137,6040,5980, ,0,11,0,400414,40,159,130,60,29
2025-06-03,2454,74,10,400414,157,5947,6040, ,0,15,0,400414,13,157,159,-93,-2
2025-06-04,2454,450,2,400414,199,6196,5947, ,0,49,0,400414,6,114,157,249,-43
2025-06-05,2454,506,5,400414,32,6665,6196, ,0,36,0,400414,11,89,114,469,-25
2025-06-06,2454,107,4,400414,527,6241,6665, ,0,5,0,400414,31,115,89,-424,26
2025-06-09,2454,162,21,400414,128,6254,6241, ,0,7,0,400414,1,109,115,13,-6
2025-06-10,2454,337,4,400414,670,5917,6254, ,0,9,0,400414,31,131,109,-337,22
2025-06-11,2454,535,4,400414,238,6210,5917, ,2,4,0,400414,50,177,131,293,46
2025-06-12,2454,318,2,400414,149,6377,6210, ,1,15,0,400414,14,176,177,167,-1
2025-06-13,2454,307,2,400414,207,6475,6377, ,0,17,0,400414,17,176,176,98,0
2025-06-16,2454,142,3,400414,73,6541,6475, ,1,4,2,400414,6,176,176,66,0
2025-06-17,2454,139,6,400414,191,6483,6541, ,0,6,0,400414,7,177,176,-58,1
2025-06-18,2454,67,31,400414,187,6332,6483, ,0,6,0,400414,3,174,177,-151,-3
2025-06-19,2454,114,8,400414,49,6389,6332, ,0,16,0,400414,0,158,174,57,-16
2025-06-20,2454,172,5,400414,34,6522,6389, ,0,24,19,400414,3,118,158,133,-40
2025-06-23,2454,32,3,400414,90,6461,6522, ,0,4,0,400414,7,121,118,-61,3
2025-06-24,2454,75,27,400414,80,6429,6461, ,0,21,0,400414,0,100,121,-32,-21
2025-06-25,2454,50,2,400414,366,6111,6429, ,0,16,0,400414,3,87,100,-318,-13
2025-06-26,2454,102,8,400414,88,6117,6111,X ,0,6,0,400414,6,87,87,6,0
2025-06-27,2454,85,6,400414,82,6114,6117,X ,0,82,0,400414,0,5,87,-3,-82
2025-06-30,2454,295,5,400414,65,6339,6114,X ,0,0,5,400414,0,0,5,225,-5
2025-07-01,2454,224,3,400414,399,6161,6339,X ,0,0,0,400414,0,0,0,-178,0
2025-07-02,2454,439,2,400414,221,6377,6161, ,0,0,0,400414,0,0,0,216,0
2025-07-03,2454,275,6,400414,178,6468,6377, ,24,0,0,400414,7,7,0,91,7
2025-07-04,2454,159,87,400414,673,5867,6468, ,19,0,0,400414,35,42,7,-601,35
2025-07-07,2454,129,5,400414,39,5952,5867, ,0,14,0,400414,11,39,42,85,-3
2025-07-08,2454,98,3,400414,72,5975,5952, ,0,4,0,400414,10,45,39,23,6
2025-07-09,2454,309,1,400414,700,5583,5975, ,5,2,0,400414,75,118,45,-392,73
2025-07-10,2454,162,0,400414,475,5270,5583, ,2,38,0,400414,67,147,118,-313,29
2025-07-11,2454,260,10,400414,272,5248,5270, ,1,4,3,400414,15,155,147,-22,8
2025-07-14,2454,271,10,400414,303,5206,5248, ,1,12,0,400414,6,149,155,-42,-6
2025-07-15,2454,154,3,400414,86,5271,5206, ,1,2,1,400414,9,155,149,65,6
2025-07-16,2454,91,4,400414,331,5027,5271, ,0,2,0,400414,4,157,155,-244,2
2025-07-17,2454,229,4,400414,82,5170,5027, ,0,5,0,400414,8,160,157,143,3
2025-07-18,2454,40,5,400414,232,4973,5170, ,0,5,0,400414,9,164,160,-197,4
2025-07-21,2454,281,1,400414,250,5003,4973, ,3,6,0,400414,7,165,164,30,1
2025-07-22,2454,207,9,400414,358,4843,5003, ,1,1,0,400414,38,202,165,-160,37
2025-07-23,2454,178,3,400414,100,4918,4843, ,1,4,0,400414,11,209,202,75,7
2025-07-24,2454,276,1,400414,76,5117,4918, ,0,4,0,400414,1,206,209,199,-3
2025-07-25,2454,237,8,400414,65,5281,5117, ,0,7,0,400414,7,206,206,164,0
2025-07-28,2454,369,0,400414,86,5564,5281, ,1,20,0,400414,10,196,206,283,-10
2025-07-29,2454,439,3,400414,146,5854,5564, ,0,58,0,400414,1,139,196,290,-57
2025-07-30,2454,104,8,400414,166,5784,5854, ,0,0,0,400414,10,149,139,-70,10
2025-07-31,2454,161,150,400414,66,5729,5784, ,2,12,0,400414,1,138,149,-55,-11
2025-08-01,2454,283,5,400414,76,5931,5729, ,0,11,0,400414,8,135,138,202,-3
2025-08-04,2454,123,2,400414,59,5993,5931, ,0,17,0,400414,1,119,135,62,-16
2025-08-05,2454,72,6,400414,56,6003,5993, ,0,5,0,400414,1,115,119,10,-4
2025-08-06,2454,176,7,400414,67,6105,6003, ,0,18,0,400414,0,97,115,102,-18
2025-08-07,2454,83,5,400414,346,5837,6105, ,0,2,0,400414,9,104,97,-268,7
2025-08-08,2454,64,9,400414,44,5848,5837, ,0,5,0,400414,3,102,104,11,-2
2025-08-11,2454,63,6,400414,75,5830,5848, ,0,1,0,400414,3,104,102,-18,2
2025-08-12,2454,91,42,400414,120,5759,5830, ,0,0,0,400414,2,106,104,-71,2
2025-08-13,2454,147,50,400414,196,5660,5759, ,0,1,0,400414,6,111,106,-99,5
2025-08-14,2454,86,1,400414,192,5553,5660, ,1,3,0,400414,3,111,111,-107,0
2025-08-15,2454,136,1,400414,75,5613,5553, ,0,3,0,400414,2,110,111,60,-1
2025-08-18,2454,77,22,400414,550,5118,5613, ,0,0,0,400414,18,128,110,-495,18
2025-08-19,2454,351,24,400414,219,5226,5118, ,1,8,0,400414,2,122,128,108,-6
2025-08-20,2454,183,2,400414,107,5300,5226, ,1,21,0,400414,10,111,122,74,-11
2025-08-21,2454,31,35,400414,67,5229,5300, ,0,7,0,400414,4,108,111,-71,-3
2025-08-22,2454,24,6,400412,46,5201,5229, ,0,0,0,400412,4,112,108,-28,4
2025-08-25,2454,200,2,400412,396,5003,5201, ,3,6,0,400412,13,119,112,-198,7
2025-08-26,2454,167,3,400412,80,5087,5003, ,0,2,0,400412,3,120,119,84,1
2025-08-27,2454,85,23,400412,135,5014,5087, ,0,2,0,400412,1,119,120,-73,-1
2025-08-28,2454,119,27,400412,122,4984,5014, ,0,3,0,400412,1,117,119,-30,-2
2025-08-29,2454,157,1,400412,101,5039,4984, ,0,54,0,400412,1,64,117,55,-53
2025-09-01,2454,85,0,400412,94,5030,5039, ,0,4,0,400412,1,61,64,-9,-3
2025-09-02,2454,48,1,400412,77,5000,5030, ,0,1,0,400412,49,109,61,-30,48
2025-09-03,2454,75,4,400412,263,4808,5000, ,0,1,0,400412,30,138,109,-192,29
2025-09-04,2454,60,21,400412,49,4798,4808, ,0,5,0,400412,6,139,138,-10,1
2025-09-05,2454,185,16,400412,395,4572,4798, ,3,45,0,400412,22,116,139,-226,-23
2025-09-08,2454,238,1,400412,233,4576,4572, ,1,0,0,400412,1,117,116,4,1
2025-09-09,2454,347,0,400412,529,4394,4576, ,2,7,0,400412,34,144,117,-182,27
2025-09-10,2454,324,23,400412,237,4458,4394, ,1,5,0,400412,2,141,144,64,-3
2025-09-11,2454,130,9,400412,168,4411,4458, ,0,6,0,400412,23,158,141,-47,17
2025-09-12,2454,161,2,400412,113,4457,4411, ,0,1,0,400412,7,164,158,46,6
2025-09-15,2454,64,7,400412,146,4368,4457, ,0,2,0,400412,19,181,164,-89,17
2025-09-16,2454,332,16,400412,357,4327,4368, ,1,18,0,400412,48,211,181,-41,30
2025-09-17,2454,164,4,400412,164,4323,4327, ,0,16,0,400412,3,198,211,-4,-13
2025-09-18,2454,173,0,400412,201,4295,4323, ,0,10,0,400412,6,194,198,-28,-4
2025-09-19,2454,657,3,400412,245,4704,4295, ,0,49,1,400412,10,154,194,409,-40
2024-09-23,3035,87,7,65137,163,14465,14548, ,1,5,0,65137,47,654,612,-83,42
2024-09-24,3035,210,21,65137,338,14316,14465, ,1,125,0,65137,59,588,654,-149,-66
2024-09-25,3035,382,0,65137,393,14305,14316, ,9,46,2,65137,82,622,588,-11,34
2024-09-26,3035,262,11,65137,149,14407,14305, ,3,36,0,65137,23,609,622,102,-13
2024-09-27,3035,724,4,65137,559,14568,14407, ,10,72,1,65137,44,580,609,161,-29
2024-09-30,3035,282,1,65137,184,14665,14568, ,6,32,2,65137,34,580,580,97,0
2024-10-01,3035,352,5,65137,152,14860,14665, ,4,27,0,65137,24,577,580,195,-3
2024-10-04,3035,129,2,65137,128,14859,14860, ,1,19,0,65137,28,586,577,-1,9
2024-10-07,3035,153,1,65137,119,14892,14859, ,3,26,0,65137,23,583,586,33,-3
2024-10-08,3035,209,4,65137,167,14930,14892, ,7,98,0,65137,50,535,583,38,-48
2024-10-09,3035,151,1,65137,210,14870,14930, ,2,24,0,65137,36,547,535,-60,12
2024-10-11,3035,272,4,65137,428,14710,14870, ,10,48,0,65137,65,564,547,-160,17
2024-10-14,3035,536,8,65137,360,14878,14710, ,10,41,0,65137,52,575,564,168,11
2024-10-15,3035,389,0,65137,430,14837,14878, ,2,30,2,65137,48,591,575,-41,16
2024-10-16,3035,315,2,65137,278,14872,14837, ,7,45,0,65137,38,584,591,35,-7
2024-10-17,3035,215,3,65137,189,14895,14872, ,0,12,0,65137,2,574,584,23,-10
2024-10-18,3035,290,2,65137,205,14978,14895, ,2,65,1,65137,11,519,574,83,-55
2024-10-21,3035,181,10,65137,463,14686,14978, ,5,35,0,65137,116,600,519,-292,81
2024-10-22,3035,284,0,65137,92,14878,14686, ,0,43,0,65137,11,568,600,192,-32
2024-10-23,3035,141,0,65137,154,14865,14878, ,5,19,0,65137,1,550,568,-13,-18
2024-10-24,3035,420,1,65137,224,15060,14865, ,11,109,0,65137,93,534,550,195,-16
2024-10-25,3035,426,3,65137,139,15344,15060, ,2,36,0,65137,149,647,534,284,113
2024-10-28,3035,136,3,65137,135,15342,15344, ,1,24,0,65137,153,776,647,-2,129
2024-10-29,3035,660,28,65137,571,15403,15342, ,8,150,0,65137,324,950,776,61,174
2024-10-30,3035,784,18,65137,298,15871,15403, ,22,471,0,65137,74,553,950,468,-397
2024-11-01,3035,350,15,65137,193,16013,15871, ,17,183,0,65137,183,553,553,142,0
2024-11-04,3035,166,7,65137,99,16073,16013, ,8,39,0,65137,93,607,553,60,54
2024-11-05,3035,139,3,65137,184,16025,16073, ,2,32,2,65137,41,614,607,-48,7
2024-11-06,3035,221,5,65137,341,15900,16025, ,10,97,0,65137,57,574,614,-125,-40
2024-11-07,3035,274,8,65137,219,15947,15900, ,1,95,0,65137,21,500,574,47,-74
2024-11-08,3035,266,13,65137,238,15962,15947, ,4,45,0,65137,46,501,500,15,1
2024-11-11,3035,116,2,65137,105,15971,15962, ,3,52,0,65137,20,469,501,9,-32
2024-11-12,3035,281,9,65137,190,16053,15971, ,3,146,0,65137,107,430,469,82,-39
2024-11-13,3035,179,4,65137,128,16100,16053, ,0,58,0,65137,41,413,430,47,-17
2024-11-14,3035,246,5,65137,294,16047,16100, ,1,17,0,65137,15,411,413,-53,-2
2024-11-15,3035,137,27,65137,184,15973,16047, ,4,22,0,65137,58,447,411,-74,36
2024-11-18,3035,165,12,65137,156,15970,15973, ,1,107,0,65137,59,399,447,-3,-48
2024-11-19,3035,219,4,65137,149,16036,15970, ,6,48,0,65137,62,413,399,66,14
2024-11-20,3035,141,7,65137,163,16007,16036, ,0,12,0,65137,17,418,413,-29,5
2024-11-21,3035,119,1,65137,72,16053,16007, ,1,12,0,65137,6,412,418,46,-6
2024-11-22,3035,159,0,65137,123,16089,16053, ,7,17,0,65137,6,401,412,36,-11
2024-11-25,3035,83,9,65137,180,15983,16089, ,0,24,1,65137,52,428,401,-106,27
2024-11-26,3035,171,4,65137,62,16088,15983, ,7,6,0,65137,3,425,428,105,-3
2024-11-27,3035,390,2,65137,270,16206,16088, ,1,117,0,65137,133,441,425,118,16
2024-11-28,3035,76,9,65137,340,15933,16206, ,5,34,0,65137,169,576,441,-273,135
2024-11-29,3035,104,6,65137,102,15929,15933, ,2,80,0,65137,53,549,576,-4,-27
2024-12-02,3035,103,6,65137,123,15903,15929, ,6,22,0,65137,58,585,549,-26,36
2024-12-03,3035,132,8,65137,87,15940,15903, ,6,45,7,65137,18,551,585,37,-34
2024-12-04,3035,375,1,65137,169,16145,15940, ,0,18,0,65137,52,585,551,205,34
2024-12-05,3035,518,0,65137,354,16309,16145, ,10,48,0,65137,37,574,585,164,-11
2024-12-06,3035,515,2,65137,585,16237,16309, ,9,19,0,65137,106,661,574,-72,87
2024-12-09,3035,1123,51,65137,487,16822,16237, ,7,2,0,65137,52,711,661,585,50
2024-12-10,3035,737,0,65137,419,17140,16822, ,4,28,0,65137,29,712,711,318,1
2024-12-11,3035,465,5,65137,286,17314,17140, ,4,61,0,65137,7,658,712,174,-54
2024-12-12,3035,151,4,65137,238,17223,17314, ,1,2,0,65137,16,672,658,-91,14
2024-12-13,3035,122,13,65137,320,17012,17223, ,3,1,0,65137,39,710,672,-211,38
2024-12-16,3035,1387,1,65137,500,17898,17012, ,12,29,2,65137,71,750,710,886,40
2024-12-17,3035,3355,10,65137,1590,19653,17898, ,27,39,0,65137,255,966,750,1755,216
2024-12-18,3035,985,2,65137,1440,19196,19653, ,10,58,0,65137,17,925,966,-457,-41
2024-12-19,3035,467,10,65137,697,18956,19196, ,7,60,2,65137,27,890,925,-240,-35
2024-12-20,3035,583,2,65137,541,18996,18956, ,3,28,0,65137,35,897,890,40,7
2024-12-23,3035,203,2,65137,424,18773,18996, ,2,1,0,65137,26,922,897,-223,25
2024-12-24,3035,244,6,65137,421,18590,18773, ,0,26,0,65137,1,897,922,-183,-25
2024-12-25,3035,124,1,65137,561,18152,18590, ,0,4,0,65137,12,905,897,-438,8
2024-12-26,3035,138,4,65137,124,18162,18152, ,0,9,0,65137,0,896,905,10,-9
2024-12-27,3035,969,6,65137,1795,17330,18162, ,12,40,0,65137,138,994,896,-832,98
2024-12-30,3035,895,6,65137,423,17796,17330, ,13,57,0,65137,9,946,994,466,-48
2024-12-31,3035,261,3,65137,262,17792,17796, ,9,8,0,65137,16,954,946,-4,8
2025-01-02,3035,383,0,65137,286,17889,17792, ,1,32,0,65137,18,940,954,97,-14
2025-01-03,3035,298,1,65137,156,18030,17889, ,1,17,0,65137,13,936,940,141,-4
2025-01-06,3035,337,20,65137,495,17852,18030, ,0,19,0,65137,186,1103,936,-178,167
2025-01-07,3035,538,0,65137,423,17967,17852, ,2,8,0,65137,20,1115,1103,115,12
2025-01-08,3035,614,9,65137,450,18122,17967, ,7,25,0,65137,18,1108,1115,155,-7
2025-01-09,3035,672,1,65137,770,18023,18122, ,3,172,0,65137,27,963,1108,-99,-145
2025-01-10,3035,216,4,65137,287,17948,18023, ,0,25,0,65137,45,983,963,-75,20
2025-01-13,3035,512,15,65137,1271,17174,17948, ,7,78,0,65137,47,952,983,-774,-31
2025-01-14,3035,347,9,65137,174,17338,17174, ,6,46,0,65137,47,953,952,164,1
2025-01-15,3035,180,8,65137,182,17328,17338, ,8,17,0,65137,80,1016,953,-10,63
2025-01-16,3035,82,1,65137,290,17119,17328, ,10,47,1,65137,57,1025,1016,-209,9
2025-01-17,3035,176,9,65137,129,17157,17119, ,2,24,2,65137,31,1030,1025,38,5
2025-01-20,3035,58,21,65137,301,16893,17157, ,0,47,0,65137,37,1020,1030,-264,-10
2025-01-21,3035,42,15,65137,160,16760,16893, ,5,11,0,65137,13,1022,1020,-133,2
2025-01-22,3035,110,40,65137,169,16661,16760, ,2,16,3,65137,5,1008,1022,-99,-14
2025-02-03,3035,204,12,65137,197,16634,16639, ,3,44,0,65137,32,996,1008,-5,-12
2025-02-04,3035,323,9,65137,426,16522,16634, ,1,9,2,65137,200,1185,996,-112,189
2025-02-05,3035,341,1,65137,837,16025,16522, ,8,23,0,65137,163,1325,1185,-497,140
2025-02-06,3035,444,3,65137,378,16088,16025, ,1,21,0,65137,50,1354,1325,63,29
2025-02-07,3035,309,10,65137,673,15714,16088, ,2,29,0,65137,62,1387,1354,-374,33
2025-02-10,3035,511,5,65137,339,15881,15714, ,4,30,0,65137,99,1456,1387,167,69
2025-02-11,3035,211,4,65137,327,15761,15881, ,1,34,0,65137,17,1439,1456,-120,-17
2025-02-12,3035,246,1,65137,231,15775,15761, ,0,8,0,65137,23,1454,1439,14,15
2025-02-13,3035,813,1,65137,380,16207,15775, ,5,33,0,65137,41,1462,1454,432,8
2025-02-14,3035,1609,5,65137,833,16978,16207, ,12,47,0,65137,86,1501,1462,771,39
2025-02-17,3035,889,1,65137,711,17155,16978, ,5,36,0,65137,336,1801,1501,177,300
2025-02-18,3035,1397,11,65137,1217,17324,17155, ,12,16,0,65137,113,1898,1801,169,97
2025-02-19,3035,2147,1,65137,1126,18344,17324, ,6,65,0,65137,258,2091,1898,1020,193
2025-02-20,3035,784,5,65137,1461,17662,18344, ,3,109,0,65137,31,2013,2091,-682,-78
2025-02-21,3035,397,5,65137,355,17699,17662, ,6,75,1,65137,29,1966,2013,37,-47
2025-02-24,3035,474,20,65137,624,17529,17699, ,6,981,1,65137,84,1068,1966,-170,-898
2025-02-25,3035,378,51,65137,264,17592,17529, ,1,282,0,65137,17,803,1068,63,-265
2025-02-26,3035,243,4,65137,479,17352,17592, ,0,66,0,65137,2,739,803,-240,-64
2025-02-27,3035,190,5,65137,305,17232,17352, ,1,16,0,65137,24,747,739,-120,8
2025-03-03,3035,216,3,65137,239,17206,17232, ,5,26,0,65137,51,772,747,-26,25
2025-03-04,3035,646,4,65137,410,17438,17206, ,6,50,9,65137,43,756,772,232,-16
2025-03-05,3035,376,1,65137,510,17303,17438, ,4,12,3,65137,15,756,756,-135,0
2025-03-06,3035,416,1,65137,334,17384,17303, ,0,73,8,65137,3,678,756,81,-78
2025-03-07,3035,239,4,65137,337,17282,17384, ,15,20,0,65137,18,676,678,-102,-2
2025-03-10,3035,1289,4,65137,987,17580,17282, ,16,59,8,65137,26,635,676,298,-41
2025-03-11,3035,403,6,65137,432,17545,17580, ,9,86,6,65137,44,587,635,-35,-48
2025-03-12,3035,724,5,65137,387,17877,17545, ,3,117,0,65137,32,502,587,332,-85
2025-03-13,3035,270,6,65137,520,17621,17877, ,3,67,0,65137,14,449,502,-256,-53
2025-03-14,3035,180,4,65137,210,17587,17621,X ,5,242,22,65137,30,215,449,-34,-234
2025-03-17,3035,272,4,65137,181,17674,17587,X ,0,197,16,65137,0,2,215,87,-213
2025-03-18,3035,122,5,65137,194,17597,17674,X ,0,0,2,65137,0,0,2,-77,-2
2025-03-19,3035,259,8,65137,446,17402,17597,X ,0,0,0,65137,0,0,0,-195,0
2025-03-20,3035,651,4,65137,798,17251,17402, ,0,0,0,65137,0,0,0,-151,0
2025-03-21,3035,540,8,65137,1341,16442,17251, ,155,0,0,65137,304,304,0,-809,304
2025-03-24,3035,770,6,65137,575,16631,16442, ,156,22,0,65137,183,465,304,189,161
2025-03-25,3035,652,0,65137,628,16655,16631, ,11,30,0,65137,133,568,465,24,103
2025-03-26,3035,473,13,65137,356,16759,16655, ,4,95,0,65137,34,507,568,104,-61
2025-03-27,3035,367,3,65137,471,16652,16759, ,0,113,0,65137,49,443,507,-107,-64
2025-03-28,3035,476,0,65137,701,16427,16652, ,11,142,1,65137,108,408,443,-225,-35
2025-03-31,3035,943,37,65137,1600,15733,16427, ,7,124,0,65137,84,368,408,-694,-40
2025-04-01,3035,390,5,65137,472,15646,15733, ,2,104,40,65137,111,335,368,-87,-33
2025-04-02,3035,245,8,65137,691,15192,15646, ,7,46,0,65137,333,622,335,-454,287
2025-04-07,3035,30,53,65137,97,15072,15192, ,0,31,0,65137,25,616,622,-120,-6
2025-04-08,3035,1510,163,65137,2859,13560,15072, ,0,292,0,65137,98,422,616,-1512,-194
2025-04-09,3035,633,113,65137,2183,11893,13556, ,12,30,19,65137,64,437,422,-1663,15
2025-04-10,3035,292,83,65137,230,11872,11893, ,0,37,46,65137,5,359,437,-21,-78
2025-04-11,3035,806,18,65137,665,11995,11872, ,14,52,1,65137,148,454,359,123,95
2025-04-14,3035,552,4,65137,766,11777,11995, ,3,36,0,65137,82,500,454,-218,46
2025-04-15,3035,513,16,65137,500,11774,11777, ,10,19,1,65137,170,650,500,-3,150
2025-04-16,3035,344,5,65137,559,11554,11774, ,6,100,0,65137,68,618,650,-220,-32
2025-04-17,3035,885,3,65137,649,11787,11554, ,23,92,0,65137,622,1148,618,233,530
2025-04-18,3035,639,2,65137,565,11859,11787, ,13,48,0,65137,130,1230,1148,72,82
2025-04-21,3035,166,7,65137,472,11546,11859, ,7,144,0,65137,101,1187,1230,-313,-43
2025-04-22,3035,351,11,65137,144,11742,11546, ,2,62,0,65137,143,1268,1187,196,81
2025-04-23,3035,2696,12,65137,1103,13323,11742, ,36,209,0,65137,397,1456,1268,1581,188
2025-04-24,3035,815,3,65137,842,13293,13323, ,15,224,0,65137,271,1503,1456,-30,47
2025-04-25,3035,765,7,65137,660,13391,13293, ,20,239,0,65137,82,1346,1503,98,-157
2025-04-28,3035,1196,12,65137,670,13905,13391, ,5,88,40,65137,54,1272,1346,514,-74
2025-04-29,3035,381,12,65137,531,13743,13905, ,0,246,142,65137,115,999,1272,-162,-273
2025-04-30,3035,573,4,65137,364,13948,13743, ,0,42,16,65137,116,1057,999,205,58
2025-05-02,3035,518,5,65137,592,13869,13948, ,4,97,20,65137,19,959,1057,-79,-98
2025-05-05,3035,643,8,65137,624,13880,13869, ,17,72,2,65137,133,1018,959,11,59
2025-05-06,3035,176,2,65137,259,13795,13880, ,6,63,28,65137,169,1096,1018,-85,78
2025-05-07,3035,220,1,65137,230,13784,13795, ,9,38,8,65137,22,1072,1096,-11,-24
2025-05-08,3035,273,3,65137,401,13653,13784, ,6,169,4,65137,61,960,1072,-131,-112
2025-05-09,3035,300,2,65137,300,13651,13653, ,2,68,0,65137,138,1030,960,-2,70
2025-05-12,3035,526,4,65137,647,13526,13651, ,7,56,30,65137,64,1008,1030,-125,-22
2025-05-13,3035,678,0,65137,642,13562,13526, ,4,67,1,65137,16,956,1008,36,-52
2025-05-14,3035,548,5,65137,633,13472,13562, ,0,57,0,65137,51,950,956,-90,-6
2025-05-15,3035,345,12,65137,345,13460,13472, ,1,8,3,65137,5,944,950,-12,-6
2025-05-16,3035,248,7,65137,205,13496,13460, ,0,23,0,65137,3,924,944,36,-20
2025-05-19,3035,315,1,65137,306,13504,13496, ,3,21,0,65137,103,1006,924,8,82
2025-05-20,3035,320,7,65137,313,13504,13504, ,1,9,0,65137,149,1146,1006,0,140
2025-05-21,3035,273,12,65137,341,13424,13504, ,6,96,0,65137,115,1165,1146,-80,19
2025-05-22,3035,291,1,65137,385,13329,13424, ,0,48,0,65137,6,1123,1165,-95,-42
2025-05-23,3035,187,6,65137,223,13287,13329, ,0,17,196,65137,31,941,1123,-42,-182
2025-05-26,3035,340,5,65137,349,13273,13287, ,3,92,19,65137,18,848,941,-14,-93
2025-05-27,3035,396,4,65137,228,13437,13273, ,0,68,0,65137,83,863,848,164,15
2025-05-28,3035,254,2,65137,163,13526,13437, ,2,219,0,65137,89,733,863,89,-130
2025-05-29,3035,183,6,65137,260,13443,13526, ,2,206,0,65137,94,621,733,-83,-112
2025-06-02,3035,677,30,65137,983,13107,13443, ,2,142,0,65137,546,1025,621,-336,404
2025-06-03,3035,138,7,65137,223,13015,13107, ,6,184,1,65137,143,983,1025,-92,-42
2025-06-04,3035,420,14,65137,625,12796,13015, ,12,418,4,65137,193,754,983,-219,-229
2025-06-05,3035,199,2,65137,279,12714,12796, ,1,37,18,65137,10,709,754,-82,-45
2025-06-06,3035,101,3,65137,149,12663,12714, ,1,138,0,65137,78,649,709,-51,-60
2025-06-09,3035,165,0,65137,116,12712,12663, ,1,64,175,65137,78,488,649,49,-161
2025-06-10,3035,349,6,65137,331,12724,12712,X ,0,255,0,65137,187,420,488,12,-68
2025-06-11,3035,166,19,65137,602,12269,12724,X ,0,415,2,65137,0,3,420,-455,-417
2025-06-12,3035,248,1,65137,321,12195,12269,X ,0,0,3,65137,0,0,3,-74,-3
2025-06-13,3035,155,9,65137,180,12161,12195,X ,0,0,0,65137,0,0,0,-34,0
2025-06-16,3035,174,9,65137,269,12057,12161, ,0,0,0,65137,0,0,0,-104,0
2025-06-17,3035,359,12,65137,149,12255,12057, ,59,0,0,65137,136,136,0,198,136
2025-06-18,3035,133,16,65137,183,12189,12255, ,24,5,0,65137,45,176,136,-66,40
2025-06-19,3035,1768,4,65137,651,13302,12189, ,11,33,0,65137,116,259,176,1113,83
2025-06-20,3035,979,4,65137,826,13451,13302, ,2,74,0,65137,210,395,259,149,136
2025-06-23,3035,282,1,65137,448,13284,13451, ,5,118,0,65137,54,331,395,-167,-64
2025-06-24,3035,285,4,65137,390,13175,13284, ,1,33,0,65137,64,362,331,-109,31
2025-06-25,3035,1036,4,65137,562,13645,13175, ,3,20,0,65137,73,415,362,470,53
2025-06-26,3035,805,14,65137,686,13750,13645, ,2,39,0,65137,8,384,415,105,-31
2025-06-27,3035,1514,10,65137,891,14363,13750, ,113,13,0,65137,62,433,384,613,49
2025-06-30,3035,523,12,65137,1111,13763,14363, ,2,7,0,65137,16,442,433,-600,9
2025-07-01,3035,990,16,65137,552,14185,13763, ,0,16,0,65137,348,774,442,422,332
2025-07-02,3035,539,11,65137,982,13731,14185, ,1,12,0,65137,67,829,774,-454,55
2025-07-03,3035,1315,18,65137,866,14162,13731, ,8,6,0,65137,13,836,829,431,7
2025-07-04,3035,557,9,65137,876,13834,14162, ,4,42,0,65137,18,812,836,-328,-24
2025-07-07,3035,208,1,65137,357,13684,13834, ,0,83,0,65137,56,785,812,-150,-27
2025-07-08,3035,419,9,65137,443,13651,13684, ,2,9,0,65137,36,812,785,-33,27
2025-07-09,3035,320,7,65137,364,13600,13651, ,5,54,0,65137,34,792,812,-51,-20
2025-07-10,3035,227,24,65137,199,13604,13600, ,0,63,0,65137,14,743,792,4,-49
2025-07-11,3035,224,10,65137,344,13474,13604, ,3,14,0,65137,53,782,743,-130,39
2025-07-14,3035,263,18,65137,87,13632,13474, ,0,67,0,65137,21,736,782,158,-46
2025-07-15,3035,180,15,65137,71,13726,13632, ,0,245,0,65137,20,511,736,94,-225
2025-07-16,3035,331,2,65137,304,13751,13726, ,3,21,0,65137,76,566,511,25,55
2025-07-17,3035,472,16,65137,349,13858,13751, ,8,32,0,65137,23,557,566,107,-9
2025-07-18,3035,407,22,65137,352,13891,13858, ,1,5,0,65137,20,572,557,33,15
2025-07-21,3035,174,24,65137,191,13850,13891, ,0,3,0,65137,44,613,572,-41,41
2025-07-22,3035,566,15,65137,452,13948,13849, ,0,147,0,65137,64,530,613,99,-83
2025-07-23,3035,302,2,65137,325,13923,13948, ,0,33,0,65137,82,579,530,-25,49
2025-07-24,3035,122,10,65137,157,13878,13923, ,3,64,0,65137,36,551,579,-45,-28
2025-07-25,3035,374,13,65137,103,14136,13878, ,0,15,0,65137,22,558,551,258,7
2025-07-28,3035,109,12,65137,125,14108,14136, ,0,51,0,65137,4,511,558,-28,-47
2025-07-29,3035,393,1,65137,317,14183,14108, ,1,210,0,65137,174,475,511,75,-36
2025-07-30,3035,1199,30,65137,2178,13174,14183, ,8,232,0,65137,86,329,475,-1009,-146
2025-07-31,3035,552,53,65137,337,13336,13174, ,6,78,0,65137,90,341,329,162,12
2025-08-01,3035,356,24,65137,375,13293,13336, ,3,43,8,65137,109,399,341,-43,58
2025-08-04,3035,191,15,65137,105,13364,13293, ,1,21,25,65137,46,399,399,71,0
2025-08-05,3035,121,31,65137,192,13262,13364, ,0,33,0,65137,26,392,399,-102,-7
2025-08-06,3035,193,21,65137,139,13295,13262, ,0,19,0,65137,13,386,392,33,-6
2025-08-07,3035,164,32,65137,138,13289,13295, ,0,28,0,65137,11,369,386,-6,-17
2025-08-08,3035,136,23,65137,108,13294,13289, ,0,27,0,65137,15,357,369,5,-12
2025-08-11,3035,94,35,65137,102,13251,13294, ,0,8,0,65137,2,351,357,-43,-6
2025-08-12,3035,134,13,65137,216,13156,13251, ,0,26,0,65137,165,490,351,-95,139
2025-08-13,3035,317,30,65137,202,13241,13156, ,0,27,0,65137,33,496,490,85,6
2025-08-14,3035,205,35,65137,71,13340,13241, ,0,6,0,65137,12,502,496,99,6
2025-08-15,3035,109,43,65137,106,13300,13340, ,2,29,0,65137,16,489,502,-40,-13
2025-08-18,3035,124,47,65137,148,13229,13300, ,0,43,0,65137,8,454,489,-71,-35
2025-08-19,3035,363,35,65137,157,13400,13229, ,1,6,0,65137,2,450,454,171,-4
2025-08-20,3035,1556,37,65137,1012,13907,13400, ,9,26,0,65137,267,691,450,507,241
2025-08-21,3035,715,6,65137,467,14149,13907, ,4,46,29,65137,19,635,691,242,-56
2025-08-22,3035,452,15,65137,432,14154,14149, ,0,418,4,65137,108,321,635,5,-314
2025-08-25,3035,207,16,65137,375,13970,14154, ,0,29,20,65137,254,526,321,-184,205
2025-08-26,3035,111,8,65137,180,13893,13970, ,0,39,0,65137,152,639,526,-77,113
2025-08-27,3035,226,16,65137,418,13685,13893, ,1,11,0,65137,104,732,639,-208,93
2025-08-28,3035,260,6,65137,304,13635,13685, ,0,3,0,65137,14,743,732,-50,11
2025-08-29,3035,638,21,65137,286,13966,13635, ,2,57,0,65137,113,799,743,331,56
2025-09-01,3035,168,12,65137,355,13767,13966, ,1,38,0,65137,6,767,799,-199,-32
2025-09-02,3035,288,7,65137,149,13899,13767, ,1,12,0,65137,48,803,767,132,36
2025-09-03,3035,66,18,65137,195,13752,13899, ,0,4,0,65137,14,813,803,-147,10
2025-09-04,3035,68,13,65137,212,13595,13752, ,0,14,0,65137,31,830,813,-157,17
2025-09-05,3035,80,19,65137,413,13243,13595, ,1,1,0,65137,28,857,830,-352,27
2025-09-08,3035,101,20,65137,276,13048,13243, ,2,2,0,65137,0,855,857,-195,-2
2025-09-09,3035,86,12,65137,147,12975,13048, ,0,16,0,65137,3,842,855,-73,-13
2025-09-10,3035,315,14,65137,117,13159,12975, ,0,38,0,65137,2,806,842,184,-36
2025-09-11,3035,310,16,65137,148,13305,13159, ,0,6,0,65137,28,828,806,146,22
2025-09-12,3035,583,34,65137,271,13583,13305, ,2,15,0,65137,26,839,828,278,11
2025-09-15,3035,402,15,65137,232,13738,13583, ,2,92,0,65137,13,760,839,155,-79
2025-09-16,3035,218,23,65137,193,13740,13738, ,0,33,0,65137,8,735,760,2,-25
2025-09-17,3035,373,12,65137,142,13959,13740, ,0,166,0,65137,1,570,735,219,-165
2025-09-18,3035,693,22,65137,355,14275,13959, ,5,60,0,65137,184,694,570,316,124
2025-09-19,3035,1512,18,65137,807,14962,14275, ,0,6,0,65137,181,869,694,687,175
2024-09-23,3293,145,0,70450,134,2244,2233,,0,5,0,70450,7,333,335,11,-2
2024-09-24,3293,135,0,70450,124,2255,2244,,0,5,0,70450,1,337,333,11,4
2024-09-25,3293,312,2,70450,254,2311,2255,,3,50,1,70450,5,381,337,56,44
2024-09-26,3293,570,7,70450,352,2522,2311,,9,35,0,70450,29,387,381,211,6
2024-09-27,3293,413,3,70450,594,2338,2522,,5,4,0,70450,29,362,387,-184,-25
2024-09-30,3293,248,1,70450,264,2321,2338,,2,12,0,70450,3,371,362,-17,9
2024-10-01,3293,270,0,70450,207,2384,2321,,0,11,0,70450,5,377,371,63,6
2024-10-04,3293,367,1,70450,268,2482,2384,,3,1,0,70450,24,354,377,98,-23
2024-10-07,3293,140,0,70450,71,2551,2482,,1,2,279,70450,5,72,354,69,-282
2024-10-08,3293,107,1,70450,166,2491,2551,,1,9,0,70450,4,77,72,-60,5
2024-10-09,3293,119,2,70450,168,2440,2491,,6,7,0,70450,0,84,77,-51,7
2024-10-11,3293,264,0,70450,383,2321,2440,,6,24,1,70450,5,102,84,-119,18
2024-10-14,3293,187,1,70450,170,2337,2321,,5,5,0,70450,17,90,102,16,-12
2024-10-15,3293,369,3,70450,150,2553,2337,,5,4,1,70450,9,84,90,216,-6
2024-10-16,3293,321,0,70450,258,2616,2553,,2,7,0,70450,2,89,84,63,5
2024-10-17,3293,89,0,70450,78,2627,2616,,1,2,0,70450,0,91,89,11,2
2024-10-18,3293,248,4,70450,180,2691,2627,,0,1,1,70450,3,88,91,64,-3
2024-10-21,3293,255,0,70450,221,2725,2691,,1,3,0,70450,2,89,88,34,1
2024-10-22,3293,153,4,70450,133,2741,2725,,2,2,0,70450,0,91,89,16,2
2024-10-23,3293,248,2,70450,208,2779,2741,,0,2,0,70450,6,87,91,38,-4
2024-10-24,3293,145,1,70450,262,2661,2779,,0,3,0,70450,7,83,87,-118,-4
2024-10-25,3293,112,0,70450,38,2735,2661,,0,1,1,70450,4,79,83,74,-4
2024-10-28,3293,171,1,70450,176,2729,2735,,0,10,0,70450,0,89,79,-6,10
2024-10-29,3293,111,0,70450,142,2698,2729,,0,1,0,70450,9,81,89,-31,-8
2024-10-30,3293,147,0,70450,59,2786,2698,,0,2,0,70450,12,71,81,88,-10
2024-11-01,3293,104,0,70450,99,2791,2786,,1,14,0,70450,5,80,71,5,9
2024-11-04,3293,130,0,70450,65,2856,2791,,1,4,0,70450,8,76,80,65,-4
2024-11-05,3293,76,1,70450,51,2880,2856,,0,20,0,70450,2,94,76,24,18
2024-11-06,3293,154,1,70450,114,2919,2880,,2,3,0,70450,5,92,94,39,-2
2024-11-07,3293,305,2,70450,94,3128,2919,,1,2,0,70450,3,91,92,209,-1
2024-11-08,3293,120,0,70450,77,3171,3128,,1,12,0,70450,3,100,91,43,9
2024-11-11,3293,46,7,70450,61,3149,3171,,0,0,0,70450,0,100,100,-22,0
2024-11-12,3293,98,5,70450,64,3178,3149,,2,3,0,70450,0,103,100,29,3
2024-11-13,3293,26,1,70450,117,3086,3178,,3,6,0,70450,3,106,103,-92,3
2024-11-14,3293,20,0,70450,63,3043,3086,,2,23,0,70450,4,125,106,-43,19
2024-11-15,3293,325,47,70450,217,3104,3043,,2,8,1,70450,37,95,125,61,-30
2024-11-18,3293,372,7,70450,296,3173,3104,,6,19,0,70450,8,106,95,69,11
2024-11-19,3293,246,0,70450,133,3286,3173,,2,55,1,70450,6,154,106,113,48
2024-11-20,3293,196,2,70450,128,3352,3286,,2,20,0,70450,11,163,154,66,9
2024-11-21,3293,123,1,70450,78,3396,3352,,3,32,0,70450,5,190,163,44,27
2024-11-22,3293,171,2,70450,290,3275,3396,,5,22,1,70450,9,202,190,-121,12
2024-11-25,3293,230,1,70450,202,3302,3275,,3,32,0,70450,67,167,202,27,-35
2024-11-26,3293,332,2,70450,194,3438,3302,,2,55,0,70450,57,165,167,136,-2
2024-11-27,3293,90,12,70450,136,3380,3438,,3,46,0,70450,37,174,165,-58,9
2024-11-28,3293,142,2,70450,113,3407,3380,,2,26,0,70450,78,122,174,27,-52
2024-11-29,3293,66,2,70450,152,3319,3407,,1,86,0,70450,15,193,122,-88,71
2024-12-02,3293,81,1,70450,166,3233,3319,,2,34,0,70450,40,187,193,-86,-6
2024-12-03,3293,128,4,70450,94,3263,3233,,0,8,0,70450,6,189,187,30,2
2024-12-04,3293,119,2,70450,152,3228,3263,,5,22,0,70450,6,205,189,-35,16
2024-12-05,3293,98,2,70450,152,3172,3228,,4,33,0,70450,1,237,205,-56,32
2024-12-06,3293,183,0,70450,108,3247,3172,,5,1,0,70450,1,237,237,75,0
2024-12-09,3293,121,3,70450,224,3141,3247,,4,9,1,70450,3,242,237,-106,5
2024-12-10,3293,210,2,70450,69,3280,3141,,0,2,0,70450,15,229,242,139,-13
2024-12-11,3293,49,1,70450,159,3169,3280,,0,14,0,70450,2,241,229,-111,12
2024-12-12,3293,46,2,70450,60,3153,3169,,0,4,0,70450,0,245,241,-16,4
2024-12-13,3293,38,16,70450,94,3081,3153,,0,3,0,70450,7,241,245,-72,-4
2024-12-16,3293,82,0,70450,88,3075,3081,,1,5,0,70450,84,162,241,-6,-79
2024-12-17,3293,63,2,70450,119,3017,3075,,1,37,0,70450,3,196,162,-58,34
2024-12-18,3293,19,1,70450,51,2984,3017,,2,1,0,70450,2,195,196,-33,-1
2024-12-19,3293,48,0,70450,123,2909,2984,,2,2,0,70450,16,181,195,-75,-14
2024-12-20,3293,129,0,70450,49,2989,2909,,0,0,0,70450,35,146,181,80,-35
2024-12-23,3293,81,5,70450,86,2979,2989,,0,0,0,70450,1,145,146,-10,-1
2024-12-24,3293,74,1,70450,34,3019,2980,,0,0,6,70450,1,138,145,39,-7
2024-12-25,3293,69,0,70450,44,3044,3019,,3,20,0,70450,8,150,138,25,12
2024-12-26,3293,29,2,70450,34,3037,3044,,0,1,0,70450,1,150,150,-7,0
2024-12-27,3293,31,2,70450,37,3029,3037,,0,3,0,70450,0,153,150,-8,3
2024-12-30,3293,69,0,70450,54,3044,3029,,0,0,0,70450,22,131,153,15,-22
2024-12-31,3293,70,2,70450,46,3066,3044,,0,4,0,70450,4,131,131,22,0
2025-01-02,3293,51,1,70450,46,3070,3066,,0,1,0,70450,3,129,131,4,-2
2025-01-03,3293,136,1,70450,160,3045,3070,,4,7,0,70450,0,136,129,-25,7
2025-01-06,3293,76,0,70450,55,3066,3045,,0,3,0,70450,5,134,136,21,-2
2025-01-07,3293,70,1,70450,87,3048,3066,,1,6,0,70450,0,140,134,-18,6
2025-01-08,3293,45,8,70450,72,3013,3048,,1,1,0,70450,5,136,140,-35,-4
2025-01-09,3293,57,21,70450,47,3002,3013,,1,0,0,70450,12,124,136,-11,-12
2025-01-10,3293,56,3,70450,52,3003,3002,,1,29,0,70450,5,148,124,1,24
2025-01-13,3293,30,1,70450,75,2957,3003,,0,4,0,70450,38,114,148,-46,-34
2025-01-14,3293,49,5,70450,29,2972,2957,,0,10,0,70450,30,94,114,15,-20
2025-01-15,3293,307,2,70450,100,3177,2972,,2,8,0,70450,16,86,94,205,-8
2025-01-16,3293,310,1,70450,165,3321,3177,,2,15,0,70450,8,93,86,144,7
2025-01-17,3293,35,2,70450,61,3293,3321,,0,8,0,70450,6,95,93,-28,2
2025-01-20,3293,42,0,70450,105,3230,3293,,1,2,0,70450,3,94,95,-63,-1
2025-01-21,3293,96,2,70450,8,3316,3230,,1,6,3,70450,8,89,94,86,-5
2025-01-22,3293,18,9,70450,80,3245,3316,,0,0,0,70450,4,85,89,-71,-4
2025-02-03,3293,93,0,70450,33,3303,3243,,0,3,0,70450,13,75,85,60,-10
2025-02-04,3293,64,4,70450,31,3332,3303,,0,1,0,70450,5,71,75,29,-4
2025-02-05,3293,84,0,70450,37,3379,3332,,4,3,0,70450,2,72,71,47,1
2025-02-06,3293,82,0,70450,43,3418,3379,,0,1,0,70450,2,71,72,39,-1
2025-02-07,3293,88,3,70450,94,3409,3418,,0,1,0,70450,2,70,71,-9,-1
2025-02-10,3293,44,0,70450,46,3407,3409,,0,2,0,70450,9,63,70,-2,-7
2025-02-11,3293,42,9,70450,43,3397,3407,,1,7,0,70450,1,69,63,-10,6
2025-02-12,3293,71,0,70450,27,3441,3397,,0,4,0,70450,2,71,69,44,2
2025-02-13,3293,43,2,70450,39,3443,3441,,0,4,0,70450,0,75,71,2,4
2025-02-14,3293,35,0,70450,134,3344,3443,,1,3,0,70450,10,68,75,-99,-7
2025-02-17,3293,147,0,70450,130,3361,3344,,0,3,0,70450,4,67,68,17,-1
2025-02-18,3293,89,1,70450,38,3411,3361,,0,2,0,70450,1,68,67,50,1
2025-02-19,3293,77,0,70450,31,3457,3411,,0,1,0,70450,5,64,68,46,-4
2025-02-20,3293,56,0,70450,108,3405,3457,,1,5,0,70450,2,67,64,-52,3
2025-02-21,3293,101,11,70450,28,3467,3405,,0,1,0,70450,3,65,67,62,-2
2025-02-24,3293,991,1,70450,433,4024,3467,,1,13,0,70450,4,74,65,557,9
2025-02-25,3293,691,0,70450,337,4378,4024,,1,13,0,70450,36,51,74,354,-23
2025-02-26,3293,204,0,70450,112,4470,4378,,1,1,0,70450,0,52,51,92,1
2025-02-27,3293,244,1,70450,243,4470,4470,,0,3,0,70450,0,55,52,0,3
2025-03-03,3293,383,2,70450,478,4373,4470,,3,2,0,70450,13,44,55,-97,-11
2025-03-04,3293,117,0,70450,222,4268,4373,,0,2,0,70450,8,38,44,-105,-6
2025-03-05,3293,300,0,70450,303,4265,4268,,0,12,0,70450,1,49,38,-3,11
2025-03-06,3293,1167,3,70450,573,4856,4265,,2,54,0,70450,1,102,49,591,53
2025-03-07,3293,718,6,70450,906,4662,4856,,34,11,0,70450,36,77,102,-194,-25
2025-03-10,3293,143,0,70450,207,4598,4662,,7,5,0,70450,10,72,77,-64,-5
2025-03-11,3293,156,0,70450,528,4226,4598,,31,8,0,70450,16,64,72,-372,-8
2025-03-12,3293,175,5,70450,582,3814,4226,,9,8,2,70450,4,66,64,-412,2
2025-03-13,3293,254,19,70450,202,3847,3814,,0,9,0,70450,4,71,66,33,5
2025-03-14,3293,129,20,70450,177,3779,3847,,6,6,0,70450,15,62,71,-68,-9
2025-03-17,3293,105,3,70450,89,3792,3779,,2,3,0,70450,3,62,62,13,0
2025-03-18,3293,217,0,70450,249,3760,3792,,2,19,0,70450,6,75,62,-32,13
2025-03-19,3293,89,0,70450,48,3801,3760,,0,0,0,70450,12,63,75,41,-12
2025-03-20,3293,66,3,70450,125,3739,3801,,3,3,1,70450,3,62,63,-62,-1
2025-03-21,3293,153,0,70450,42,3850,3739,,2,0,0,70450,6,56,62,111,-6
2025-03-24,3293,46,1,70450,49,3846,3850,,0,1,0,70450,28,29,56,-4,-27
2025-03-25,3293,115,4,70450,64,3893,3846,,0,1,0,70450,1,29,29,47,0
2025-03-26,3293,210,1,70450,394,3708,3893,,8,10,0,70450,8,31,29,-185,2
2025-03-27,3293,29,1,70450,72,3664,3708,,0,4,0,70450,4,31,31,-44,0
2025-03-28,3293,78,3,70450,58,3681,3664,,0,2,0,70450,3,30,31,17,-1
2025-03-31,3293,49,19,70450,430,3281,3681,,1,2,0,70450,9,23,30,-400,-7
2025-04-01,3293,19,2,70450,70,3228,3281,,0,11,0,70450,5,29,23,-53,6
2025-04-02,3293,16,2,70450,32,3210,3228,,0,3,0,70450,2,30,29,-18,1
2025-04-07,3293,15,37,70450,84,3104,3210,,0,0,0,70450,2,28,30,-106,-2
2025-04-08,3293,192,16,70450,432,2848,3104,,1,5,0,70450,5,28,28,-256,0
2025-04-09,3293,238,4,70450,424,2658,2848,,0,6,0,70450,8,26,28,-190,-2
2025-04-10,3293,112,9,70450,84,2677,2658,X,0,1,2,70450,0,25,26,19,-1
2025-04-11,3293,204,4,70450,136,2741,2677,X,0,0,1,70450,23,1,25,64,-24
2025-04-14,3293,332,0,70450,264,2809,2741,X,0,0,0,70450,1,0,1,68,-1
2025-04-15,3293,109,1,70450,177,2740,2809,X,0,0,0,70450,0,0,0,-69,0
2025-04-16,3293,158,0,70450,245,2653,2740,,0,0,0,70450,0,0,0,-87,0
2025-04-17,3293,86,8,70450,101,2630,2653,,18,7,0,70450,0,7,0,-23,7
2025-04-18,3293,159,7,70450,35,2747,2630,,12,0,0,70450,0,7,7,117,0
2025-04-21,3293,22,5,70450,81,2683,2747,,2,3,0,70450,3,7,7,-64,0
2025-04-22,3293,94,6,70450,102,2669,2683,,2,0,0,70450,5,2,7,-14,-5
2025-04-23,3293,68,0,70450,69,2668,2669,,0,1,0,70450,0,3,2,-1,1
2025-04-24,3293,40,4,70450,69,2635,2668,,0,6,0,70450,0,9,3,-33,6
2025-04-25,3293,49,3,70450,115,2566,2635,,0,3,0,70450,2,10,9,-69,1
2025-04-28,3293,60,0,70450,33,2593,2566,,0,2,0,70450,4,8,10,27,-2
2025-04-29,3293,58,0,70450,82,2569,2593,,1,6,0,70450,1,13,8,-24,5
2025-04-30,3293,51,1,70450,47,2572,2569,,0,0,0,70450,4,9,13,3,-4
2025-05-02,3293,126,2,70450,91,2605,2572,,1,4,0,70450,0,13,9,33,4
2025-05-05,3293,115,1,70450,53,2666,2605,,3,6,0,70450,6,13,13,61,0
2025-05-06,3293,54,2,70450,114,2604,2666,,0,4,0,70450,2,15,13,-62,2
2025-05-07,3293,195,0,70450,205,2594,2604,,4,1,0,70450,6,10,15,-10,-5
2025-05-08,3293,51,1,70450,94,2550,2594,,1,7,0,70450,0,17,10,-44,7
2025-05-09,3293,387,0,70450,93,2844,2550,,3,4,0,70450,3,18,17,294,1
2025-05-12,3293,161,2,70450,204,2799,2844,,0,48,0,70450,5,61,18,-45,43
2025-05-13,3293,342,0,70450,326,2815,2799,,0,5,0,70450,46,20,61,16,-41
2025-05-14,3293,323,1,70450,193,2944,2815,,0,0,0,70450,3,17,20,129,-3
2025-05-15,3293,293,1,70450,166,3070,2944,,0,0,0,70450,2,15,17,126,-2
2025-05-16,3293,119,2,70450,181,3006,3070,,1,6,0,70450,2,19,15,-64,4
2025-05-19,3293,141,3,70450,73,3071,3006,,0,3,0,70450,8,14,19,65,-5
2025-05-20,3293,93,1,70450,74,3089,3071,,0,4,0,70450,0,18,14,18,4
2025-05-21,3293,82,0,70450,117,3054,3089,,1,0,0,70450,7,11,18,-35,-7
2025-05-22,3293,194,1,70450,177,3070,3054,,1,0,0,70450,4,7,11,16,-4
2025-05-23,3293,210,28,70450,122,3130,3070,,0,0,0,70450,1,6,7,60,-1
2025-05-26,3293,43,8,70450,34,3131,3130,,0,0,0,70450,1,5,6,1,-1
2025-05-27,3293,19,2,70450,35,3113,3131,,0,1,0,70450,0,6,5,-18,1
2025-05-28,3293,27,1,70450,35,3104,3113,,0,0,0,70450,1,5,6,-9,-1
2025-05-29,3293,73,0,70450,50,3127,3104,,1,0,0,70450,0,5,5,23,0
2025-06-02,3293,67,1,70450,61,3132,3127,,0,0,0,70450,0,5,5,5,0
2025-06-03,3293,48,1,70450,67,3112,3132,,0,0,0,70450,0,5,5,-20,0
2025-06-04,3293,63,1,70450,41,3133,3112,,0,0,0,70450,0,5,5,21,0
2025-06-05,3293,249,1,70450,398,2983,3133,,7,9,0,70450,0,14,5,-150,9
2025-06-06,3293,187,1,70450,41,3128,2983,,0,0,0,70450,7,7,14,145,-7
2025-06-09,3293,60,1,70450,20,3167,3128,,0,0,0,70450,0,7,7,39,0
2025-06-10,3293,65,8,70450,115,3109,3167,,0,0,0,70450,0,7,7,-58,0
2025-06-11,3293,111,1,70450,192,3027,3109,,1,2,0,70450,0,9,7,-82,2
2025-06-12,3293,49,0,70450,98,2978,3027,,0,0,0,70450,0,9,9,-49,0
2025-06-13,3293,39,0,70450,316,2701,2978,,0,0,0,70450,0,9,9,-277,0
2025-06-16,3293,93,1,70450,179,2614,2701,,0,7,0,70450,0,16,9,-87,7
2025-06-17,3293,81,0,70450,79,2616,2614,,3,1,0,70450,0,17,16,2,1
2025-06-18,3293,173,7,70450,102,2680,2616,,0,0,0,70450,3,14,17,64,-3
2025-06-19,3293,136,0,70450,155,2661,2680,,0,1,0,70450,6,9,14,-19,-5
2025-06-20,3293,86,0,70450,138,2609,2661,,0,6,0,70450,2,13,9,-52,4
2025-06-23,3293,111,1,70450,22,2697,2609,,0,1,0,70450,7,7,13,88,-6
2025-06-24,3293,65,1,70450,71,2690,2697,,1,0,1,70450,0,6,7,-7,-1
2025-06-25,3293,65,0,70450,31,2724,2690,,1,0,0,70450,0,6,6,34,0
2025-06-26,3293,53,1,70450,36,2740,2724,,0,0,1,70450,0,5,6,16,-1
2025-06-27,3293,39,0,70450,104,2675,2740,,0,0,0,70450,0,5,5,-65,0
2025-06-30,3293,80,0,70450,62,2693,2675,,0,1,0,70450,0,6,5,18,1
2025-07-01,3293,59,0,70450,22,2730,2693,,0,0,0,70450,0,6,6,37,0
2025-07-02,3293,32,0,70450,35,2727,2730,,0,1,0,70450,1,6,6,-3,0
2025-07-03,3293,46,3,70450,20,2750,2727,,0,0,0,70450,0,6,6,23,0
2025-07-04,3293,81,4,70450,54,2773,2750,,0,0,0,70450,0,6,6,23,0
2025-07-07,3293,31,0,70450,25,2779,2773,,0,1,0,70450,0,7,6,6,1
2025-07-08,3293,18,2,70450,54,2741,2779,,0,0,0,70450,2,5,7,-38,-2
2025-07-09,3293,53,1,70450,15,2778,2741,,0,1,0,70450,2,4,5,37,-1
2025-07-10,3293,107,1,70450,65,2819,2778,X,0,0,0,70450,3,1,4,41,-3
2025-07-11,3293,95,1,70450,28,2885,2819,X,0,0,0,70450,1,0,1,66,-1
2025-07-14,3293,101,3,70450,58,2925,2885,X,0,0,0,70450,0,0,0,40,0
2025-07-15,3293,82,2,70450,58,2947,2925,X,0,0,0,70450,0,0,0,22,0
2025-07-16,3293,134,5,70450,96,2980,2947,,0,0,0,70450,0,0,0,33,0
2025-07-17,3293,204,2,70450,99,3083,2980,,4,7,0,70450,0,7,0,103,7
2025-07-18,3293,174,2,70450,43,3212,3083,,8,0,0,70450,2,5,7,129,-2
2025-07-21,3293,99,3,70450,134,3174,3212,,0,0,0,70450,1,4,5,-38,-1
2025-07-22,3293,98,9,70450,58,3208,3177,,1,2,0,70450,0,6,4,31,2
2025-07-23,3293,155,2,70450,158,3203,3208,,0,35,0,70450,4,37,6,-5,31
2025-07-24,3293,116,1,70450,14,3304,3203,,0,0,0,70450,7,30,37,101,-7
2025-07-25,3293,27,0,70450,31,3300,3304,,0,2,0,70450,0,32,30,-4,2
2025-07-28,3293,55,0,70450,20,3335,3300,,0,0,0,70450,22,10,32,35,-22
2025-07-29,3293,67,1,70450,42,3359,3335,,0,3,0,70450,0,13,10,24,3
2025-07-30,3293,45,0,70450,146,3258,3359,,0,2,0,70450,2,13,13,-101,0
2025-07-31,3293,33,1,70450,60,3230,3258,,0,1,0,70450,2,12,13,-28,-1
2025-08-01,3293,67,1,70450,19,3277,3230,,0,0,0,70450,0,12,12,47,0
2025-08-04,3293,54,5,70450,56,3270,3277,,0,3,1,70450,0,14,12,-7,2
2025-08-05,3293,142,0,70450,97,3315,3270,,0,2,0,70450,1,15,14,45,1
2025-08-06,3293,114,0,70450,87,3342,3315,,0,1,0,70450,2,14,15,27,-1
2025-08-07,3293,64,0,70450,144,3262,3342,,0,0,0,70450,0,14,14,-80,0
2025-08-08,3293,121,2,70450,14,3367,3262,,0,1,0,70450,1,14,14,105,0
2025-08-11,3293,68,0,70450,64,3371,3367,,0,1,0,70450,7,8,14,4,-6
2025-08-12,3293,71,0,70450,72,3370,3371,,0,0,0,70450,1,7,8,-1,-1
2025-08-13,3293,140,5,70450,126,3379,3370,,0,1,0,70450,2,6,7,9,-1
2025-08-14,3293,118,0,70450,105,3392,3379,,0,2,0,70450,4,4,6,13,-2
2025-08-15,3293,69,18,70450,72,3371,3392,,0,1,0,70450,0,5,4,-21,1
2025-08-18,3293,202,4,70450,229,3340,3371,,0,8,0,70450,2,11,5,-31,6
2025-08-19,3293,108,0,70450,93,3355,3340,,1,1,0,70450,3,9,11,15,-2
2025-08-20,3293,72,2,70450,101,3324,3355,,0,0,0,70450,2,7,9,-31,-2
2025-08-21,3293,33,1,70450,60,3296,3324,,1,1,1,70450,1,6,7,-28,-1
2025-08-22,3293,95,8,70450,7,3376,3296,,1,1,0,70450,2,5,6,80,-1
2025-08-25,3293,96,0,70450,76,3396,3376,,2,1,0,70450,1,5,5,20,0
2025-08-26,3293,24,1,70450,47,3372,3396,,0,0,0,70450,0,5,5,-24,0
2025-08-27,3293,81,1,70450,34,3418,3372,,0,0,0,70450,0,5,5,46,0
2025-08-28,3293,32,0,70450,36,3414,3418,,0,0,0,70450,1,4,5,-4,-1
2025-08-29,3293,74,0,70450,59,3429,3414,,0,1,0,70450,0,5,4,15,1
2025-09-01,3293,43,0,70450,51,3421,3429,,0,0,0,70450,0,5,5,-8,0
2025-09-02,3293,16,1,70450,45,3391,3421,,0,0,0,70450,0,5,5,-30,0
2025-09-03,3293,14,0,70450,58,3347,3391,,0,1,0,70450,1,5,5,-44,0
2025-09-04,3293,77,5,70450,93,3326,3347,,1,2,1,70450,1,5,5,-21,0
2025-09-05,3293,90,0,70450,45,3371,3326,,0,1,0,70450,1,5,5,45,0
2025-09-08,3293,23,0,70450,39,3355,3371,,0,2,0,70450,0,7,5,-16,2
2025-09-09,3293,44,3,70450,23,3373,3355,,0,0,0,70450,1,6,7,18,-1
2025-09-10,3293,98,1,70450,68,3402,3373,,0,3,0,70450,0,9,6,29,3
2025-09-11,3293,154,2,70450,92,3462,3402,,2,5,1,70450,0,13,9,60,4
2025-09-12,3293,1121,4,70450,450,4129,3462,,10,20,0,70450,1,32,13,667,19
2025-09-15,3293,370,3,70450,244,4252,4129,,0,2,0,70450,24,10,32,123,-22
2025-09-16,3293,164,35,70450,180,4201,4252,,0,4,0,70450,2,12,10,-51,2
2025-09-17,3293,181,5,70450,571,3806,4201,,0,0,0,70450,3,9,12,-395,-3
2025-09-18,3293,72,0,70450,132,3746,3806,,1,1,0,70450,2,8,9,-60,-1
2025-09-19,3293,144,0,70450,124,3766,3746,,0,1,0,70450,1,8,8,20,0
2024-09-23,3535,271,2,19763,338,7829,7898, ,3,97,0,19763,59,1738,1776,-69,-38
2024-09-24,3535,321,3,19763,422,7725,7829, ,3,105,0,19763,161,1794,1738,-104,56
2024-09-25,3535,204,0,19763,191,7738,7725, ,1,70,50,19763,40,1714,1794,13,-80
2024-09-26,3535,599,0,19763,441,7896,7738, ,10,81,0,19763,91,1724,1714,158,10
2024-09-27,3535,340,0,19763,816,7420,7896, ,3,89,0,19763,26,1661,1724,-476,-63
2024-09-30,3535,57,0,19763,81,7396,7420, ,1,49,0,19763,83,1695,1661,-24,34
2024-10-01,3535,76,0,19763,156,7316,7396, ,1,78,0,19763,38,1655,1695,-80,-40
2024-10-04,3535,185,3,19763,421,7077,7316, ,3,122,0,19763,322,1855,1655,-239,200
2024-10-07,3535,136,3,19763,132,7078,7077, ,1,176,0,19763,165,1844,1855,1,-11
2024-10-08,3535,73,3,19763,79,7069,7078, ,0,83,0,19763,44,1805,1844,-9,-39
2024-10-09,3535,109,2,19763,197,6979,7069, ,7,95,0,19763,64,1774,1805,-90,-31
2024-10-11,3535,178,10,19763,322,6825,6979, ,11,247,0,19763,125,1652,1774,-154,-122
2024-10-14,3535,59,3,19763,188,6693,6825, ,9,84,1,19763,57,1624,1652,-132,-28
2024-10-15,3535,149,7,19763,104,6731,6693, ,7,71,0,19763,25,1578,1624,38,-46
2024-10-16,3535,64,0,19763,170,6625,6731, ,1,68,0,19763,37,1547,1578,-106,-31
2024-10-17,3535,407,4,19763,120,6908,6625, ,1,29,0,19763,133,1651,1547,283,104
2024-10-18,3535,177,0,19763,148,6937,6908, ,1,48,0,19763,18,1621,1651,29,-30
2024-10-21,3535,611,3,19763,361,7184,6937, ,6,15,0,19763,223,1829,1621,247,208
2024-10-22,3535,2204,0,19763,994,8394,7184, ,84,128,0,19763,598,2299,1829,1210,470
2024-10-23,3535,1600,0,19763,1552,8442,8394, ,78,67,0,19763,410,2642,2299,48,343
2024-10-24,3535,742,1,19763,1112,8071,8442, ,20,132,0,19763,152,2662,2642,-371,20
2024-10-25,3535,211,0,19763,248,8034,8071, ,4,107,0,19763,55,2610,2662,-37,-52
2024-10-28,3535,154,0,19763,478,7710,8034, ,2,269,0,19763,66,2407,2610,-324,-203
2024-10-29,3535,207,0,19763,195,7722,7710, ,8,212,1,19763,82,2276,2407,12,-131
2024-10-30,3535,130,0,19763,249,7603,7722, ,3,91,0,19763,90,2275,2276,-119,-1
2024-11-01,3535,93,1,19763,184,7511,7603, ,1,168,0,19763,161,2268,2275,-92,-7
2024-11-04,3535,132,0,19763,76,7567,7511, ,0,193,0,19763,43,2118,2268,56,-150
2024-11-05,3535,185,0,19763,277,7475,7567, ,12,115,3,19763,99,2099,2118,-92,-19
2024-11-06,3535,160,0,19763,141,7494,7475, ,0,70,0,19763,29,2058,2099,19,-41
2024-11-07,3535,496,1,19763,289,7700,7494, ,3,30,0,19763,63,2091,2058,206,33
2024-11-08,3535,216,13,19763,456,7447,7700, ,4,139,12,19763,49,1989,2091,-253,-102
2024-11-11,3535,108,2,19763,312,7241,7447, ,6,135,0,19763,99,1953,1989,-206,-36
2024-11-12,3535,130,2,19763,292,7077,7241, ,1,94,0,19763,179,2038,1953,-164,85
2024-11-13,3535,95,1,19763,39,7132,7077, ,5,65,0,19763,60,2033,2038,55,-5
2024-11-14,3535,275,1,19763,125,7281,7132, ,19,118,0,19763,42,1957,2033,149,-76
2024-11-15,3535,111,6,19763,292,7094,7281, ,1,121,0,19763,103,1939,1957,-187,-18
2024-11-18,3535,290,1,19763,194,7189,7094, ,5,218,0,19763,57,1778,1939,95,-161
2024-11-19,3535,84,2,19763,76,7195,7189, ,2,14,0,19763,16,1780,1778,6,2
2024-11-20,3535,103,3,19763,46,7249,7195, ,2,81,0,19763,7,1706,1780,54,-74
2024-11-21,3535,83,0,19763,50,7282,7249, ,10,55,0,19763,23,1674,1706,33,-32
2024-11-22,3535,71,0,19763,154,7199,7282, ,5,32,0,19763,40,1682,1674,-83,8
2024-11-25,3535,51,0,19763,110,7140,7199, ,2,24,0,19763,36,1694,1682,-59,12
2024-11-26,3535,76,0,19763,33,7183,7140, ,1,60,0,19763,22,1656,1694,43,-38
2024-11-27,3535,123,0,19763,139,7167,7183, ,2,154,0,19763,30,1532,1656,-16,-124
2024-11-28,3535,47,0,19763,87,7127,7167, ,2,44,0,19763,90,1578,1532,-40,46
2024-11-29,3535,21,0,19763,56,7092,7127, ,2,76,0,19763,20,1522,1578,-35,-56
2024-12-02,3535,41,2,19763,113,7018,7092, ,0,97,0,19763,26,1451,1522,-74,-71
2024-12-03,3535,86,0,19763,112,6992,7018, ,0,143,0,19763,20,1328,1451,-26,-123
2024-12-04,3535,35,0,19763,43,6984,6992, ,3,61,0,19763,7,1274,1328,-8,-54
2024-12-05,3535,105,2,19763,122,6965,6984, ,0,93,0,19763,3,1184,1274,-19,-90
2024-12-06,3535,223,3,19763,119,7066,6965, ,5,7,0,19763,65,1242,1184,101,58
2024-12-09,3535,92,0,19763,81,7077,7066, ,1,75,0,19763,10,1177,1242,11,-65
2024-12-10,3535,473,0,19763,383,7167,7077, ,19,69,0,19763,78,1186,1177,90,9
2024-12-11,3535,120,0,19763,156,7131,7167, ,6,30,0,19763,83,1239,1186,-36,53
2024-12-12,3535,190,1,19763,121,7199,7131, ,5,48,0,19763,6,1197,1239,68,-42
2024-12-13,3535,128,0,19763,109,7218,7199, ,1,35,0,19763,29,1191,1197,19,-6
2024-12-16,3535,56,0,19763,194,7080,7218, ,0,54,0,19763,114,1251,1191,-138,60
2024-12-17,3535,36,0,19763,71,7045,7080, ,3,56,0,19763,49,1244,1251,-35,-7
2024-12-18,3535,18,0,19763,76,6987,7045, ,5,69,0,19763,25,1200,1244,-58,-44
2024-12-19,3535,17,2,19763,70,6932,6987, ,7,141,0,19763,1,1060,1200,-55,-140
2024-12-20,3535,41,1,19763,41,6931,6932, ,1,21,0,19763,2,1041,1060,-1,-19
2024-12-23,3535,113,0,19763,144,6900,6931, ,6,10,0,19763,40,1071,1041,-31,30
2024-12-24,3535,95,0,19763,61,6934,6900, ,7,18,0,19763,5,1058,1071,34,-13
2024-12-25,3535,112,0,19763,307,6739,6934, ,0,6,0,19763,12,1064,1058,-195,6
2024-12-26,3535,78,0,19763,93,6724,6739, ,2,12,0,19763,0,1052,1064,-15,-12
2024-12-27,3535,87,0,19763,75,6736,6724, ,0,21,0,19763,5,1036,1052,12,-16
2024-12-30,3535,31,1,19763,19,6747,6736, ,5,86,0,19763,3,953,1036,11,-83
2024-12-31,3535,25,25,19763,19,6728,6747, ,0,29,0,19763,3,927,953,-19,-26
2025-01-02,3535,284,0,19763,232,6780,6728, ,3,8,0,19763,235,1154,927,52,227
2025-01-03,3535,941,0,19763,569,7152,6780, ,6,232,0,19763,46,968,1154,372,-186
2025-01-06,3535,199,0,19763,144,7207,7152, ,0,23,0,19763,8,953,968,55,-15
2025-01-07,3535,73,0,19763,54,7226,7207, ,7,8,0,19763,4,949,953,19,-4
2025-01-08,3535,86,0,19763,105,7207,7226, ,0,22,0,19763,12,939,949,-19,-10
2025-01-09,3535,95,1,19763,68,7233,7207, ,0,47,0,19763,12,904,939,26,-35
2025-01-10,3535,259,17,19763,579,6896,7233, ,6,227,0,19763,145,822,904,-337,-82
2025-01-13,3535,79,49,19763,450,6476,6896, ,0,158,0,19763,104,768,822,-420,-54
2025-01-14,3535,69,0,19763,49,6496,6476, ,2,75,0,19763,51,744,768,20,-24
2025-01-15,3535,26,10,19763,47,6465,6496, ,1,23,0,19763,108,829,744,-31,85
2025-01-16,3535,104,0,19763,200,6369,6465, ,1,60,0,19763,78,847,829,-96,18
2025-01-17,3535,79,5,19763,126,6317,6369, ,7,7,0,19763,47,887,847,-52,40
2025-01-20,3535,353,0,19763,238,6432,6317, ,1,48,0,19763,307,1146,887,115,259
2025-01-21,3535,175,0,19763,336,6271,6432, ,7,124,0,19763,56,1078,1146,-161,-68
2025-01-22,3535,67,80,19763,80,6178,6271, ,6,82,0,19763,16,1012,1078,-93,-66
2025-02-03,3535,68,1,19763,41,6204,6178, ,1,59,0,19763,38,991,1012,26,-21
2025-02-04,3535,112,0,19763,47,6269,6204, ,0,37,0,19763,33,987,991,65,-4
2025-02-05,3535,37,4,19763,26,6276,6269, ,0,6,0,19763,8,989,987,7,2
2025-02-06,3535,33,1,19763,25,6283,6276, ,0,13,0,19763,21,997,989,7,8
2025-02-07,3535,43,2,19763,30,6294,6283, ,0,7,0,19763,11,1001,997,11,4
2025-02-10,3535,49,4,19763,60,6279,6294, ,2,140,0,19763,27,888,1001,-15,-113
2025-02-11,3535,23,0,19763,59,6243,6279, ,1,22,0,19763,30,896,888,-36,8
2025-02-12,3535,75,0,19763,54,6264,6243, ,0,17,0,19763,14,893,896,21,-3
2025-02-13,3535,44,0,19763,56,6252,6264, ,0,7,0,19763,11,897,893,-12,4
2025-02-14,3535,41,0,19763,4,6289,6252, ,0,5,0,19763,6,898,897,37,1
2025-02-17,3535,153,4,19763,104,6334,6289, ,0,79,0,19763,86,905,898,45,7
2025-02-18,3535,47,6,19763,42,6333,6334, ,1,14,0,19763,2,893,905,-1,-12
2025-02-19,3535,415,0,19763,191,6557,6333, ,6,28,0,19763,109,974,893,224,81
2025-02-20,3535,304,0,19763,260,6601,6557, ,10,22,0,19763,22,974,974,44,0
2025-02-21,3535,81,10,19763,94,6578,6601, ,0,32,0,19763,9,951,974,-23,-23
2025-02-24,3535,46,0,19763,49,6575,6578, ,0,34,0,19763,2,919,951,-3,-32
2025-02-25,3535,78,1,19763,50,6602,6575, ,0,108,0,19763,6,817,919,27,-102
2025-02-26,3535,21,0,19763,25,6598,6602, ,0,16,0,19763,0,801,817,-4,-16
2025-02-27,3535,38,0,19763,92,6544,6598, ,0,54,0,19763,7,754,801,-54,-47
2025-03-03,3535,95,61,19763,47,6531,6544, ,6,22,0,19763,25,757,754,-13,3
2025-03-04,3535,59,0,19763,60,6530,6531, ,1,43,0,19763,21,735,757,-1,-22
2025-03-05,3535,35,0,19763,151,6414,6530, ,2,16,0,19763,46,765,735,-116,30
2025-03-06,3535,62,2,19763,12,6462,6414, ,9,37,0,19763,8,736,765,48,-29
2025-03-07,3535,36,0,19763,32,6466,6462, ,0,23,0,19763,6,719,736,4,-17
2025-03-10,3535,12,0,19763,50,6428,6466, ,0,61,0,19763,15,673,719,-38,-46
2025-03-11,3535,23,3,19763,91,6357,6428, ,3,89,0,19763,10,594,673,-71,-79
2025-03-12,3535,26,5,19763,55,6323,6357, ,1,76,0,19763,4,522,594,-34,-72
2025-03-13,3535,42,1,19763,50,6314,6323, ,1,45,0,19763,5,482,522,-9,-40
2025-03-14,3535,9,2,19763,28,6293,6314, ,0,42,0,19763,22,462,482,-21,-20
2025-03-17,3535,18,5,19763,32,6274,6293, ,1,79,7,19763,1,377,462,-19,-85
2025-03-18,3535,27,2,19763,8,6291,6274, ,0,27,0,19763,1,351,377,17,-26
2025-03-19,3535,33,10,19763,27,6287,6291, ,0,151,0,19763,1,201,351,-4,-150
2025-03-20,3535,94,0,19763,22,6359,6287,X ,0,28,1,19763,0,172,201,72,-29
2025-03-21,3535,56,1,19763,14,6400,6359,X ,0,170,2,19763,0,0,172,41,-172
2025-03-24,3535,134,2,19763,121,6411,6400,X ,0,0,0,19763,0,0,0,11,0
2025-03-25,3535,124,0,19763,211,6324,6411,X ,0,0,0,19763,0,0,0,-87,0
2025-03-26,3535,33,0,19763,13,6344,6324, ,0,0,0,19763,0,0,0,20,0
2025-03-27,3535,40,1,19763,323,6060,6344, ,3,0,0,19763,18,18,0,-284,18
2025-03-28,3535,45,4,19763,528,5573,6060, ,10,3,0,19763,4,19,18,-487,1
2025-03-31,3535,98,45,19763,954,4672,5573, ,0,7,0,19763,52,64,19,-901,45
2025-04-01,3535,31,3,19763,148,4552,4672, ,0,38,0,19763,23,49,64,-120,-15
2025-04-02,3535,62,4,19763,70,4540,4552, ,0,1,0,19763,32,80,49,-12,31
2025-04-07,3535,9,57,19763,29,4463,4540, ,0,0,0,19763,0,80,80,-77,0
2025-04-08,3535,65,95,19763,175,4258,4463, ,0,10,0,19763,0,70,80,-205,-10
2025-04-09,3535,56,68,19763,155,4091,4258, ,0,11,0,19763,0,59,70,-167,-11
2025-04-10,3535,117,110,19763,361,3737,4091, ,0,39,0,19763,16,36,59,-354,-23
2025-04-11,3535,28,27,19763,205,3533,3737, ,0,12,0,19763,4,28,36,-204,-8
2025-04-14,3535,42,7,19763,121,3447,3533, ,0,0,0,19763,20,48,28,-86,20
2025-04-15,3535,67,2,19763,139,3373,3447, ,0,9,0,19763,8,47,48,-74,-1
2025-04-16,3535,48,36,19763,42,3343,3373, ,0,3,0,19763,10,54,47,-30,7
2025-04-17,3535,7,2,19763,33,3315,3343, ,0,7,0,19763,15,62,54,-28,8
2025-04-18,3535,6,0,19763,14,3307,3315, ,0,6,0,19763,6,62,62,-8,0
2025-04-21,3535,20,0,19763,82,3245,3307, ,0,9,0,19763,19,72,62,-62,10
2025-04-22,3535,221,0,19763,41,3425,3245, ,3,3,0,19763,26,95,72,180,23
2025-04-23,3535,309,0,19763,227,3507,3425, ,32,26,0,19763,55,124,95,82,29
2025-04-24,3535,273,4,19763,139,3637,3507, ,5,42,0,19763,13,95,124,130,-29
2025-04-25,3535,80,3,19763,99,3615,3637, ,1,3,0,19763,42,134,95,-22,39
2025-04-28,3535,70,1,19763,84,3600,3615, ,0,8,0,19763,5,131,134,-15,-3
2025-04-29,3535,275,3,19763,275,3597,3600, ,9,43,0,19763,91,179,131,-3,48
2025-04-30,3535,261,1,19763,314,3543,3597, ,5,55,0,19763,5,129,179,-54,-50
2025-05-02,3535,184,1,19763,38,3688,3543, ,0,14,0,19763,18,133,129,145,4
2025-05-05,3535,65,0,19763,125,3628,3688, ,6,37,0,19763,15,111,133,-60,-22
2025-05-06,3535,64,0,19763,88,3604,3628, ,21,5,0,19763,8,114,111,-24,3
2025-05-07,3535,56,0,19763,21,3639,3604, ,0,4,0,19763,3,113,114,35,-1
2025-05-08,3535,166,2,19763,118,3685,3639, ,0,9,0,19763,13,117,113,46,4
2025-05-09,3535,43,0,19763,106,3622,3685, ,1,1,0,19763,3,119,117,-63,2
2025-05-12,3535,84,0,19763,105,3601,3622, ,36,2,0,19763,6,123,119,-21,4
2025-05-13,3535,77,0,19763,92,3586,3601, ,0,0,0,19763,16,139,123,-15,16
2025-05-14,3535,67,0,19763,108,3545,3586, ,0,0,0,19763,1,140,139,-41,1
2025-05-15,3535,45,0,19763,12,3578,3545, ,0,1,0,19763,4,143,140,33,3
2025-05-16,3535,66,2,19763,38,3604,3578, ,10,3,0,19763,11,151,143,26,8
2025-05-19,3535,47,3,19763,60,3588,3604, ,0,17,0,19763,3,137,151,-16,-14
2025-05-20,3535,37,3,19763,48,3574,3588, ,0,31,0,19763,1,107,137,-14,-30
2025-05-21,3535,51,0,19763,31,3594,3574, ,0,1,0,19763,2,108,107,20,1
2025-05-22,3535,18,2,19763,3,3607,3594, ,0,8,0,19763,13,113,108,13,5
2025-05-23,3535,61,0,19763,43,3625,3607, ,0,0,0,19763,32,145,113,18,32
2025-05-26,3535,49,0,19763,49,3625,3625, ,0,0,0,19763,13,158,145,0,13
2025-05-27,3535,62,0,19763,11,3676,3625, ,0,16,0,19763,13,155,158,51,-3
2025-05-28,3535,32,0,19763,69,3639,3676, ,0,38,0,19763,6,123,155,-37,-32
2025-05-29,3535,16,0,19763,15,3640,3639, ,0,7,0,19763,1,117,123,1,-6
2025-06-02,3535,4,1,19763,31,3612,3640, ,0,5,0,19763,4,116,117,-28,-1
2025-06-03,3535,11,0,19763,45,3578,3612, ,0,11,0,19763,2,107,116,-34,-9
2025-06-04,3535,35,0,19763,35,3578,3578, ,0,6,0,19763,17,118,107,0,11
2025-06-05,3535,411,0,19763,224,3765,3578, ,22,5,0,19763,110,223,118,187,105
2025-06-06,3535,1636,0,19763,423,4978,3765, ,78,6,0,19763,160,377,223,1213,154
2025-06-09,3535,1693,0,19763,1478,5193,4978, ,18,107,0,19763,539,809,377,215,432
2025-06-10,3535,1296,0,19763,1670,4819,5193, ,135,277,0,19763,282,814,809,-374,5
2025-06-11,3535,406,0,19763,748,4477,4819, ,15,363,0,19763,210,661,814,-342,-153
2025-06-12,3535,325,0,19763,325,4477,4477, ,3,90,1,19763,31,601,661,0,-60
2025-06-13,3535,310,4,19763,229,4554,4477, ,10,42,5,19763,106,660,601,77,59
2025-06-16,3535,650,0,19763,245,4959,4554, ,17,22,0,19763,40,678,660,405,18
2025-06-17,3535,204,2,19763,327,4834,4959, ,2,53,0,19763,55,680,678,-125,2
2025-06-18,3535,213,0,19763,163,4884,4834, ,6,20,1,19763,7,666,680,50,-14
2025-06-19,3535,127,0,19763,267,4744,4884, ,0,80,0,19763,11,597,666,-140,-69
2025-06-20,3535,500,3,19763,369,4872,4744, ,9,11,0,19763,89,675,597,128,78
2025-06-23,3535,1208,0,19763,514,5566,4872, ,39,91,0,19763,89,673,675,694,-2
2025-06-24,3535,857,0,19763,548,5875,5566, ,21,77,0,19763,11,607,673,309,-66
2025-06-25,3535,268,0,19763,226,5917,5875, ,4,12,0,19763,36,631,607,42,24
2025-06-26,3535,393,0,19763,166,6144,5917, ,6,5,1,19763,54,679,631,227,48
2025-06-27,3535,1007,2,19763,853,6296,6144, ,15,51,0,19763,440,1068,679,152,389
2025-06-30,3535,2242,1,19763,1487,7050,6296, ,53,64,0,19763,1392,2396,1068,754,1328
2025-07-01,3535,2586,0,19763,1474,8162,7050, ,51,674,0,19763,64,1786,2396,1112,-610
2025-07-02,3535,669,0,19763,1506,7325,8162, ,32,188,0,19763,139,1737,1786,-837,-49
2025-07-03,3535,583,11,19763,466,7431,7325, ,8,81,0,19763,121,1777,1737,106,40
2025-07-04,3535,1066,0,19763,846,7651,7431, ,48,183,0,19763,264,1858,1777,220,81
2025-07-07,3535,962,1,19763,736,7876,7651, ,32,91,52,19763,213,1928,1858,225,70
2025-07-08,3535,265,2,19763,472,7667,7876, ,11,67,0,19763,193,2054,1928,-209,126
2025-07-09,3535,607,0,19763,487,7787,7667, ,3,35,1,19763,80,2098,2054,120,44
2025-07-10,3535,625,1,19763,400,8011,7787, ,5,88,0,19763,47,2057,2098,224,-41
2025-07-11,3535,1169,0,19763,1947,7233,8011, ,4,46,0,19763,373,2384,2057,-778,327
2025-07-14,3535,3690,10,19763,786,10127,7233, ,56,414,0,19763,262,2232,2384,2894,-152
2025-07-15,3535,1139,0,19763,1511,9755,10127, ,30,170,0,19763,208,2270,2232,-372,38
2025-07-16,3535,677,0,19763,452,9980,9755, ,23,155,0,19763,44,2159,2270,225,-111
2025-07-17,3535,1040,1,19763,360,10659,9980, ,21,44,2,19763,158,2271,2159,679,112
2025-07-18,3535,576,20,19763,673,10542,10659, ,5,158,0,19763,51,2164,2271,-117,-107
2025-07-21,3535,477,3,19763,362,10654,10542, ,3,106,0,19763,42,2100,2164,112,-64
2025-07-22,3535,641,1,19763,1021,10273,10654, ,38,110,0,19763,80,2070,2100,-381,-30
2025-07-23,3535,291,0,19763,237,10327,10273, ,10,152,0,19763,53,1971,2070,54,-99
2025-07-24,3535,387,0,19763,385,10329,10327, ,8,64,0,19763,51,1958,1971,2,-13
2025-07-25,3535,509,0,19763,307,10531,10329, ,6,46,0,19763,23,1935,1958,202,-23
2025-07-28,3535,1012,0,19763,890,10653,10531, ,30,62,1,19763,86,1958,1935,122,23
2025-07-29,3535,1064,0,19763,1184,10533,10653, ,29,145,0,19763,89,1902,1958,-120,-56
2025-07-30,3535,326,0,19763,241,10618,10533, ,2,60,0,19763,22,1864,1902,85,-38
2025-07-31,3535,543,1,19763,921,10239,10618, ,9,137,0,19763,148,1875,1864,-379,11
2025-08-01,3535,435,0,19763,341,10333,10239, ,7,98,0,19763,72,1849,1875,94,-26
2025-08-04,3535,560,1,19763,341,10551,10333, ,9,203,0,19763,19,1665,1849,218,-184
2025-08-05,3535,232,2,19763,485,10296,10551, ,3,181,2,19763,20,1502,1665,-255,-163
2025-08-06,3535,267,1,19763,178,10384,10296, ,9,97,0,19763,16,1421,1502,88,-81
2025-08-07,3535,513,4,19763,306,10587,10384, ,6,171,2,19763,31,1279,1421,203,-142
2025-08-08,3535,280,1,19763,208,10658,10587,X ,3,624,8,19763,11,658,1279,71,-621
2025-08-11,3535,972,2,19763,1315,10313,10658,X ,0,646,1,19763,0,11,658,-345,-647
2025-08-12,3535,621,2,19763,4336,6596,10313,X ,0,0,11,19763,0,0,11,-3717,-11
2025-08-13,3535,466,0,19763,685,6377,6596,X ,0,0,0,19763,0,0,0,-219,0
2025-08-14,3535,234,0,19763,144,6467,6377, ,0,0,0,19763,0,0,0,90,0
2025-08-15,3535,217,0,19763,163,6521,6467, ,33,0,0,19763,53,53,0,54,53
2025-08-18,3535,566,0,19763,288,6799,6521, ,76,3,0,19763,193,243,53,278,190
2025-08-19,3535,2212,1,19763,572,8438,6799, ,4,11,0,19763,228,460,243,1639,217
2025-08-20,3535,816,2,19763,985,8267,8438, ,36,101,0,19763,246,605,460,-171,145
2025-08-21,3535,616,12,19763,513,8358,8267, ,14,93,0,19763,88,600,605,91,-5
2025-08-22,3535,2271,0,19763,1317,9312,8358, ,4,92,0,19763,585,1093,600,954,493
2025-08-25,3535,4888,0,19763,1642,12558,9312, ,62,123,0,19763,1443,2413,1093,3246,1320
2025-08-26,3535,3001,1,19763,3172,12386,12558, ,46,300,0,19763,222,2335,2413,-172,-78
2025-08-27,3535,2303,0,19763,1890,12799,12386, ,43,733,0,19763,208,1810,2335,413,-525
2025-08-28,3535,636,0,19763,1162,12273,12799, ,10,278,1,19763,51,1582,1810,-526,-228
2025-08-29,3535,712,0,19763,1694,11291,12273, ,3,116,0,19763,72,1538,1582,-982,-44
2025-09-01,3535,770,0,19763,1804,10257,11291, ,8,255,0,19763,35,1318,1538,-1034,-220
2025-09-02,3535,478,0,19763,586,10149,10257, ,4,183,1,19763,52,1186,1318,-108,-132
2025-09-03,3535,482,0,19763,315,10316,10149, ,1,86,0,19763,85,1185,1186,167,-1
2025-09-04,3535,260,1,19763,409,10166,10316, ,1,81,0,19763,12,1116,1185,-150,-69
2025-09-05,3535,1694,5,19763,817,11038,10166, ,0,58,1,19763,346,1403,1116,872,287
2025-09-08,3535,2247,2,19763,1646,11637,11038, ,11,184,1,19763,86,1304,1403,599,-99
2025-09-09,3535,1176,0,19763,1719,11094,11637, ,34,20,2,19763,325,1607,1304,-543,303
2025-09-10,3535,1688,0,19763,1638,11144,11094, ,24,34,1,19763,421,1993,1607,50,386
2025-09-11,3535,1918,7,19763,1563,11492,11144, ,20,127,0,19763,351,2217,1993,348,224
2025-09-12,3535,3302,0,19763,2178,12616,11492, ,80,155,0,19763,386,2448,2217,1124,231
2025-09-15,3535,1328,0,19763,1083,12861,12616, ,5,305,0,19763,97,2240,2448,245,-208
2025-09-16,3535,414,2,19763,630,12643,12861, ,11,72,1,19763,61,2228,2240,-218,-12
2025-09-17,3535,972,0,19763,650,12965,12643, ,2,149,0,19763,15,2094,2228,322,-134
2025-09-18,3535,1888,0,19763,1446,13407,12965, ,15,40,0,19763,665,2719,2094,442,625
2025-09-19,3535,2375,2,19763,1675,14105,13407, ,22,188,1,19763,367,2897,2719,698,178
2024-09-23,6231,42,0,11413,53,2322,2333,,9,6,1,11413,6,387,388,-11,-1
2024-09-24,6231,70,2,11413,73,2317,2322,,23,12,0,11413,6,393,387,-5,6
2024-09-25,6231,74,0,11413,56,2335,2317,,9,1,0,11413,2,392,393,18,-1
2024-09-26,6231,75,0,11413,101,2309,2335,,23,1,1,11413,8,384,392,-26,-8
2024-09-27,6231,64,1,11413,113,2259,2309,,13,5,0,11413,6,383,384,-50,-1
2024-09-30,6231,66,0,11413,63,2262,2259,,50,5,0,11413,17,371,383,3,-12
2024-10-01,6231,221,1,11413,219,2263,2262,,6,21,0,11413,15,377,371,1,6
2024-10-04,6231,150,0,11413,142,2271,2263,,2,3,0,11413,33,347,377,8,-30
2024-10-07,6231,211,1,11413,223,2258,2271,,7,56,0,11413,17,386,347,-13,39
2024-10-08,6231,307,0,11413,72,2493,2258,,3,3,0,11413,46,343,386,235,-43
2024-10-09,6231,187,0,11413,174,2506,2493,,4,13,1,11413,11,344,343,13,1
2024-10-11,6231,109,0,11413,77,2538,2506,,3,3,0,11413,16,331,344,32,-13
2024-10-14,6231,74,2,11413,86,2524,2538,,0,4,0,11413,4,331,331,-14,0
2024-10-15,6231,157,1,11413,489,2191,2524,,8,39,0,11413,3,367,331,-333,36
2024-10-16,6231,278,0,11413,174,2295,2191,,2,21,0,11413,2,386,367,104,19
2024-10-17,6231,218,0,11413,205,2308,2295,,10,23,0,11413,13,396,386,13,10
2024-10-18,6231,157,0,11413,126,2339,2308,,3,19,0,11413,5,410,396,31,14
2024-10-21,6231,248,0,11413,359,2228,2339,,7,4,0,11413,15,399,410,-111,-11
2024-10-22,6231,108,0,11413,89,2247,2228,,2,5,0,11413,5,399,399,19,0
2024-10-23,6231,62,0,11413,72,2237,2247,,0,3,0,11413,4,398,399,-10,-1
2024-10-24,6231,114,0,11413,290,2061,2237,,2,1,0,11413,9,390,398,-176,-8
2024-10-25,6231,106,0,11413,124,2043,2061,,2,8,1,11413,28,369,390,-18,-21
2024-10-28,6231,144,0,11413,226,1961,2043,,2,2,0,11413,5,366,369,-82,-3
2024-10-29,6231,81,0,11413,128,1914,1961,,3,1,0,11413,12,355,366,-47,-11
2024-10-30,6231,102,0,11413,125,1891,1914,,2,0,0,11413,12,343,355,-23,-12
2024-11-01,6231,69,1,11413,63,1896,1891,,2,1,0,11413,12,332,343,5,-11
2024-11-04,6231,49,0,11413,50,1895,1896,,1,1,0,11413,12,321,332,-1,-11
2024-11-05,6231,70,0,11413,39,1926,1895,,0,4,0,11413,1,324,321,31,3
2024-11-06,6231,97,0,11413,193,1830,1926,,0,30,0,11413,2,352,324,-96,28
2024-11-07,6231,89,1,11413,78,1840,1830,,2,2,0,11413,7,347,352,10,-5
2024-11-08,6231,69,0,11413,92,1817,1840,,4,1,0,11413,0,348,347,-23,1
2024-11-11,6231,120,0,11413,84,1853,1817,,1,1,0,11413,23,326,348,36,-22
2024-11-12,6231,58,0,11413,123,1788,1853,,0,3,0,11413,6,323,326,-65,-3
2024-11-13,6231,89,1,11413,60,1816,1788,,0,2,0,11413,5,320,323,28,-3
2024-11-14,6231,45,1,11413,58,1802,1816,,0,0,0,11413,10,310,320,-14,-10
2024-11-15,6231,90,0,11413,78,1814,1802,,4,4,0,11413,9,305,310,12,-5
2024-11-18,6231,64,2,11413,138,1738,1814,,0,2,0,11413,31,276,305,-76,-29
2024-11-19,6231,37,0,11413,65,1710,1738,,0,29,0,11413,5,300,276,-28,24
2024-11-20,6231,42,0,11413,33,1719,1710,,3,7,30,11413,2,275,300,9,-25
2024-11-21,6231,37,0,11413,18,1738,1719,,1,2,0,11413,2,275,275,19,0
2024-11-22,6231,10,0,11413,32,1716,1738,,1,5,0,11413,1,279,275,-22,4
2024-11-25,6231,67,0,11413,75,1708,1716,,1,1,0,11413,20,260,279,-8,-19
2024-11-26,6231,60,1,11413,37,1730,1708,,0,5,0,11413,12,253,260,22,-7
2024-11-27,6231,11,0,11413,34,1707,1730,,0,1,0,11413,1,253,253,-23,0
2024-11-28,6231,30,0,11413,28,1709,1707,,1,0,60,11413,39,154,253,2,-99
2024-11-29,6231,15,1,11413,30,1693,1709,,0,5,30,11413,13,116,154,-16,-38
2024-12-02,6231,65,2,11413,67,1689,1693,,0,2,0,11413,8,110,116,-4,-6
2024-12-03,6231,188,0,11413,192,1685,1689,,2,6,0,11413,49,67,110,-4,-43
2024-12-04,6231,39,0,11413,108,1616,1685,,0,12,0,11413,2,77,67,-69,10
2024-12-05,6231,76,0,11413,38,1654,1616,,0,6,0,11413,6,77,77,38,0
2024-12-06,6231,99,1,11413,56,1696,1654,,2,6,0,11413,17,66,77,42,-11
2024-12-09,6231,35,0,11413,33,1698,1696,,0,1,0,11413,9,58,66,2,-8
2024-12-10,6231,43,0,11413,27,1714,1698,,0,2,0,11413,7,53,58,16,-5
2024-12-11,6231,47,0,11413,87,1674,1714,,5,14,0,11413,9,58,53,-40,5
2024-12-12,6231,38,0,11413,33,1679,1674,,0,4,0,11413,2,60,58,5,2
2024-12-13,6231,24,0,11413,27,1676,1679,,0,0,0,11413,10,50,60,-3,-10
2024-12-16,6231,49,1,11413,35,1689,1676,,1,0,0,11413,3,47,50,13,-3
2024-12-17,6231,29,2,11413,32,1684,1689,,0,4,0,11413,4,47,47,-5,0
2024-12-18,6231,9,0,11413,13,1680,1684,,0,4,0,11413,0,51,47,-4,4
2024-12-19,6231,16,0,11413,17,1679,1680,,0,1,0,11413,4,48,51,-1,-3
2024-12-20,6231,96,1,11413,49,1725,1679,,0,2,0,11413,2,48,48,46,0
2024-12-23,6231,66,1,11413,40,1750,1725,,0,1,0,11413,10,39,48,25,-9
2024-12-24,6231,35,2,11413,40,1743,1750,,0,5,0,11413,1,43,39,-7,4
2024-12-25,6231,77,0,11413,41,1779,1743,,1,1,0,11413,7,37,43,36,-6
2024-12-26,6231,55,1,11413,31,1802,1779,,1,2,0,11413,0,39,37,23,2
2024-12-27,6231,58,0,11413,68,1792,1802,,1,0,0,11413,4,35,39,-10,-4
2024-12-30,6231,34,3,11413,50,1773,1792,,0,3,0,11413,3,35,35,-19,0
2024-12-31,6231,68,4,11413,35,1802,1773,,3,2,0,11413,0,37,35,29,2
2025-01-02,6231,29,0,11413,11,1820,1802,,0,0,0,11413,3,34,37,18,-3
2025-01-03,6231,28,0,11413,23,1825,1820,,0,0,0,11413,1,33,34,5,-1
2025-01-06,6231,99,5,11413,33,1886,1825,,0,3,0,11413,6,30,33,61,-3
2025-01-07,6231,46,0,11413,37,1895,1886,,0,0,0,11413,2,28,30,9,-2
2025-01-08,6231,246,1,11413,18,2122,1895,,0,3,0,11413,0,31,28,227,3
2025-01-09,6231,220,2,11413,317,2023,2122,,2,58,0,11413,1,88,31,-99,57
2025-01-10,6231,470,0,11413,85,2408,2023,,2,2,0,11413,32,58,88,385,-30
2025-01-13,6231,89,3,11413,110,2384,2408,,2,6,0,11413,17,47,58,-24,-11
2025-01-14,6231,317,0,11413,197,2504,2384,,7,32,0,11413,4,75,47,120,28
2025-01-15,6231,419,0,11413,159,2764,2504,,8,25,0,11413,14,86,75,260,11
2025-01-16,6231,141,0,11413,212,2693,2764,,2,13,0,11413,4,95,86,-71,9
2025-01-17,6231,282,0,11413,127,2848,2693,,4,8,0,11413,19,84,95,155,-11
2025-01-20,6231,108,0,11413,185,2771,2848,,6,9,1,11413,2,90,84,-77,6
2025-01-21,6231,136,0,11413,123,2784,2771,,3,3,0,11413,2,91,90,13,1
2025-01-22,6231,153,5,11413,114,2818,2784,,5,3,0,11413,8,86,91,34,-5
2025-02-03,6231,132,0,11413,83,2867,2818,,2,10,0,11413,32,64,86,49,-22
2025-02-04,6231,365,0,11413,198,3034,2867,,9,29,0,11413,11,82,64,167,18
2025-02-05,6231,331,0,11413,249,3116,3034,,1,11,0,11413,4,89,82,82,7
2025-02-06,6231,300,1,11413,363,3052,3116,,2,49,0,11413,4,134,89,-64,45
2025-02-07,6231,287,1,11413,146,3192,3052,,0,6,1,11413,4,135,134,140,1
2025-02-10,6231,212,0,11413,205,3199,3192,,0,5,0,11413,39,101,135,7,-34
2025-02-11,6231,180,1,11413,231,3147,3199,,0,2,0,11413,8,95,101,-52,-6
2025-02-12,6231,140,0,11413,212,3075,3147,,1,0,0,11413,8,87,95,-72,-8
2025-02-13,6231,207,8,11413,101,3173,3075,,0,13,0,11413,1,99,87,98,12
2025-02-14,6231,117,1,11413,88,3201,3173,,0,1,0,11413,10,90,99,28,-9
2025-02-17,6231,69,2,11413,77,3191,3201,,0,1,0,11413,2,89,90,-10,-1
2025-02-18,6231,235,0,11413,175,3251,3191,,0,8,0,11413,1,96,89,60,7
2025-02-19,6231,140,0,11413,91,3300,3251,,0,0,0,11413,8,88,96,49,-8
2025-02-20,6231,160,1,11413,130,3329,3300,,1,1,0,11413,3,86,88,29,-2
2025-02-21,6231,221,1,11413,102,3447,3329,,0,5,0,11413,7,84,86,118,-2
2025-02-24,6231,72,1,11413,61,3457,3447,,0,2,0,11413,6,80,84,10,-4
2025-02-25,6231,62,1,11413,43,3475,3457,,1,1,0,11413,9,72,80,18,-8
2025-02-26,6231,158,0,11413,68,3565,3475,,0,1,0,11413,1,72,72,90,0
2025-02-27,6231,363,0,11413,185,3743,3565,,1,17,0,11413,2,87,72,178,15
2025-03-03,6231,254,0,11413,388,3609,3743,,0,51,0,11413,33,105,87,-134,18
2025-03-04,6231,76,2,11413,146,3537,3609,,0,7,0,11413,56,56,105,-72,-49
2025-03-05,6231,86,0,11413,65,3558,3537,,0,0,0,11413,3,53,56,21,-3
2025-03-06,6231,58,0,11413,53,3563,3558,,2,3,0,11413,0,56,53,5,3
2025-03-07,6231,115,2,11413,239,3437,3563,,7,28,0,11413,5,79,56,-126,23
2025-03-10,6231,29,0,11413,41,3425,3437,,0,3,0,11413,29,53,79,-12,-26
2025-03-11,6231,50,1,11413,120,3354,3425,,0,2,0,11413,24,31,53,-71,-22
2025-03-12,6231,37,1,11413,33,3357,3354,,2,2,0,11413,3,30,31,3,-1
2025-03-13,6231,84,4,11413,68,3369,3357,,0,1,0,11413,5,26,30,12,-4
2025-03-14,6231,27,0,11413,85,3311,3369,X,2,2,0,11413,7,21,26,-58,-5
2025-03-17,6231,44,2,11413,29,3324,3311,X,0,0,0,11413,15,6,21,13,-15
2025-03-18,6231,25,1,11413,44,3304,3324,X,0,0,6,11413,0,0,6,-20,-6
2025-03-19,6231,67,0,11413,59,3312,3304,X,0,0,0,11413,0,0,0,8,0
2025-03-20,6231,18,0,11413,17,3313,3312,,0,0,0,11413,0,0,0,1,0
2025-03-21,6231,20,0,11413,25,3308,3313,,11,7,0,11413,0,7,0,-5,7
2025-03-24,6231,39,0,11413,30,3317,3308,,2,2,0,11413,1,8,7,9,1
2025-03-25,6231,25,0,11413,18,3324,3317,,0,5,0,11413,0,13,8,7,5
2025-03-26,6231,18,2,11413,35,3305,3324,,0,9,0,11413,0,22,13,-19,9
2025-03-27,6231,62,0,11413,118,3249,3305,,0,11,0,11413,10,23,22,-56,1
2025-03-28,6231,54,4,11413,85,3214,3249,,2,7,0,11413,8,22,23,-35,-1
2025-03-31,6231,82,2,11413,501,2793,3214,,0,6,0,11413,3,25,22,-421,3
2025-04-01,6231,30,0,11413,83,2740,2793,,0,7,0,11413,5,27,25,-53,2
2025-04-02,6231,14,11,11413,15,2728,2740,,0,0,0,11413,2,25,27,-12,-2
2025-04-07,6231,2,9,11413,32,2689,2728,,0,0,0,11413,1,24,25,-39,-1
2025-04-08,6231,25,33,11413,77,2604,2689,,0,0,0,11413,1,23,24,-85,-1
2025-04-09,6231,10,29,11413,92,2493,2604,,0,0,0,11413,4,19,23,-111,-4
2025-04-10,6231,601,203,11413,206,2685,2493,,2,49,0,11413,15,53,19,192,34
2025-04-11,6231,142,16,11413,427,2384,2685,,3,4,1,11413,35,21,53,-301,-32
2025-04-14,6231,111,0,11413,106,2389,2384,,2,2,0,11413,2,21,21,5,0
2025-04-15,6231,99,0,11413,274,2214,2389,,1,3,15,11413,0,9,21,-175,-12
2025-04-16,6231,78,0,11413,75,2217,2214,,6,2,0,11413,4,7,9,3,-2
2025-04-17,6231,47,5,11413,102,2157,2217,,0,7,0,11413,1,13,7,-60,6
2025-04-18,6231,20,5,11413,34,2138,2157,,0,5,0,11413,1,17,13,-19,4
2025-04-21,6231,43,0,11413,26,2155,2138,,0,1,0,11413,6,12,17,17,-5
2025-04-22,6231,17,3,11413,47,2122,2155,,0,2,0,11413,1,13,12,-33,1
2025-04-23,6231,40,2,11413,42,2118,2122,,0,7,0,11413,2,18,13,-4,5
2025-04-24,6231,50,5,11413,31,2132,2118,,0,0,0,11413,6,12,18,14,-6
2025-04-25,6231,69,0,11413,72,2129,2132,,0,7,0,11413,1,18,12,-3,6
2025-04-28,6231,124,0,11413,71,2182,2129,,0,16,0,11413,4,30,18,53,12
2025-04-29,6231,362,0,11413,99,2445,2182,,0,8,0,11413,10,28,30,263,-2
2025-04-30,6231,191,0,11413,189,2447,2445,,0,3,0,11413,9,22,28,2,-6
2025-05-02,6231,91,1,11413,95,2442,2447,,2,4,1,11413,1,24,22,-5,2
2025-05-05,6231,114,0,11413,98,2458,2442,,0,2,0,11413,14,12,24,16,-12
2025-05-06,6231,33,0,11413,42,2449,2458,,0,2,0,11413,0,14,12,-9,2
2025-05-07,6231,78,0,11413,38,2489,2449,,1,12,0,11413,2,24,14,40,10
2025-05-08,6231,45,0,11413,25,2509,2489,,2,0,0,11413,7,17,24,20,-7
2025-05-09,6231,101,9,11413,56,2545,2509,,1,0,0,11413,5,12,17,36,-5
2025-05-12,6231,136,0,11413,145,2536,2545,,0,2,0,11413,3,11,12,-9,-1
2025-05-13,6231,113,0,11413,99,2550,2536,,0,1,0,11413,0,12,11,14,1
2025-05-14,6231,87,0,11413,56,2581,2550,,0,0,0,11413,3,9,12,31,-3
2025-05-15,6231,90,1,11413,53,2617,2581,,0,8,0,11413,3,14,9,36,5
2025-05-16,6231,44,0,11413,35,2626,2617,,1,1,0,11413,7,8,14,9,-6
2025-05-19,6231,34,1,11413,42,2617,2626,,1,1,0,11413,1,8,8,-9,0
2025-05-20,6231,75,0,11413,78,2614,2617,,2,9,0,11413,2,15,8,-3,7
2025-05-21,6231,100,0,11413,61,2653,2614,,0,3,0,11413,1,17,15,39,2
2025-05-22,6231,36,0,11413,61,2628,2653,,0,1,0,11413,2,16,17,-25,-1
2025-05-23,6231,37,1,11413,20,2644,2628,,0,1,0,11413,3,14,16,16,-2
2025-05-26,6231,28,0,11413,76,2596,2644,,1,4,0,11413,4,14,14,-48,0
2025-05-27,6231,44,1,11413,25,2614,2596,,0,4,0,11413,5,13,14,18,-1
2025-05-28,6231,22,1,11413,30,2605,2614,,0,3,0,11413,0,16,13,-9,3
2025-05-29,6231,24,2,11413,19,2608,2605,,0,0,0,11413,0,16,16,3,0
2025-06-02,6231,58,0,11413,55,2611,2608,,0,5,0,11413,4,17,16,3,1
2025-06-03,6231,38,0,11413,53,2596,2611,,0,7,0,11413,2,22,17,-15,5
2025-06-04,6231,46,2,11413,40,2600,2596,,0,9,0,11413,2,29,22,4,7
2025-06-05,6231,46,1,11413,51,2594,2600,,0,2,0,11413,0,31,29,-6,2
2025-06-06,6231,31,0,11413,17,2608,2594,,0,0,0,11413,3,28,31,14,-3
2025-06-09,6231,156,0,11413,59,2705,2608,,0,2,0,11413,0,30,28,97,2
2025-06-10,6231,207,0,11413,182,2730,2705,,0,5,0,11413,12,23,30,25,-7
2025-06-11,6231,87,1,11413,77,2739,2730,,0,0,0,11413,1,22,23,9,-1
2025-06-12,6231,79,0,11413,51,2767,2739,,0,3,0,11413,0,25,22,28,3
2025-06-13,6231,67,0,11413,70,2764,2767,,0,2,0,11413,7,20,25,-3,-5
2025-06-16,6231,51,3,11413,107,2705,2764,,1,1,0,11413,0,21,20,-59,1
2025-06-17,6231,152,0,11413,253,2604,2705,,0,32,0,11413,1,52,21,-101,31
2025-06-18,6231,607,1,11413,247,2963,2604,,4,30,0,11413,25,57,52,359,5
2025-06-19,6231,265,0,11413,181,3047,2963,,4,7,0,11413,6,58,57,84,1
2025-06-20,6231,80,0,11413,86,3041,3047,,0,3,1,11413,6,54,58,-6,-4
2025-06-23,6231,66,0,11413,43,3064,3041,,0,3,0,11413,1,56,54,23,2
2025-06-24,6231,138,0,11413,122,3080,3064,,1,1,0,11413,3,54,56,16,-2
2025-06-25,6231,141,0,11413,215,3006,3080,,1,7,12,11413,0,49,54,-74,-5
2025-06-26,6231,115,3,11413,93,3025,3006,,1,6,12,11413,5,38,49,19,-11
2025-06-27,6231,72,0,11413,91,3006,3025,,0,5,0,11413,8,35,38,-19,-3
2025-06-30,6231,157,0,11413,110,3053,3006,,0,10,0,11413,1,44,35,47,9
2025-07-01,6231,163,3,11413,101,3112,3053,,0,8,0,11413,6,46,44,59,2
2025-07-02,6231,49,0,11413,59,3102,3112,,0,0,0,11413,16,30,46,-10,-16
2025-07-03,6231,42,3,11413,63,3078,3102,,1,0,0,11413,0,30,30,-24,0
2025-07-04,6231,88,0,11413,99,3067,3078,,0,0,0,11413,4,26,30,-11,-4
2025-07-07,6231,25,0,11413,56,3036,3067,,0,0,0,11413,2,24,26,-31,-2
2025-07-08,6231,22,0,11413,49,3009,3036,,0,1,0,11413,1,24,24,-27,0
2025-07-09,6231,107,1,11413,108,3007,3009,,1,2,0,11413,4,22,24,-2,-2
2025-07-10,6231,64,3,11413,70,2998,3007,,0,1,0,11413,1,22,22,-9,0
2025-07-11,6231,34,0,11413,43,2989,2998,,0,0,0,11413,6,16,22,-9,-6
2025-07-14,6231,58,0,11413,57,2990,2989,,0,0,0,11413,4,12,16,1,-4
2025-07-15,6231,37,1,11413,39,2987,2990,X,0,0,0,11413,1,11,12,-3,-1
2025-07-16,6231,22,2,11413,43,2964,2987,X,0,0,0,11413,11,0,11,-23,-11
2025-07-17,6231,146,1,11413,163,2946,2964,X,0,0,0,11413,0,0,0,-18,0
2025-07-18,6231,124,0,11413,86,2984,2946,X,0,0,0,11413,0,0,0,38,0
2025-07-21,6231,77,1,11413,45,3015,2984,,0,0,0,11413,0,0,0,31,0
2025-07-22,6231,147,4,11413,126,3032,3015,,14,15,0,11413,0,15,0,17,15
2025-07-23,6231,37,2,11413,17,3050,3032,,8,6,0,11413,5,16,15,18,1
2025-07-24,6231,35,3,11413,20,3062,3050,,0,0,0,11413,2,14,16,12,-2
2025-07-25,6231,16,0,11413,10,3068,3062,,0,2,0,11413,2,14,14,6,0
2025-07-28,6231,22,5,11413,46,3039,3068,,0,3,0,11413,1,16,14,-29,2
2025-07-29,6231,42,9,11413,58,3014,3039,,1,2,0,11413,4,14,16,-25,-2
2025-07-30,6231,32,0,11413,24,3022,3014,,0,3,0,11413,2,15,14,8,1
2025-07-31,6231,90,0,11413,41,3071,3022,,2,2,0,11413,5,12,15,49,-3
2025-08-01,6231,39,18,11413,101,2991,3071,,1,7,0,11413,2,17,12,-80,5
2025-08-04,6231,25,0,11413,10,3006,2991,,0,2,0,11413,1,18,17,15,1
2025-08-05,6231,71,0,11413,130,2947,3006,,0,12,0,11413,1,29,18,-59,11
2025-08-06,6231,348,0,11413,125,3170,2947,,0,15,0,11413,14,30,29,223,1
2025-08-07,6231,110,1,11413,75,3204,3170,,0,0,0,11413,7,23,30,34,-7
2025-08-08,6231,71,0,11413,58,3217,3204,,1,9,2,11413,4,26,23,13,3
2025-08-11,6231,63,1,11413,63,3216,3217,,0,4,0,11413,3,27,26,-1,1
2025-08-12,6231,73,1,11413,33,3255,3216,,0,0,3,11413,4,20,27,39,-7
2025-08-13,6231,74,0,11413,113,3216,3255,,1,0,0,11413,7,13,20,-39,-7
2025-08-14,6231,47,0,11413,74,3189,3216,,0,9,0,11413,1,21,13,-27,8
2025-08-15,6231,109,1,11413,71,3226,3189,,0,2,3,11413,6,14,21,37,-7
2025-08-18,6231,46,0,11413,58,3214,3226,,0,3,0,11413,3,14,14,-12,0
2025-08-19,6231,52,0,11413,36,3230,3214,,0,0,0,11413,4,10,14,16,-4
2025-08-20,6231,53,19,11413,30,3234,3230,,3,0,0,11413,1,9,10,4,-1
2025-08-21,6231,43,1,11413,36,3240,3234,,0,3,0,11413,2,10,9,6,1
2025-08-22,6231,51,0,11413,94,3197,3240,,0,2,0,11413,1,11,10,-43,1
2025-08-25,6231,117,4,11413,165,3145,3197,,0,3,0,11413,1,13,11,-52,2
2025-08-26,6231,40,0,11413,43,3142,3145,,1,5,0,11413,2,16,13,-3,3
2025-08-27,6231,37,2,11413,56,3121,3142,,0,0,0,11413,2,14,16,-21,-2
2025-08-28,6231,113,0,11413,140,3094,3121,,1,9,0,11413,0,23,14,-27,9
2025-08-29,6231,200,1,11413,182,3111,3094,,0,3,0,11413,4,22,23,17,-1
2025-09-01,6231,62,0,11413,186,2987,3111,,0,1,0,11413,18,5,22,-124,-17
2025-09-02,6231,233,0,11413,170,3050,2987,,3,2,0,11413,0,7,5,63,2
2025-09-03,6231,112,3,11413,130,3029,3050,,0,12,0,11413,0,19,7,-21,12
2025-09-04,6231,459,0,11413,192,3296,3029,,13,13,0,11413,1,31,19,267,12
2025-09-05,6231,137,7,11413,137,3289,3296,,4,4,0,11413,14,21,31,-7,-10
2025-09-08,6231,375,1,11413,421,3242,3289,,1,21,0,11413,3,39,21,-47,18
2025-09-09,6231,311,0,11413,231,3322,3242,,0,26,0,11413,2,63,39,80,24
2025-09-10,6231,179,0,11413,135,3366,3322,,0,0,0,11413,13,50,63,44,-13
2025-09-11,6231,99,13,11413,233,3219,3366,,0,1,0,11413,7,44,50,-147,-6
2025-09-12,6231,93,0,11413,98,3214,3219,,0,4,0,11413,0,48,44,-5,4
2025-09-15,6231,116,0,11413,89,3241,3214,,0,1,0,11413,18,31,48,27,-17
2025-09-16,6231,52,0,11413,117,3176,3241,,2,12,0,11413,1,42,31,-65,11
2025-09-17,6231,483,0,11413,433,3226,3176,,4,49,0,11413,3,88,42,50,46
2025-09-18,6231,558,1,11413,333,3450,3226,,3,24,0,11413,24,88,88,224,0
2025-09-19,6231,931,0,11413,678,3703,3450,,6,12,0,11413,29,71,88,253,-17
2024-09-23,6643,6,0,10451,134,2506,2634,61      D,0,14,3,10451,42,175,206,-128,-31
2024-09-24,6643,14,2,10451,63,2455,2506,61      D,0,0,1,10451,10,164,175,-51,-11
2024-09-25,6643,94,3,10451,176,2370,2455,61      D,42,23,5,10451,70,112,164,-85,-52
2024-09-26,6643,26,2,10451,85,2309,2370,61      D,19,2,2,10451,9,103,112,-61,-9
2024-09-27,6643,11,2,10451,73,2245,2309,61      D,15,0,0,10451,6,97,103,-64,-6
2024-09-30,6643,1,0,10451,16,2230,2245,61      D,7,0,0,10451,3,94,97,-15,-3
2024-10-01,6643,4,1,10451,32,2201,2230,61      D,4,0,0,10451,0,94,94,-29,0
2024-10-04,6643,0,0,10451,7,2194,2201,61      D,0,1,0,10451,0,95,94,-7,1
2024-10-07,6643,2,0,10451,4,2192,2194,61      D,1,2,0,10451,0,97,95,-2,2
2024-10-08,6643,1,0,10451,7,2186,2192,,1,0,0,10451,0,97,97,-6,0
2024-10-09,6643,100,0,10451,44,2242,2186,,3,4,0,10451,1,100,97,56,3
2024-10-11,6643,99,1,10451,60,2280,2242,,1,2,0,10451,4,98,100,38,-2
2024-10-14,6643,89,4,10451,23,2342,2280,,0,0,0,10451,2,96,98,62,-2
2024-10-15,6643,57,1,10451,35,2363,2342,,0,0,21,10451,2,73,96,21,-23
2024-10-16,6643,120,0,10451,48,2435,2363,,0,1,0,10451,4,70,73,72,-3
2024-10-17,6643,78,1,10451,21,2491,2435,,0,0,20,10451,1,49,70,56,-21
2024-10-18,6643,71,0,10451,12,2550,2491,,0,1,0,10451,1,49,49,59,0
2024-10-21,6643,141,0,10451,126,2565,2550,,2,6,0,10451,2,53,49,15,4
2024-10-22,6643,113,0,10451,43,2635,2565,,0,1,0,10451,2,52,53,70,-1
2024-10-23,6643,104,7,10451,75,2657,2635,,2,0,0,10451,0,52,52,22,0
2024-10-24,6643,142,1,10451,49,2749,2657,,1,1,0,10451,0,53,52,92,1
2024-10-25,6643,83,2,10451,37,2793,2749,,0,1,0,10451,2,52,53,44,-1
2024-10-28,6643,104,0,10451,54,2843,2793,,3,34,1,10451,1,84,52,50,32
2024-10-29,6643,103,0,10451,62,2884,2843,,1,20,0,10451,12,92,84,41,8
2024-10-30,6643,191,0,10451,64,3011,2884,,3,24,0,10451,5,111,92,127,19
2024-11-01,6643,51,0,10451,66,2996,3011,,1,12,0,10451,29,94,111,-15,-17
2024-11-04,6643,72,0,10451,99,2969,2996,,2,24,0,10451,22,96,94,-27,2
2024-11-05,6643,95,0,10451,32,3032,2969,,1,7,4,10451,8,91,96,63,-5
2024-11-06,6643,71,22,10451,39,3042,3032,,3,4,3,10451,0,92,91,10,1
2024-11-07,6643,268,3,10451,149,3158,3042,,2,21,0,10451,25,88,92,116,-4
2024-11-08,6643,70,12,10451,95,3121,3158,,3,43,0,10451,5,126,88,-37,38
2024-11-11,6643,105,6,10451,90,3130,3121,,1,2,0,10451,17,111,126,9,-15
2024-11-12,6643,46,1,10451,82,3093,3130,,2,3,0,10451,19,95,111,-37,-16
2024-11-13,6643,70,0,10451,43,3120,3093,,0,8,0,10451,3,100,95,27,5
2024-11-14,6643,52,0,10451,55,3117,3120,,4,5,0,10451,24,81,100,-3,-19
2024-11-15,6643,140,3,10451,157,3097,3117,,1,22,0,10451,0,103,81,-20,22
2024-11-18,6643,118,7,10451,187,3021,3097,,1,31,0,10451,13,121,103,-76,18
2024-11-19,6643,41,3,10451,87,2972,3021,,4,15,0,10451,29,107,121,-49,-14
2024-11-20,6643,49,1,10451,47,2973,2972,,0,7,1,10451,3,110,107,1,3
2024-11-21,6643,43,0,10451,69,2947,2973,,1,9,0,10451,4,115,110,-26,5
2024-11-22,6643,26,2,10451,36,2935,2947,,1,2,0,10451,6,111,115,-12,-4
2024-11-25,6643,52,0,10451,42,2945,2935,,1,5,0,10451,5,111,111,10,0
2024-11-26,6643,70,1,10451,64,2950,2945,,1,3,1,10451,9,104,111,5,-7
2024-11-27,6643,48,0,10450,32,2966,2950,,0,21,0,10450,2,123,104,16,19
2024-11-28,6643,21,1,10450,23,2963,2966,,4,13,0,10450,9,127,123,-3,4
2024-11-29,6643,33,4,10450,117,2875,2963,,1,35,0,10450,7,155,127,-88,28
2024-12-02,6643,59,1,10450,21,2912,2875,,0,1,0,10450,20,136,155,37,-19
2024-12-03,6643,30,1,10450,62,2879,2912,,0,12,0,10450,13,135,136,-33,-1
2024-12-04,6643,115,0,10450,58,2936,2879,,1,0,0,10450,17,118,135,57,-17
2024-12-05,6643,43,0,10450,73,2906,2936,,0,6,0,10450,5,119,118,-30,1
2024-12-06,6643,108,0,10450,136,2878,2906,,5,17,0,10450,9,127,119,-28,8
2024-12-09,6643,54,1,10450,27,2904,2878,,0,3,0,10450,5,125,127,26,-2
2024-12-10,6643,135,0,10450,36,3003,2904,,2,2,0,10450,20,107,125,99,-18
2024-12-11,6643,20,0,10450,34,2989,3003,,0,12,0,10450,2,117,107,-14,10
2024-12-12,6643,89,0,10450,131,2947,2989,,0,3,0,10450,10,110,117,-42,-7
2024-12-13,6643,73,1,10450,81,2938,2947,,1,4,0,10450,1,113,110,-9,3
2024-12-16,6643,354,1,10450,292,2999,2938,,6,12,0,10450,5,120,113,61,7
2024-12-17,6643,495,1,10450,235,3258,2999,,11,34,0,10450,8,146,120,259,26
2024-12-18,6643,179,1,10450,187,3249,3258,,1,14,0,10450,21,139,146,-9,-7
2024-12-19,6643,113,1,10450,144,3217,3249,,0,18,0,10450,11,146,139,-32,7
2024-12-20,6643,117,2,10450,91,3241,3217,,1,0,0,10450,9,137,146,24,-9
2024-12-23,6643,78,1,10450,43,3275,3241,,0,2,0,10450,3,136,137,34,-1
2024-12-24,6643,72,1,10450,93,3253,3275,,0,3,0,10450,5,134,136,-22,-2
2024-12-25,6643,67,1,10450,105,3214,3253,,0,5,0,10450,12,127,134,-39,-7
2024-12-26,6643,83,1,10450,48,3248,3214,,1,4,0,10450,17,114,127,34,-13
2024-12-27,6643,83,3,10450,40,3288,3248,,0,2,0,10450,1,115,114,40,1
2024-12-30,6643,58,0,10450,71,3275,3288,,0,17,0,10450,16,116,115,-13,1
2024-12-31,6643,103,0,10450,29,3349,3275,,0,14,0,10450,2,128,116,74,12
2025-01-02,6643,96,0,10450,80,3365,3349,,0,4,0,10450,15,117,128,16,-11
2025-01-03,6643,30,1,10450,30,3364,3365,,0,2,0,10450,3,116,117,-1,-1
2025-01-06,6643,31,1,10450,49,3345,3364,,0,3,0,10450,29,90,116,-19,-26
2025-01-07,6643,45,0,10450,65,3325,3345,,0,14,0,10450,0,104,90,-20,14
2025-01-08,6643,209,2,10450,85,3447,3325,,1,22,0,10450,25,101,104,122,-3
2025-01-09,6643,84,1,10450,100,3430,3447,,0,8,0,10450,9,100,101,-17,-1
2025-01-10,6643,100,0,10450,137,3393,3430,,1,2,0,10450,6,96,100,-37,-4
2025-01-13,6643,156,9,10450,268,3272,3393,,0,30,0,10450,14,112,96,-121,16
2025-01-14,6643,65,9,10450,35,3293,3272,,5,11,0,10450,14,109,112,21,-3
2025-01-15,6643,24,2,10450,34,3281,3293,,0,7,0,10450,28,88,109,-12,-21
2025-01-16,6643,40,2,10450,32,3287,3281,,0,1,0,10450,19,70,88,6,-18
2025-01-17,6643,30,4,10450,60,3253,3287,,2,10,0,10450,3,77,70,-34,7
2025-01-20,6643,30,3,10450,46,3234,3253,,1,1,0,10450,8,70,77,-19,-7
2025-01-21,6643,46,2,10450,98,3180,3234,,6,7,0,10450,4,73,70,-54,3
2025-01-22,6643,59,4,10450,22,3213,3180,,0,6,0,10450,10,69,73,33,-4
2025-02-03,6643,38,3,10450,29,3219,3213,,1,7,0,10450,5,71,69,6,2
2025-02-04,6643,31,0,10450,84,3166,3219,,0,21,1,10450,6,85,71,-53,14
2025-02-05,6643,40,2,10450,71,3133,3166,,2,5,0,10450,20,70,85,-33,-15
2025-02-06,6643,160,0,10450,88,3205,3133,,0,9,0,10450,2,77,70,72,7
2025-02-07,6643,116,0,10450,103,3218,3205,,6,24,0,10450,7,94,77,13,17
2025-02-10,6643,49,1,10450,64,3202,3218,,0,8,0,10450,10,92,94,-16,-2
2025-02-11,6643,52,3,10450,42,3209,3202,,0,2,0,10450,0,94,92,7,2
2025-02-12,6643,29,0,10450,20,3218,3209,,0,2,0,10450,1,95,94,9,1
2025-02-13,6643,310,2,10450,220,3306,3218,,3,45,0,10450,10,130,95,88,35
2025-02-14,6643,324,0,10450,350,3280,3306,,3,12,0,10450,3,139,130,-26,9
2025-02-17,6643,219,4,10450,106,3389,3280,,0,6,0,10450,3,142,139,109,3
2025-02-18,6643,122,0,10450,144,3367,3389,,0,23,0,10450,1,164,142,-22,22
2025-02-19,6643,294,1,10450,389,3271,3367,,1,29,0,10450,6,187,164,-96,23
2025-02-20,6643,116,1,10450,118,3268,3271,,0,22,0,10450,15,194,187,-3,7
2025-02-21,6643,112,0,10450,71,3309,3268,,1,3,0,10450,13,184,194,41,-10
2025-02-24,6643,55,1,10450,79,3284,3309,,1,13,0,10450,3,194,184,-25,10
2025-02-25,6643,84,2,10450,61,3305,3284,,1,5,0,10450,39,160,194,21,-34
2025-02-26,6643,169,1,10450,118,3355,3305,,1,18,0,10450,28,150,160,50,-10
2025-02-27,6643,55,1,10450,87,3322,3355,,0,19,0,10450,14,155,150,-33,5
2025-03-03,6643,37,0,10450,34,3325,3322,,0,4,0,10450,18,141,155,3,-14
2025-03-04,6643,112,1,10450,47,3389,3325,,1,8,0,10450,25,124,141,64,-17
2025-03-05,6643,54,1,10450,41,3401,3389,,2,5,0,10450,6,123,124,12,-1
2025-03-06,6643,21,1,10450,73,3348,3401,,2,0,0,10450,10,113,123,-53,-10
2025-03-07,6643,85,1,10450,34,3398,3348,,1,3,0,10450,21,95,113,50,-18
2025-03-10,6643,33,3,10450,47,3381,3398,,3,3,0,10450,0,98,95,-17,3
2025-03-11,6643,50,0,10450,67,3364,3381,,1,2,1,10450,9,90,98,-17,-8
2025-03-12,6643,18,0,10450,35,3347,3364,,3,1,0,10450,2,89,90,-17,-1
2025-03-13,6643,34,0,10450,70,3311,3347,,0,12,0,10450,11,90,89,-36,1
2025-03-14,6643,26,1,10450,22,3314,3311,,5,7,10,10450,6,81,90,3,-9
2025-03-17,6643,105,1,10450,42,3376,3314,,1,3,0,10450,26,58,81,62,-23
2025-03-18,6643,15,0,10450,73,3318,3376,,0,21,0,10450,3,76,58,-58,18
2025-03-19,6643,29,3,10450,46,3298,3318,,2,0,0,10450,9,67,76,-20,-9
2025-03-20,6643,166,3,10450,53,3408,3298,X,0,7,3,10450,38,33,67,110,-34
2025-03-21,6643,47,3,10450,57,3395,3408,X,0,0,0,10450,33,0,33,-13,-33
2025-03-24,6643,36,1,10450,83,3347,3395,X,0,0,0,10450,0,0,0,-48,0
2025-03-25,6643,43,0,10450,29,3361,3347,X,0,0,0,10450,0,0,0,14,0
2025-03-26,6643,20,2,10449,24,3355,3361,,0,0,0,10449,0,0,0,-6,0
2025-03-27,6643,19,2,10449,25,3347,3355,,13,5,0,10449,0,5,0,-8,5
2025-03-28,6643,99,2,10449,52,3392,3347,,10,6,0,10449,3,8,5,45,3
2025-03-31,6643,136,12,10449,161,3355,3392,,1,16,0,10449,3,21,8,-37,13
2025-04-01,6643,17,17,10449,65,3290,3355,,0,21,0,10449,7,35,21,-65,14
2025-04-02,6643,17,1,10449,19,3287,3290,,0,24,0,10449,6,53,35,-3,18
2025-04-07,6643,6,25,10449,20,3248,3287,,0,0,0,10449,0,53,53,-39,0
2025-04-08,6643,29,63,10449,45,3169,3248,,0,0,0,10449,2,51,53,-79,-2
2025-04-09,6643,31,41,10449,37,3122,3169,,0,0,0,10449,2,49,51,-47,-2
2025-04-10,6643,215,127,10449,455,2755,3122,,2,22,0,10449,32,39,49,-367,-10
2025-04-11,6643,100,11,10449,177,2667,2755,,0,12,0,10449,23,28,39,-88,-11
2025-04-14,6643,43,7,10449,129,2574,2667,,2,36,0,10449,8,56,28,-93,28
2025-04-15,6643,57,0,10449,73,2558,2574,,2,24,0,10449,6,74,56,-16,18
2025-04-16,6643,52,3,10449,41,2566,2558,,0,6,0,10449,9,71,74,8,-3
2025-04-17,6643,33,6,10449,66,2527,2566,,0,40,0,10449,3,108,71,-39,37
2025-04-18,6643,61,0,10449,19,2569,2527,,1,13,0,10449,3,118,108,42,10
2025-04-21,6643,83,1,10449,127,2524,2569,,0,3,0,10449,34,87,118,-45,-31
2025-04-22,6643,29,0,10449,67,2486,2524,,1,35,0,10449,3,119,87,-38,32
2025-04-23,6643,59,4,10449,34,2507,2486,,1,6,0,10449,33,92,119,21,-27
2025-04-24,6643,40,1,10449,15,2531,2507,,1,11,0,10449,13,90,92,24,-2
2025-04-25,6643,47,1,10449,123,2454,2531,,3,7,0,10449,26,71,90,-77,-19
2025-04-28,6643,55,0,10449,36,2473,2454,,1,5,0,10449,0,76,71,19,5
2025-04-29,6643,56,1,10449,74,2454,2473,,0,13,0,10449,12,77,76,-19,1
2025-04-30,6643,44,1,10449,36,2461,2454,,0,1,0,10449,2,76,77,7,-1
2025-05-02,6643,37,0,10449,95,2403,2461,,2,8,0,10449,8,76,76,-58,0
2025-05-05,6643,67,3,10449,65,2402,2403,,0,8,0,10449,6,78,76,-1,2
2025-05-06,6643,17,1,10449,47,2371,2402,,1,4,0,10449,3,79,78,-31,1
2025-05-07,6643,261,0,10449,104,2528,2371,,1,49,0,10449,20,108,79,157,29
2025-05-08,6643,22,0,10449,111,2439,2528,,2,15,0,10449,6,117,108,-89,9
2025-05-09,6643,61,1,10449,44,2456,2440,,0,5,0,10449,8,114,117,16,-3
2025-05-12,6643,36,0,10449,130,2362,2456,,0,11,0,10449,8,117,114,-94,3
2025-05-13,6643,64,1,10449,66,2359,2362,,3,6,0,10449,4,119,117,-3,2
2025-05-14,6643,120,3,10449,96,2380,2359,,1,23,0,10449,10,132,119,21,13
2025-05-15,6643,66,4,10449,53,2389,2380,,1,2,0,10449,14,120,132,9,-12
2025-05-16,6643,49,2,10449,26,2410,2389,,0,4,0,10449,1,123,120,21,3
2025-05-19,6643,65,4,10449,39,2432,2410,,0,15,0,10449,19,119,123,22,-4
2025-05-20,6643,51,1,10449,58,2424,2432,,0,5,0,10449,1,123,119,-8,4
2025-05-21,6643,46,1,10449,26,2443,2424,,0,3,0,10449,2,124,123,19,1
2025-05-22,6643,32,1,10449,30,2444,2443,,1,8,0,10449,5,127,124,1,3
2025-05-23,6643,40,0,10449,30,2454,2444,,1,6,0,10449,3,130,127,10,3
2025-05-26,6643,48,1,10449,9,2492,2454,,0,2,0,10449,14,118,130,38,-12
2025-05-27,6643,33,0,10449,29,2496,2492,,0,3,0,10449,1,120,118,4,2
2025-05-28,6643,21,1,10449,27,2489,2496,,0,6,0,10449,2,124,120,-7,4
2025-05-29,6643,21,0,10449,9,2501,2489,,1,0,0,10449,3,121,124,12,-3
2025-06-02,6643,39,0,10449,39,2501,2501,,0,31,0,10449,7,145,121,0,24
2025-06-03,6643,11,0,10449,15,2497,2501,,0,0,0,10449,9,136,145,-4,-9
2025-06-04,6643,42,0,10449,32,2507,2497,,0,2,0,10449,11,127,136,10,-9
2025-06-05,6643,19,0,10449,25,2501,2507,,0,5,0,10449,0,132,127,-6,5
2025-06-06,6643,50,0,10449,29,2522,2501,,0,1,0,10449,5,128,132,21,-4
2025-06-09,6643,31,5,10449,31,2517,2522,,0,1,0,10449,1,128,128,-5,0
2025-06-10,6643,101,0,10449,33,2585,2517,,0,0,0,10449,3,125,128,68,-3
2025-06-11,6643,109,0,10449,149,2545,2585,,1,4,0,10449,2,127,125,-40,2
2025-06-12,6643,74,1,10449,23,2595,2545,,0,0,0,10449,7,120,127,50,-7
2025-06-13,6643,71,4,10449,42,2620,2595,,0,10,0,10449,0,130,120,25,10
2025-06-16,6643,38,1,10449,10,2647,2620,,0,2,0,10449,4,128,130,27,-2
2025-06-17,6643,40,0,10449,44,2643,2647,,0,1,7,10449,27,95,128,-4,-33
2025-06-18,6643,36,0,10449,14,2665,2643,,1,0,0,10449,8,87,95,22,-8
2025-06-19,6643,57,0,10449,12,2710,2665,,0,0,0,10449,12,75,87,45,-12
2025-06-20,6643,54,1,10449,39,2724,2710,,0,0,0,10449,3,72,75,14,-3
2025-06-23,6643,12,5,10449,16,2715,2724,,0,2,1,10449,13,60,72,-9,-12
2025-06-24,6643,79,1,10449,201,2592,2715,X,0,14,0,10449,6,68,60,-123,8
2025-06-25,6643,92,0,10449,71,2613,2592,X,0,0,30,10449,38,0,68,21,-68
2025-06-26,6643,74,2,10449,61,2624,2613,X,0,0,0,10449,0,0,0,11,0
2025-06-27,6643,148,0,10449,118,2654,2624,X,0,0,0,10449,0,0,0,30,0
2025-06-30,6643,125,3,10449,74,2702,2654,,0,0,0,10449,0,0,0,48,0
2025-07-01,6643,38,1,10449,83,2656,2702,,29,1,0,10449,0,1,0,-46,1
2025-07-02,6643,144,0,10449,205,2595,2656,,66,9,0,10449,0,10,1,-61,9
2025-07-03,6643,158,1,10449,57,2695,2595,,0,2,0,10449,8,4,10,100,-6
2025-07-04,6643,108,3,10449,35,2765,2695,,2,3,0,10449,0,7,4,70,3
2025-07-07,6643,35,0,10449,15,2785,2765,,0,34,0,10449,3,38,7,20,31
2025-07-08,6643,36,0,10449,20,2801,2785,,1,12,0,10449,5,45,38,16,7
2025-07-09,6643,50,6,10449,20,2825,2801,,3,4,0,10449,0,49,45,24,4
2025-07-10,6643,95,2,10449,198,2720,2825,,2,15,0,10449,10,54,49,-105,5
2025-07-11,6643,73,1,10449,85,2707,2720,,0,6,0,10449,6,54,54,-13,0
2025-07-14,6643,143,1,10449,32,2817,2707,,0,2,0,10449,9,47,54,110,-7
2025-07-15,6643,59,1,10449,24,2851,2817,,0,4,0,10449,16,35,47,34,-12
2025-07-16,6643,67,0,10449,63,2855,2851,,0,5,0,10449,3,37,35,4,2
2025-07-17,6643,23,0,10449,70,2808,2855,,0,3,0,10449,2,38,37,-47,1
2025-07-18,6643,56,0,10449,34,2830,2808,,0,5,0,10449,0,43,38,22,5
2025-07-21,6643,41,2,10449,20,2849,2830,,0,5,0,10449,0,48,43,19,5
2025-07-22,6643,276,0,10449,192,2933,2849,,7,11,0,10449,8,51,48,84,3
2025-07-23,6643,62,0,10449,38,2957,2933,,0,8,0,10449,7,52,51,24,1
2025-07-24,6643,24,0,10449,42,2939,2957,,0,5,0,10449,3,54,52,-18,2
2025-07-25,6643,37,1,10449,16,2959,2939,,0,0,0,10449,11,43,54,20,-11
2025-07-28,6643,28,0,10449,27,2960,2959,,0,3,0,10449,0,46,43,1,3
2025-07-29,6643,65,6,10449,67,2952,2960,,0,4,0,10449,10,40,46,-8,-6
2025-07-30,6643,92,0,10449,29,3015,2952,,0,27,0,10449,3,64,40,63,24
2025-07-31,6643,45,5,10449,31,3024,3015,,0,2,0,10449,2,64,64,9,0
2025-08-01,6643,38,7,10449,58,2997,3024,,0,10,0,10449,1,73,64,-27,9
2025-08-04,6643,38,2,10449,18,3015,2997,,0,6,2,10449,10,67,73,18,-6
2025-08-05,6643,29,13,10449,113,2918,3015,,0,9,0,10449,12,64,67,-97,-3
2025-08-06,6643,101,7,10449,80,2932,2918,,0,12,0,10449,16,60,64,14,-4
2025-08-07,6643,54,0,10449,248,2738,2932,,1,5,0,10449,6,59,60,-194,-1
2025-08-08,6643,85,11,10449,63,2749,2738,,1,4,0,10449,5,58,59,11,-1
2025-08-11,6643,75,4,10449,14,2806,2749,,0,3,0,10449,0,61,58,57,3
2025-08-12,6643,18,5,10449,36,2783,2806,,0,3,0,10449,5,59,61,-23,-2
2025-08-13,6643,57,2,10449,112,2726,2783,,0,1,0,10449,0,60,59,-57,1
2025-08-14,6643,32,3,10449,48,2707,2726,,0,3,0,10449,1,62,60,-19,2
2025-08-15,6643,68,1,10449,37,2737,2707,,0,0,0,10449,6,56,62,30,-6
2025-08-18,6643,71,2,10449,31,2775,2737,,0,0,0,10449,2,54,56,38,-2
2025-08-19,6643,119,31,10449,31,2832,2775,,0,9,0,10449,3,60,54,57,6
2025-08-20,6643,110,6,10449,64,2872,2832,,0,8,0,10449,7,61,60,40,1
2025-08-21,6643,91,0,10449,9,2954,2872,,0,5,0,10449,0,66,61,82,5
2025-08-22,6643,48,8,10449,73,2921,2954,,0,13,0,10449,2,77,66,-33,11
2025-08-25,6643,43,0,10449,82,2882,2921,,0,19,0,10449,18,78,77,-39,1
2025-08-26,6643,121,4,10449,248,2751,2882,,4,24,0,10449,20,82,78,-131,4
2025-08-27,6643,47,1,10449,110,2687,2751,,1,5,2,10449,1,84,82,-64,2
2025-08-28,6643,43,4,10449,56,2670,2687,,0,0,0,10449,6,78,84,-17,-6
2025-08-29,6643,35,3,10449,57,2645,2670,,0,1,0,10449,3,76,78,-25,-2
2025-09-01,6643,61,6,10449,53,2647,2645,,0,0,0,10449,10,66,76,2,-10
2025-09-02,6643,97,2,10449,106,2636,2647,,3,15,0,10449,2,79,66,-11,13
2025-09-03,6643,38,4,10449,84,2586,2636,,1,20,0,10449,0,99,79,-50,20
2025-09-04,6643,49,3,10449,43,2589,2586,,0,7,0,10449,13,93,99,3,-6
2025-09-05,6643,97,12,10449,59,2615,2589,,1,12,0,10449,26,79,93,26,-14
2025-09-08,6643,25,11,10449,50,2579,2615,,0,0,0,10449,6,73,79,-36,-6
2025-09-09,6643,54,3,10449,21,2609,2579,,0,0,0,10449,7,66,73,30,-7
2025-09-10,6643,96,6,10449,51,2648,2609,,0,2,0,10449,4,64,66,39,-2
2025-09-11,6643,62,2,10449,64,2644,2648,,0,29,0,10449,5,88,64,-4,24
2025-09-12,6643,32,1,10449,37,2638,2644,,0,4,0,10449,9,83,88,-6,-5
2025-09-15,6643,41,1,10449,34,2644,2638,,0,8,0,10449,1,90,83,6,7
2025-09-16,6643,15,0,10449,14,2645,2644,,1,5,0,10449,3,92,90,1,2
2025-09-17,6643,46,1,10449,42,2648,2645,,0,0,0,10449,13,79,92,3,-13
2025-09-18,6643,44,9,10449,56,2627,2648,,0,1,0,10449,13,67,79,-21,-12
2025-09-19,6643,155,0,10449,102,2680,2627,,1,3,0,10449,8,62,67,53,-5
2024-09-23,8358,202,0,63147,104,9943,9845,,0,0,1,63147,2,57,60,98,-3
2024-09-24,8358,64,0,63147,100,9907,9943,,0,0,0,63147,0,57,57,-36,0
2024-09-25,8358,117,1,63147,171,9852,9907,,1,0,0,63147,0,57,57,-55,0
2024-09-26,8358,31,1,63147,69,9813,9852,,0,0,0,63147,0,57,57,-39,0
2024-09-27,8358,84,1,63147,64,9832,9813,,0,0,0,63147,0,57,57,19,0
2024-09-30,8358,53,0,63147,55,9830,9832,,0,1,0,63147,3,55,57,-2,-2
2024-10-01,8358,82,0,63147,36,9876,9830,,0,1,0,63147,1,55,55,46,0
2024-10-04,8358,122,0,63147,57,9941,9876,,0,0,0,63147,3,52,55,65,-3
2024-10-07,8358,21,0,63147,70,9892,9941,,0,0,0,63147,0,52,52,-49,0
2024-10-08,8358,49,16,63147,50,9875,9892,,0,0,0,63147,7,45,52,-17,-7
2024-10-09,8358,57,0,63147,34,9898,9875,,0,1,0,63147,4,42,45,23,-3
2024-10-11,8358,136,1,63147,305,9728,9898,,0,0,0,63147,5,37,42,-170,-5
2024-10-14,8358,90,0,63147,53,9765,9728,,0,0,0,63147,0,37,37,37,0
2024-10-15,8358,52,1,63147,102,9714,9765,,3,0,0,63147,0,37,37,-51,0
2024-10-16,8358,21,0,63147,37,9698,9714,,0,0,0,63147,0,37,37,-16,0
2024-10-17,8358,56,27,63147,59,9668,9698,,0,0,0,63147,0,37,37,-30,0
2024-10-18,8358,127,0,63147,142,9653,9668,,0,3,0,63147,0,40,37,-15,3
2024-10-21,8358,51,6,63147,81,9617,9653,,1,1,0,63147,1,40,40,-36,0
2024-10-22,8358,57,0,63147,73,9601,9617,,2,3,0,63147,0,43,40,-16,3
2024-10-23,8358,160,0,63147,126,9635,9601,,0,0,0,63147,3,40,43,34,-3
2024-10-24,8358,68,0,63147,34,9669,9635,,0,8,0,63147,0,48,40,34,8
2024-10-25,8358,576,130,63147,182,9933,9669,,2,14,0,63147,0,62,48,264,14
2024-10-28,8358,294,6,63147,217,10004,9933,,1,6,0,63147,5,63,62,71,1
2024-10-29,8358,217,0,63147,181,10040,10004,,1,8,0,63147,10,61,63,36,-2
2024-10-30,8358,88,0,63147,110,10018,10040,,0,9,0,63147,16,54,61,-22,-7
2024-11-01,8358,32,1,63147,146,9903,10018,,0,2,0,63147,2,54,54,-115,0
2024-11-04,8358,32,0,63147,42,9893,9903,,0,2,0,63147,2,54,54,-10,0
2024-11-05,8358,61,0,63147,6,9948,9893,,0,0,0,63147,1,53,54,55,-1
2024-11-06,8358,48,0,63147,33,9963,9948,,0,0,0,63147,0,53,53,15,0
2024-11-07,8358,85,0,63147,61,9987,9963,,0,2,0,63147,14,41,53,24,-12
2024-11-08,8358,128,1,63147,91,10023,9987,,0,0,0,63147,0,41,41,36,0
2024-11-11,8358,183,8,63147,105,10093,10023,,0,4,0,63147,4,41,41,70,0
2024-11-12,8358,121,4,63147,194,10016,10093,,0,11,0,63147,1,51,41,-77,10
2024-11-13,8358,46,2,63147,61,9999,10016,,0,2,0,63147,11,42,51,-17,-9
2024-11-14,8358,126,0,63147,67,10058,9999,,3,3,0,63147,2,43,42,59,1
2024-11-15,8358,50,1,63147,46,10061,10058,,0,1,0,63147,0,44,43,3,1
2024-11-18,8358,100,1,63147,39,10121,10061,,0,3,0,63147,0,47,44,60,3
2024-11-19,8358,36,3,63147,12,10142,10121,,0,1,0,63147,1,47,47,21,0
2024-11-20,8358,28,7,63147,67,10096,10142,,0,1,0,63147,3,45,47,-46,-2
2024-11-21,8358,38,4,63147,100,10030,10096,,1,0,0,63147,3,42,45,-66,-3
2024-11-22,8358,712,1,63147,537,10204,10030,,0,6,0,63147,5,43,42,174,1
2024-11-25,8358,389,0,63147,191,10402,10204,,1,14,0,63147,2,55,43,198,12
2024-11-26,8358,80,10,63147,111,10361,10402,,0,0,0,63147,14,41,55,-41,-14
2024-11-27,8358,90,1,63147,163,10287,10361,,0,0,30,63147,1,10,41,-74,-31
2024-11-28,8358,132,0,63147,177,10242,10287,,0,3,0,63147,2,11,10,-45,1
2024-11-29,8358,307,6,63147,102,10441,10242,,0,7,0,63147,2,16,11,199,5
2024-12-02,8358,193,0,63147,345,10289,10441,,7,4,0,63147,0,20,16,-152,4
2024-12-03,8358,106,0,63147,76,10319,10289,,0,0,0,63147,5,15,20,30,-5
2024-12-04,8358,498,0,63147,277,10540,10319,,2,35,0,63147,1,49,15,221,34
2024-12-05,8358,307,3,63147,202,10642,10540,,1,9,0,63147,1,57,49,102,8
2024-12-06,8358,130,2,63147,145,10625,10642,,0,0,0,63147,27,30,57,-17,-27
2024-12-09,8358,58,2,63147,149,10532,10625,,1,0,0,63147,3,27,30,-93,-3
2024-12-10,8358,101,0,63147,225,10408,10532,,0,11,0,63147,10,28,27,-124,1
2024-12-11,8358,104,0,63147,104,10408,10408,,0,6,0,63147,1,33,28,0,5
2024-12-12,8358,177,1,63147,116,10468,10408,,0,1,0,63147,1,33,33,60,0
2024-12-13,8358,432,5,63147,306,10589,10468,,37,4,0,63147,0,37,33,121,4
2024-12-16,8358,249,0,63147,339,10499,10589,,3,11,0,63147,18,30,37,-90,-7
2024-12-17,8358,166,0,63147,93,10572,10499,,0,5,0,63147,1,34,30,73,4
2024-12-18,8358,111,8,63147,113,10562,10572,,2,11,0,63147,4,41,34,-10,7
2024-12-19,8358,84,0,63147,157,10489,10562,,0,1,0,63147,9,33,41,-73,-8
2024-12-20,8358,72,0,63147,38,10523,10489,,0,0,0,63147,1,32,33,34,-1
2024-12-23,8358,47,0,63147,19,10551,10523,,0,0,0,63147,0,32,32,28,0
2024-12-24,8358,86,0,63147,109,10528,10551,,0,0,0,63147,0,32,32,-23,0
2024-12-25,8358,58,2,63147,37,10547,10528,,0,0,0,63147,6,26,32,19,-6
2024-12-26,8358,76,0,63147,101,10522,10547,,0,1,0,63147,0,27,26,-25,1
2024-12-27,8358,35,0,63147,153,10404,10522,,0,0,0,63147,0,27,27,-118,0
2024-12-30,8358,98,0,63147,77,10425,10404,,0,0,0,63147,2,25,27,21,-2
2024-12-31,8358,70,0,63147,37,10458,10425,,0,1,0,63147,0,26,25,33,1
2025-01-02,8358,87,0,63147,57,10488,10458,,0,3,0,63147,4,25,26,30,-1
2025-01-03,8358,67,0,63147,71,10484,10488,,0,2,0,63147,3,24,25,-4,-1
2025-01-06,8358,350,11,63147,399,10424,10484,,0,2,0,63147,3,23,24,-60,-1
2025-01-07,8358,102,6,63147,92,10428,10424,,0,0,0,63147,1,22,23,4,-1
2025-01-08,8358,93,0,63147,186,10335,10428,,0,2,0,63147,3,21,22,-93,-1
2025-01-09,8358,174,1,63147,216,10292,10335,,0,4,0,63147,0,25,21,-43,4
2025-01-10,8358,128,78,63147,265,10077,10292,,0,12,0,63147,0,37,25,-215,12
2025-01-13,8358,142,18,63147,231,9970,10077,,0,7,0,63147,1,43,37,-107,6
2025-01-14,8358,33,4,63147,56,9943,9970,,0,0,0,63147,1,42,43,-27,-1
2025-01-15,8358,79,11,63147,78,9933,9943,,1,1,0,63147,1,42,42,-10,0
2025-01-16,8358,43,2,63147,24,9950,9933,,0,0,0,63147,6,36,42,17,-6
2025-01-17,8358,32,0,63147,41,9941,9950,,0,3,0,63147,0,39,36,-9,3
2025-01-20,8358,19,12,63147,35,9913,9941,,0,0,0,63147,4,35,39,-28,-4
2025-01-21,8358,85,13,63147,39,9946,9913,,0,0,0,63147,0,35,35,33,0
2025-01-22,8358,10,18,63147,109,9829,9946,,0,0,0,63147,3,32,35,-117,-3
2025-02-03,8358,74,6,63147,116,9779,9827,,0,0,0,63147,2,30,32,-48,-2
2025-02-04,8358,25,0,63147,27,9777,9779,,0,2,0,63147,0,32,30,-2,2
2025-02-05,8358,52,0,63147,47,9782,9777,,0,0,0,63147,0,32,32,5,0
2025-02-06,8358,16,19,63147,114,9665,9782,,0,2,0,63147,12,22,32,-117,-10
2025-02-07,8358,90,3,63147,124,9628,9665,,0,0,0,63147,5,17,22,-37,-5
2025-02-10,8358,38,1,63147,118,9547,9628,,0,1,0,63147,0,18,17,-81,1
2025-02-11,8358,38,1,63147,75,9509,9547,,0,0,0,63147,0,18,18,-38,0
2025-02-12,8358,30,0,63147,40,9499,9509,,0,0,0,63147,0,18,18,-10,0
2025-02-13,8358,34,33,63147,28,9472,9499,,0,0,0,63147,2,16,18,-27,-2
2025-02-14,8358,49,0,63147,15,9506,9472,,0,1,0,63147,0,17,16,34,1
2025-02-17,8358,48,2,63147,27,9525,9506,,0,1,0,63147,0,18,17,19,1
2025-02-18,8358,37,1,63147,31,9530,9525,,0,0,0,63147,0,18,18,5,0
2025-02-19,8358,44,11,63147,32,9531,9530,,0,0,0,63147,1,17,18,1,-1
2025-02-20,8358,65,5,63147,37,9554,9531,,0,0,0,63147,1,16,17,23,-1
2025-02-21,8358,39,3,63147,25,9565,9554,,0,0,0,63147,0,16,16,11,0
2025-02-24,8358,171,1,63147,47,9688,9565,,0,2,0,63147,0,18,16,123,2
2025-02-25,8358,205,1,63147,132,9760,9688,,2,0,0,63147,6,12,18,72,-6
2025-02-26,8358,477,0,63147,270,9967,9760,,0,1,0,63147,4,9,12,207,-3
2025-02-27,8358,355,11,63147,106,10205,9967,,0,0,0,63147,1,8,9,238,-1
2025-03-03,8358,387,6,63147,158,10428,10205,,0,0,0,63147,0,8,8,223,0
2025-03-04,8358,186,1,63147,164,10449,10428,,2,2,0,63147,0,10,8,21,2
2025-03-05,8358,77,2,63147,193,10331,10449,,1,0,0,63147,1,9,10,-118,-1
2025-03-06,8358,102,1,63147,220,10212,10331,,2,1,0,63147,0,10,9,-119,1
2025-03-07,8358,106,3,63147,125,10190,10212,,0,0,0,63147,1,9,10,-22,-1
2025-03-10,8358,32,3,63147,96,10123,10190,,1,3,0,63147,0,12,9,-67,3
2025-03-11,8358,312,52,63147,94,10289,10123,,1,0,0,63147,6,6,12,166,-6
2025-03-12,8358,70,0,63147,92,10267,10289,,0,2,0,63147,1,7,6,-22,1
2025-03-13,8358,176,0,63147,81,10362,10267,,0,2,0,63147,0,9,7,95,2
2025-03-14,8358,55,0,63147,100,10317,10362,,0,0,0,63147,0,9,9,-45,0
2025-03-17,8358,45,0,63147,88,10274,10317,,0,0,0,63147,0,9,9,-43,0
2025-03-18,8358,60,3,63147,56,10275,10274,,0,0,0,63147,0,9,9,1,0
2025-03-19,8358,147,5,63147,70,10347,10275,,0,0,0,63147,0,9,9,72,0
2025-03-20,8358,59,0,63147,242,10164,10347,,2,0,0,63147,0,9,9,-183,0
2025-03-21,8358,243,0,63147,73,10334,10164,,0,1,0,63147,3,7,9,170,-2
2025-03-24,8358,582,0,63147,395,10521,10334,,12,35,0,63147,1,41,7,187,34
2025-03-25,8358,330,1,63147,436,10414,10521,,0,12,0,63147,18,35,41,-107,-6
2025-03-26,8358,946,1,63147,585,10774,10414,,13,14,0,63147,12,37,35,360,2
2025-03-27,8358,549,0,63147,335,10988,10774,,1,49,0,63147,11,75,37,214,38
2025-03-28,8358,339,10,63147,582,10735,10988,,4,8,1,63147,28,54,75,-253,-21
2025-03-31,8358,145,15,63147,584,10281,10735,,1,6,0,63147,44,16,54,-454,-38
2025-04-01,8358,104,48,63147,106,10231,10281,,1,6,0,63147,3,19,16,-50,3
2025-04-02,8358,64,3,63147,40,10252,10231,,0,0,0,63147,6,13,19,21,-6
2025-04-07,8358,9,185,63147,157,9919,10252,,0,0,0,63147,0,13,13,-333,0
2025-04-08,8358,326,63,63147,768,9414,9919,,0,0,0,63147,2,11,13,-505,-2
2025-04-09,8358,183,36,63147,997,8563,9413,,0,0,0,63147,0,11,11,-850,0
2025-04-10,8358,109,68,63147,207,8397,8563,,0,1,0,63147,6,6,11,-166,-5
2025-04-11,8358,79,16,63147,174,8286,8397,,3,0,0,63147,1,5,6,-111,-1
2025-04-14,8358,190,0,63147,265,8211,8286,,5,6,0,63147,2,9,5,-75,4
2025-04-15,8358,207,7,63147,243,8168,8211,,3,4,0,63147,1,12,9,-43,3
2025-04-16,8358,81,1,63147,108,8140,8168,X,1,0,0,63147,6,6,12,-28,-6
2025-04-17,8358,89,4,63147,79,8146,8140,X,0,0,0,63147,6,0,6,6,-6
2025-04-18,8358,68,0,63147,36,8178,8146,X,0,0,0,63147,0,0,0,32,0
2025-04-21,8358,78,7,63147,107,8142,8178,X,0,0,0,63147,0,0,0,-36,0
2025-04-22,8358,101,2,63147,28,8213,8142,,0,0,0,63147,0,0,0,71,0
2025-04-23,8358,41,1,63147,100,8153,8213,,3,6,0,63147,0,6,0,-60,6
2025-04-24,8358,46,4,63147,107,8088,8153,,1,1,0,63147,5,2,6,-65,-4
2025-04-25,8358,16,8,63147,110,7986,8088,,0,0,0,63147,0,2,2,-102,0
2025-04-28,8358,22,1,63147,78,7929,7986,,0,1,0,63147,0,3,2,-57,1
2025-04-29,8358,85,2,63147,96,7916,7929,,1,0,0,63147,1,2,3,-13,-1
2025-04-30,8358,64,2,63147,113,7865,7916,,0,0,0,63147,0,2,2,-51,0
2025-05-02,8358,236,0,63147,133,7968,7865,,0,31,0,63147,0,33,2,103,31
2025-05-05,8358,167,4,63147,162,7969,7968,,0,7,0,63147,31,9,33,1,-24
2025-05-06,8358,53,0,63147,50,7972,7969,,2,2,0,63147,8,3,9,3,-6
2025-05-07,8358,83,2,63147,46,8007,7972,,0,0,0,63147,0,3,3,35,0
2025-05-08,8358,42,0,63147,104,7945,8007,,0,0,0,63147,0,3,3,-62,0
2025-05-09,8358,36,0,63147,104,7877,7945,,0,0,0,63147,0,3,3,-68,0
2025-05-12,8358,385,10,63147,256,7996,7877,,2,7,0,63147,0,10,3,119,7
2025-05-13,8358,358,7,63147,321,8026,7996,,2,24,0,63147,1,33,10,30,23
2025-05-14,8358,189,1,63147,170,8044,8026,,0,6,0,63147,13,26,33,18,-7
2025-05-15,8358,142,10,63147,65,8111,8044,,0,0,0,63147,7,19,26,67,-7
2025-05-16,8358,91,0,63147,61,8141,8111,,0,0,0,63147,1,18,19,30,-1
2025-05-19,8358,48,0,63147,83,8106,8141,,0,0,0,63147,4,14,18,-35,-4
2025-05-20,8358,27,7,63147,9,8117,8106,,0,1,0,63147,3,12,14,11,-2
2025-05-21,8358,233,0,63147,163,8187,8117,,0,2,0,63147,0,14,12,70,2
2025-05-22,8358,261,0,63147,295,8153,8187,,0,15,0,63147,0,29,14,-34,15
2025-05-23,8358,152,0,63147,188,8117,8153,,0,0,0,63147,10,19,29,-36,-10
2025-05-26,8358,768,0,63147,276,8609,8117,,1,13,0,63147,0,32,19,492,13
2025-05-27,8358,427,0,63147,547,8489,8609,,1,22,0,63147,4,50,32,-120,18
2025-05-28,8358,257,0,63147,241,8505,8489,,0,35,0,63147,13,72,50,16,22
2025-05-29,8358,131,0,63147,266,8370,8505,,0,3,0,63147,11,64,72,-135,-8
2025-06-02,8358,85,1,63147,88,8366,8370,,0,1,0,63147,46,19,64,-4,-45
2025-06-03,8358,455,10,63147,545,8266,8366,,13,11,0,63147,1,29,19,-100,10
2025-06-04,8358,440,0,63147,287,8419,8266,,2,5,0,63147,4,30,29,153,1
2025-06-05,8358,164,0,63147,173,8410,8419,,0,2,0,63147,10,22,30,-9,-8
2025-06-06,8358,71,5,63147,105,8371,8410,,0,0,0,63147,2,20,22,-39,-2
2025-06-09,8358,707,0,63147,625,8453,8371,,1,57,0,63147,3,74,20,82,54
2025-06-10,8358,590,40,63147,660,8343,8453,,9,3,0,63147,12,65,74,-110,-9
2025-06-11,8358,336,10,63147,228,8441,8343,,2,0,0,63147,17,48,65,98,-17
2025-06-12,8358,1480,9,63147,626,9286,8441,,9,12,0,63147,7,53,48,845,5
2025-06-13,8358,367,3,63147,830,8820,9286,,7,33,0,63147,10,76,53,-466,23
2025-06-16,8358,407,0,63147,76,9151,8820,,0,0,0,63147,0,76,76,331,0
2025-06-17,8358,364,0,63147,170,9345,9151,,4,15,0,63147,27,64,76,194,-12
2025-06-18,8358,370,0,63147,373,9342,9345,,1,47,0,63147,10,101,64,-3,37
2025-06-19,8358,419,0,63147,227,9534,9342,,1,2,1,63147,16,86,101,192,-15
2025-06-20,8358,145,0,63147,127,9552,9534,,0,0,0,63147,63,23,86,18,-63
2025-06-23,8358,123,0,63147,115,9560,9552,,1,5,0,63147,15,13,23,8,-10
2025-06-24,8358,181,0,63147,239,9502,9560,,3,5,0,63147,2,16,13,-58,3
2025-06-25,8358,663,0,63147,510,9655,9502,,2,5,0,63147,3,18,16,153,2
2025-06-26,8358,370,0,63147,420,9605,9655,,3,2,0,63147,3,17,18,-50,-1
2025-06-27,8358,224,0,63147,203,9626,9605,,0,7,0,63147,3,21,17,21,4
2025-06-30,8358,556,0,63147,392,9790,9626,,5,1,0,63147,0,22,21,164,1
2025-07-01,8358,258,0,63147,464,9584,9790,,13,3,0,63147,0,25,22,-206,3
2025-07-02,8358,380,0,63147,232,9732,9584,,0,10,0,63147,2,33,25,148,8
2025-07-03,8358,228,0,63147,302,9658,9732,,3,0,0,63147,15,18,33,-74,-15
2025-07-04,8358,169,0,63147,338,9489,9658,,0,2,0,63147,8,12,18,-169,-6
2025-07-07,8358,69,1,63147,127,9430,9489,,0,0,0,63147,4,8,12,-59,-4
2025-07-08,8358,122,6,63147,140,9406,9430,,0,3,0,63147,0,11,8,-24,3
2025-07-09,8358,4442,2,63147,1771,12075,9406,,38,135,0,63147,4,142,11,2669,131
2025-07-10,8358,9455,0,63147,3170,18360,12075,,94,1022,0,63147,13,1151,142,6285,1009
2025-07-11,8358,7228,1,63147,4486,21101,18360,,225,434,0,63147,545,1040,1151,2741,-111
2025-07-14,8358,3509,2,63147,1978,22630,21101,X,60,92,1,63147,379,752,1040,1529,-288
2025-07-15,8358,6757,1,63147,4751,24635,22630,X,0,0,2,63147,729,21,752,2005,-731
2025-07-16,8358,8514,0,63147,7955,25194,24635,X,0,0,21,63147,0,0,21,559,-21
2025-07-17,8358,10845,5,63147,6347,29687,25194,X,0,0,0,63147,0,0,0,4493,0
2025-07-18,8358,7897,0,63147,9889,27695,29687,,0,0,0,63147,0,0,0,-1992,0
2025-07-21,8358,5522,0,63147,4320,28897,27695,,1254,1263,0,63147,0,1263,0,1202,1263
2025-07-22,8358,6790,0,63147,7765,27920,28895,,5355,680,0,63147,818,1126,1264,-975,-138
2025-07-23,8358,4307,0,63147,4482,27646,27821,,242,562,1,63147,254,1335,1028,-175,307
2025-07-24,8358,7560,0,63147,4574,30632,27646,,703,2791,0,63147,157,3969,1335,2986,2634
2025-07-25,8358,2776,3,63147,2705,30700,30632,,108,340,0,63147,594,3715,3969,68,-254
2025-07-28,8358,2395,2,63147,3366,29727,30700,,54,2815,0,63147,157,6373,3715,-973,2658
2025-07-29,8358,4161,5,63147,2863,31020,29727,,66,261,5,63147,813,5816,6373,1293,-557
2025-07-30,8358,5677,7,63147,4928,31762,31020,11     C,142,1304,237,63147,453,6430,5816,742,614
2025-07-31,8358,9808,2,63147,4180,37388,31762,11     C,130,1092,1,63147,870,6651,6430,5626,221
2025-08-01,8358,7029,3,63147,6160,38254,37388,11     C,246,347,4,63147,786,6208,6651,866,-443
2025-08-04,8358,1930,0,63147,5451,34733,38254,11     C,49,272,0,63147,852,5628,6208,-3521,-580
2025-08-05,8358,4160,0,63147,4945,33948,34733,11   A C,91,302,0,63147,231,5699,5628,-785,71
2025-08-06,8358,2549,0,63147,4344,32153,33948,11   A C,60,605,0,63147,384,5920,5699,-1795,221
2025-08-07,8358,3788,0,63147,4910,31031,32153,11   A C,69,187,0,63147,210,5897,5920,-1122,-23
2025-08-08,8358,4594,1,63147,3928,31696,31031,11   A C,37,1698,1,63147,90,7504,5897,665,1607
2025-08-11,8358,5435,30,63147,4119,32982,31696,11   A C,99,610,0,63147,634,7480,7504,1286,-24
2025-08-12,8358,4984,0,63147,4591,33375,32982,11   A C,138,1508,0,63147,639,8349,7480,393,869
2025-08-13,8358,4774,0,63147,3378,34771,33375,11   A C,109,256,0,63147,526,8079,8349,1396,-270
2025-08-14,8358,5896,2,63147,3314,37351,34771,11   A C,4,1346,2,63147,110,9313,8079,2580,1234
2025-08-15,8358,4818,7,63147,3260,38902,37351,11   A C,41,2251,18,63147,669,10877,9313,1551,1564
2025-08-18,8358,5657,18,63147,3131,41410,38902,11   A C,99,1902,0,63147,1919,10860,10877,2508,-17
2025-08-19,8358,2912,4,63147,3735,40583,41410,11   A C,3591,635,6,63147,2269,9220,10860,-827,-1640
2025-08-20,8358,5782,68,63147,3346,42951,40583,11   A C,6164,2723,4,63147,1107,10832,9220,2368,1612
2025-08-21,8358,5311,0,63147,3007,45259,42955,11   A C,2122,831,3,63147,138,11522,10832,2304,690
2025-08-22,8358,2891,771,63147,3167,44212,45259,11   A C,2565,527,505,63147,220,11324,11522,-1047,-198
2025-08-25,8358,4674,5200,63147,2067,41619,44212,11   A C,1472,811,613,63147,714,10808,11324,-2593,-516
2025-08-26,8358,2472,584,63147,3644,39863,41619,11   A C,2433,662,313,63147,742,10415,10808,-1756,-393
2025-08-27,8358,2439,0,63147,3802,38500,39863,11   A C,3450,396,60,63147,1680,9071,10415,-1363,-1344
2025-08-28,8358,1924,1,63147,1041,39382,38500,11   A C,1237,64,95,63147,335,8705,9071,882,-366
2025-08-29,8358,2660,1586,63147,1807,38649,39382,11   A C,1592,227,48,63147,180,8704,8705,-733,-1
2025-09-01,8358,3155,6,63147,3473,38325,38649,11   A C,3219,94,3,63147,638,8157,8704,-324,-547
2025-09-02,8358,7272,0,63147,6836,38761,38325,11   A C,530,2303,0,63147,122,10338,8157,436,2181
2025-09-03,8358,7511,26,63147,6600,39646,38761,11   A C,253,891,4,63147,1002,10223,10338,885,-115
2025-09-04,8358,3295,86,63147,5279,37576,39646,11   A C,106,1248,0,63147,511,10960,10223,-2070,737
2025-09-05,8358,5603,3,63147,5007,38169,37576,11   A C,66,3824,4,63147,332,14448,10960,593,3488
2025-09-08,8358,6843,6,63147,3605,41401,38169,11   A C,101,374,37,63147,1986,12799,14448,3232,-1649
2025-09-09,8358,3192,37,63147,2730,41826,41401,11   A C,97,2332,1,63147,414,14716,12799,425,1917
2025-09-10,8358,4949,2,63147,3665,43108,41826,11   A C,154,430,178,63147,1422,13546,14716,1282,-1170
2025-09-11,8358,4734,0,63147,4381,43461,43108,11   A C,145,347,5,63147,1078,12810,13546,353,-736
2025-09-12,8358,6467,0,63147,7550,42378,43461,11   A C,304,918,6,63147,1178,12544,12810,-1083,-266
2025-09-15,8358,6147,13,63147,6321,42191,42378,11   A C,46,2223,1,63147,2123,12643,12544,-187,99
2025-09-16,8358,4966,5,63147,3687,43465,42191,11   A C,120,549,17,63147,3269,9906,12643,1274,-2737
2025-09-17,8358,4530,18,63147,4027,43950,43465,11   A C,131,434,80,63147,750,9510,9906,485,-396
2025-09-18,8358,4405,10,63147,3285,45061,43951,11   A C,116,895,4,63147,382,10019,9510,1110,509
2025-09-19,8358,5803,2,63147,2760,48102,45061,11   A C,125,928,13,63147,343,10591,10019,3041,572
2024-09-23,8932,165,0,39775,35,13922,13792,,0,0,0,39775,0,7,7,130,0
2024-09-24,8932,40,0,39775,177,13785,13922,,0,0,0,39775,0,7,7,-137,0
2024-09-25,8932,89,0,39775,169,13705,13785,,0,0,0,39775,0,7,7,-80,0
2024-09-26,8932,18,0,39775,17,13706,13705,,0,0,0,39775,0,7,7,1,0
2024-09-27,8932,18,0,39775,58,13666,13706,,0,0,0,39775,6,1,7,-40,-6
2024-09-30,8932,2,0,39775,2,13666,13666,,0,0,0,39775,0,1,1,0,0
2024-10-01,8932,45,0,39775,58,13653,13666,,0,0,0,39775,0,1,1,-13,0
2024-10-04,8932,18,0,39775,19,13652,13653,,0,0,0,39775,0,1,1,-1,0
2024-10-07,8932,94,0,39775,47,13699,13652,,0,0,0,39775,0,1,1,47,0
2024-10-08,8932,10,0,39775,192,13517,13699,,0,0,0,39775,0,1,1,-182,0
2024-10-09,8932,27,0,39775,124,13420,13517,,0,0,0,39775,0,1,1,-97,0
2024-10-11,8932,59,0,39775,210,13269,13420,,0,0,1,39775,0,0,1,-151,-1
2024-10-14,8932,52,0,39775,86,13235,13269,,0,0,0,39775,0,0,0,-34,0
2024-10-15,8932,18,0,39775,84,13169,13235,,1,0,0,39775,0,0,0,-66,0
2024-10-16,8932,29,0,39775,145,13053,13169,,0,0,0,39775,0,0,0,-116,0
2024-10-17,8932,6,0,39775,63,12996,13053,,0,0,0,39775,0,0,0,-57,0
2024-10-18,8932,195,22,39775,372,12797,12996,,2,4,0,39775,0,4,0,-199,4
2024-10-21,8932,64,0,39775,104,12757,12797,X,4,0,0,39775,3,1,4,-40,-3
2024-10-22,8932,130,0,39775,27,12860,12757,X,0,0,0,39775,1,0,1,103,-1
2024-10-23,8932,72,0,39775,31,12901,12860,X,0,0,0,39775,0,0,0,41,0
2024-10-24,8932,58,0,39775,113,12846,12901,X,0,0,0,39775,0,0,0,-55,0
2024-10-25,8932,476,0,39775,299,13023,12846,,0,0,0,39775,0,0,0,177,0
2024-10-28,8932,297,0,39775,161,13159,13023,,1,1,0,39775,0,1,0,136,1
2024-10-29,8932,162,0,39775,176,13145,13159,,6,0,0,39775,0,1,1,-14,0
2024-10-30,8932,43,0,39775,185,13003,13145,,0,0,0,39775,0,1,1,-142,0
2024-11-01,8932,17,0,39775,86,12934,13003,,0,0,0,39775,1,0,1,-69,-1
2024-11-04,8932,195,0,39775,491,12638,12934,,0,6,0,39775,0,6,0,-296,6
2024-11-05,8932,90,0,39775,105,12623,12638,,0,0,0,39775,0,6,6,-15,0
2024-11-06,8932,152,0,39775,90,12685,12623,,0,0,0,39775,6,0,6,62,-6
2024-11-07,8932,254,0,39775,104,12835,12685,,0,0,0,39775,0,0,0,150,0
2024-11-08,8932,41,0,39775,17,12859,12835,,0,1,0,39775,0,1,0,24,1
2024-11-11,8932,71,0,39775,90,12840,12859,,0,0,0,39775,1,0,1,-19,-1
2024-11-12,8932,520,0,39775,114,13246,12840,,0,0,0,39775,0,0,0,406,0
2024-11-13,8932,115,0,39775,80,13281,13246,,0,0,0,39775,0,0,0,35,0
2024-11-14,8932,236,0,39775,102,13415,13281,,0,2,0,39775,0,2,0,134,2
2024-11-15,8932,102,0,39775,213,13304,13415,,0,6,0,39775,1,7,2,-111,5
2024-11-18,8932,111,2,39775,220,13193,13304,,0,4,0,39775,1,10,7,-111,3
2024-11-19,8932,41,0,39775,873,12361,13193,,0,3,0,39775,2,11,10,-832,1
2024-11-20,8932,47,0,39775,20,12388,12361,,0,3,0,39775,0,14,11,27,3
2024-11-21,8932,56,0,39775,72,12372,12388,,0,0,0,39775,2,12,14,-16,-2
2024-11-22,8932,56,115,39775,30,12283,12372,,0,2,0,39775,1,13,12,-89,1
2024-11-25,8932,114,2,39775,71,12324,12283,,0,3,0,39775,7,9,13,41,-4
2024-11-26,8932,96,0,39775,6,12414,12324,,0,0,0,39775,0,9,9,90,0
2024-11-27,8932,91,0,39775,6,12499,12414,,0,3,0,39775,0,12,9,85,3
2024-11-28,8932,18,0,39775,23,12494,12499,,0,0,0,39775,1,11,12,-5,-1
2024-11-29,8932,97,0,39775,38,12553,12494,,0,0,0,39775,0,11,11,59,0
2024-12-02,8932,43,0,39775,7,12589,12553,,0,1,0,39775,0,12,11,36,1
2024-12-03,8932,22,0,39775,51,12560,12589,,0,0,0,39775,0,12,12,-29,0
2024-12-04,8932,58,0,39775,46,12572,12560,,0,0,0,39775,0,12,12,12,0
2024-12-05,8932,90,0,39775,68,12594,12572,,3,0,0,39775,0,12,12,22,0
2024-12-06,8932,100,0,39775,111,12583,12594,,0,0,0,39775,5,7,12,-11,-5
2024-12-09,8932,139,0,39775,252,12470,12583,,0,1,0,39775,0,8,7,-113,1
2024-12-10,8932,66,0,39775,96,12440,12470,,0,1,0,39775,0,9,8,-30,1
2024-12-11,8932,91,0,39775,126,12405,12440,,0,2,0,39775,0,11,9,-35,2
2024-12-12,8932,65,0,40294,93,12377,12405,,0,0,0,40294,0,11,11,-28,0
2024-12-13,8932,132,0,40294,59,12450,12377,,0,4,0,40294,0,15,11,73,4
2024-12-16,8932,136,0,40294,32,12554,12450,,0,1,0,40294,0,16,15,104,1
2024-12-17,8932,131,0,40294,31,12654,12554,,0,0,0,40294,1,15,16,100,-1
2024-12-18,8932,133,9,40294,25,12753,12654,,0,0,0,40294,1,14,15,99,-1
2024-12-19,8932,89,0,40294,83,12759,12753,,0,0,0,40294,3,11,14,6,-3
2024-12-20,8932,15,0,40294,11,12763,12759,,0,0,0,40294,0,11,11,4,0
2024-12-23,8932,97,0,40294,71,12789,12763,,0,2,0,40294,3,10,11,26,-1
2024-12-24,8932,30,0,40294,16,12803,12789,,0,1,0,40294,0,11,10,14,1
2024-12-25,8932,91,0,40294,15,12879,12803,,0,0,0,40294,0,11,11,76,0
2024-12-26,8932,311,0,40294,9,13181,12879,,1,0,0,40294,3,8,11,302,-3
2024-12-27,8932,160,0,40294,8,13333,13181,,3,0,0,40294,0,8,8,152,0
2024-12-30,8932,17,0,40294,63,13287,13333,,0,0,0,40294,0,8,8,-46,0
2024-12-31,8932,20,0,40294,44,13263,13287,,0,0,0,40294,0,8,8,-24,0
2025-01-02,8932,61,0,40294,50,13274,13263,,0,0,0,40294,6,2,8,11,-6
2025-01-03,8932,3,3,40294,225,13049,13274,,0,0,0,40294,0,2,2,-225,0
2025-01-06,8932,7,0,40294,159,12897,13049,,0,0,0,40294,0,2,2,-152,0
2025-01-07,8932,28,0,40294,49,12876,12897,,0,0,0,40294,0,2,2,-21,0
2025-01-08,8932,67,0,40294,19,12924,12876,,0,0,0,40294,0,2,2,48,0
2025-01-09,8932,62,0,40294,23,12963,12924,,0,1,0,40294,0,3,2,39,1
2025-01-10,8932,150,0,40294,205,12908,12963,,0,1,0,40294,0,4,3,-55,1
2025-01-13,8932,62,0,40294,44,12926,12908,,0,0,0,40294,1,3,4,18,-1
2025-01-14,8932,40,0,40294,197,12769,12926,,0,1,0,40294,0,4,3,-157,1
2025-01-15,8932,15,0,40294,50,12734,12769,,0,0,0,40294,0,4,4,-35,0
2025-01-16,8932,92,0,40294,41,12785,12734,,0,0,0,40294,1,3,4,51,-1
2025-01-17,8932,28,0,40294,73,12740,12785,,0,0,0,40294,0,3,3,-45,0
2025-01-20,8932,14,12,40294,81,12661,12740,,0,0,0,40294,0,3,3,-79,0
2025-01-21,8932,41,0,40294,80,12622,12661,,0,0,0,40294,1,2,3,-39,-1
2025-01-22,8932,14,0,40294,21,12615,12622,,0,0,0,40294,0,2,2,-7,0
2025-02-03,8932,56,0,40294,131,12540,12615,,0,0,0,40294,1,1,2,-75,-1
2025-02-04,8932,164,0,40294,392,12312,12540,,0,0,0,40294,0,1,1,-228,0
2025-02-05,8932,106,0,40294,133,12285,12312,,0,0,0,40294,0,1,1,-27,0
2025-02-06,8932,175,0,40294,47,12413,12285,,1,0,0,40294,0,1,1,128,0
2025-02-07,8932,57,0,40294,61,12409,12413,,0,0,0,40294,0,1,1,-4,0
2025-02-10,8932,214,0,40294,246,12377,12409,,0,1,0,40294,0,2,1,-32,1
2025-02-11,8932,173,0,40294,138,12412,12377,,0,0,0,40294,1,1,2,35,-1
2025-02-12,8932,210,0,40294,113,12509,12412,X,0,5,0,40294,0,6,1,97,5
2025-02-13,8932,128,0,40294,68,12569,12509,X,0,0,0,40294,5,1,6,60,-5
2025-02-14,8932,161,0,40294,54,12676,12569,X,0,0,1,40294,0,0,1,107,-1
2025-02-17,8932,117,0,40294,271,12522,12676,X,0,0,0,40294,0,0,0,-154,0
2025-02-18,8932,182,0,40294,42,12662,12522,,0,0,0,40294,0,0,0,140,0
2025-02-19,8932,29,0,40294,48,12643,12662,,1,10,0,40294,0,10,0,-19,10
2025-02-20,8932,53,0,40294,3,12693,12643,,0,16,0,40294,6,20,10,50,10
2025-02-21,8932,45,0,40294,108,12630,12693,,0,27,0,40294,3,44,20,-63,24
2025-02-24,8932,102,0,40294,28,12704,12630,,0,2,0,40294,0,46,44,74,2
2025-02-25,8932,316,0,40294,71,12949,12704,,0,0,0,40294,2,44,46,245,-2
2025-02-26,8932,105,0,40294,24,13030,12949,,0,0,0,40294,0,44,44,81,0
2025-02-27,8932,211,0,40294,77,13164,13030,,0,43,0,40294,0,87,44,134,43
2025-03-03,8932,337,0,40294,394,13107,13164,,0,0,0,40294,0,87,87,-57,0
2025-03-04,8932,296,0,40294,96,13307,13107,,0,0,0,40294,0,87,87,200,0
2025-03-05,8932,132,0,40294,295,13144,13307,,2,6,0,40294,0,93,87,-163,6
2025-03-06,8932,224,0,40294,239,13129,13144,,0,2,0,40294,0,95,93,-15,2
2025-03-07,8932,82,1,40294,1,13209,13129,,0,1,43,40294,0,53,95,80,-42
2025-03-10,8932,42,0,40294,30,13221,13209,,0,12,0,40294,4,61,53,12,8
2025-03-11,8932,334,0,40294,90,13465,13221,,0,6,0,40294,11,56,61,244,-5
2025-03-12,8932,69,0,40294,33,13501,13465,,1,13,0,40294,1,68,56,36,12
2025-03-13,8932,79,0,40294,59,13521,13501,,0,21,0,40294,0,89,68,20,21
2025-03-14,8932,179,0,40294,43,13657,13521,,0,14,0,40294,2,101,89,136,12
2025-03-17,8932,102,0,40294,28,13731,13657,,0,4,0,40294,18,87,101,74,-14
2025-03-18,8932,62,0,40294,600,13193,13731,,0,1,0,40294,0,88,87,-538,1
2025-03-19,8932,101,0,41294,0,13294,13193,,0,14,0,41294,0,102,88,101,14
2025-03-20,8932,933,0,41294,812,13415,13294,,0,0,6,41294,49,47,102,121,-55
2025-03-21,8932,1478,0,41294,861,14032,13415,,0,0,1,41294,33,13,47,617,-34
2025-03-24,8932,207,0,41294,19,14220,14032,,0,1,1,41294,10,3,13,188,-10
2025-03-25,8932,161,0,41294,83,14298,14220,,0,0,0,41294,0,3,3,78,0
2025-03-26,8932,1304,0,41294,1108,14494,14298,,0,2,0,41294,0,5,3,196,2
2025-03-27,8932,35,0,41294,21,14508,14494,,0,0,0,41294,0,5,5,14,0
2025-03-28,8932,50,0,41294,17,14541,14508,,0,0,0,41294,1,4,5,33,-1
2025-03-31,8932,230,0,41294,13,14758,14541,,0,0,0,41294,1,3,4,217,-1
2025-04-01,8932,28,0,41294,67,14719,14758,,0,0,0,41294,0,3,3,-39,0
2025-04-02,8932,48,1,41294,34,14732,14719,,0,0,0,41294,0,3,3,13,0
2025-04-07,8932,2,86,41294,1,14647,14732,,0,0,0,41294,0,3,3,-85,0
2025-04-08,8932,271,111,41294,502,14305,14647,,0,0,0,41294,0,3,3,-342,0
2025-04-09,8932,306,18,41294,430,14163,14305,,0,23,0,41294,0,26,3,-142,23
2025-04-10,8932,222,0,41294,271,14114,14163,,0,0,0,41294,23,3,26,-49,-23
2025-04-11,8932,99,0,41294,126,14087,14114,,0,0,0,41294,0,3,3,-27,0
2025-04-14,8932,173,0,41294,183,14077,14087,,0,0,0,41294,0,3,3,-10,0
2025-04-15,8932,181,0,41294,7,14251,14077,,0,0,0,41294,0,3,3,174,0
2025-04-16,8932,306,0,41294,3,14554,14251,,0,0,0,41294,0,3,3,303,0
2025-04-17,8932,78,5,41294,7,14620,14554,,0,0,0,41294,3,0,3,66,-3
2025-04-18,8932,44,0,41294,27,14637,14620,,0,0,0,41294,0,0,0,17,0
2025-04-21,8932,187,0,41294,15,14809,14637,,0,0,0,41294,0,0,0,172,0
2025-04-22,8932,129,0,41294,66,14872,14809,X,0,0,0,41294,0,0,0,63,0
2025-04-23,8932,59,0,41294,39,14892,14872,X,0,0,0,41294,0,0,0,20,0
2025-04-24,8932,72,0,41294,5,14959,14892,X,0,0,0,41294,0,0,0,67,0
2025-04-25,8932,88,0,41294,50,14997,14959,X,0,0,0,41294,0,0,0,38,0
2025-04-28,8932,50,0,41294,6,15041,14997,,0,0,0,41294,0,0,0,44,0
2025-04-29,8932,26,0,41294,36,15031,15041,,0,0,0,41294,0,0,0,-10,0
2025-04-30,8932,11,0,41294,99,14943,15031,,0,0,0,41294,0,0,0,-88,0
2025-05-02,8932,446,0,41294,1317,14072,14943,,0,39,0,41294,0,39,0,-871,39
2025-05-05,8932,290,0,41294,247,14115,14072,,0,19,0,41294,30,28,39,43,-11
2025-05-06,8932,265,0,41294,26,14354,14115,,1,11,0,41294,10,29,28,239,1
2025-05-07,8932,130,0,41294,168,14316,14354,,0,1,0,41294,12,18,29,-38,-11
2025-05-08,8932,207,0,41294,397,14126,14316,,0,4,0,41294,1,21,18,-190,3
2025-05-09,8932,138,0,41294,37,14227,14126,,0,0,13,41294,2,6,21,101,-15
2025-05-12,8932,146,0,41294,324,14049,14227,,0,0,0,41294,0,6,6,-178,0
2025-05-13,8932,206,0,41294,70,14185,14049,,10,2,0,41294,2,6,6,136,0
2025-05-14,8932,226,0,41294,265,14146,14185,,0,2,0,41294,0,8,6,-39,2
2025-05-15,8932,172,0,41294,53,14265,14146,,0,0,0,41294,4,4,8,119,-4
2025-05-16,8932,385,0,41294,16,14634,14265,,0,0,0,41294,0,4,4,369,0
2025-05-19,8932,289,0,41294,120,14803,14634,,0,0,0,41294,0,4,4,169,0
2025-05-20,8932,23,0,41294,69,14757,14803,,0,0,0,41294,0,4,4,-46,0
2025-05-21,8932,83,0,41294,121,14719,14757,,0,0,0,41294,0,4,4,-38,0
2025-05-22,8932,73,0,41294,79,14713,14719,,0,0,0,41294,0,4,4,-6,0
2025-05-23,8932,104,0,41294,543,14274,14713,,20,0,0,41294,0,4,4,-439,0
2025-05-26,8932,48,0,41294,17,14305,14274,,0,0,0,41294,0,4,4,31,0
2025-05-27,8932,50,0,41294,34,14321,14305,,0,1,0,41294,0,5,4,16,1
2025-05-28,8932,110,0,41294,500,13931,14321,,0,6,0,41294,3,8,5,-390,3
2025-05-29,8932,204,0,41294,421,13714,13931,,51,4,0,41294,1,11,8,-217,3
2025-06-02,8932,95,0,41294,38,13771,13714,,0,0,0,41294,1,10,11,57,-1
2025-06-03,8932,105,0,41294,41,13835,13771,,0,0,0,41294,3,7,10,64,-3
2025-06-04,8932,82,0,41294,237,13680,13835,,1,0,0,41294,0,7,7,-155,0
2025-06-05,8932,71,0,41294,97,13654,13680,,0,0,0,41294,0,7,7,-26,0
2025-06-06,8932,1325,0,41294,1717,13262,13654,,0,6,0,41294,0,13,7,-392,6
2025-06-09,8932,2518,0,41294,1434,14346,13262,,3,117,0,41294,0,130,13,1084,117
2025-06-10,8932,1872,7,41294,2012,14199,14346,,26,325,0,41294,65,390,130,-147,260
2025-06-11,8932,1906,0,41294,2176,13929,14199,,86,301,0,41294,116,575,390,-270,185
2025-06-12,8932,1122,0,41294,960,14091,13929,,7,58,0,41294,73,560,575,162,-15
2025-06-13,8932,1349,586,41294,649,14205,14091,,4,115,0,41294,54,621,560,114,61
2025-06-16,8932,716,0,41294,790,14131,14205,,6,47,0,41294,118,550,621,-74,-71
2025-06-17,8932,2384,0,41294,2136,14379,14131,,55,20,0,41294,266,304,550,248,-246
2025-06-18,8932,735,0,41294,619,14495,14379,,7,57,0,41294,126,235,304,116,-69
2025-06-19,8932,788,8,41294,789,14486,14495,,8,100,0,41294,13,322,235,-9,87
2025-06-20,8932,580,3,41294,585,14478,14486,,2,40,40,41294,53,269,322,-8,-53
2025-06-23,8932,405,0,41294,127,14756,14478,,5,12,0,41294,87,194,269,278,-75
2025-06-24,8932,1030,0,41294,345,15441,14756,,8,34,0,41294,6,222,194,685,28
2025-06-25,8932,316,1,41294,256,15500,15441,,0,13,0,41294,25,210,222,59,-12
2025-06-26,8932,377,0,41294,274,15603,15500,,1,2,0,41294,3,209,210,103,-1
2025-06-27,8932,929,0,41294,324,16208,15603,,10,2,1,41294,35,175,209,605,-34
2025-06-30,8932,317,0,41294,542,15983,16208,,1,10,0,41294,20,165,175,-225,-10
2025-07-01,8932,428,0,41294,372,16039,15983,,0,21,0,41294,5,181,165,56,16
2025-07-02,8932,2747,1,41294,2225,16560,16039,,3,110,0,41294,12,279,181,521,98
2025-07-03,8932,2487,0,41294,1692,17355,16560,,24,97,0,41294,40,336,279,795,57
2025-07-04,8932,2073,0,41294,2915,16513,17355,,11,107,0,41294,72,371,336,-842,35
2025-07-07,8932,746,140,41294,949,16170,16513,,2,9,0,41294,71,309,371,-343,-62
2025-07-08,8932,449,12,41294,243,16364,16170,,0,5,0,41294,41,273,309,194,-36
2025-07-09,8932,447,0,41294,269,16542,16364,,0,14,0,41294,9,278,273,178,5
2025-07-10,8932,525,0,41294,1020,16047,16542,,21,29,30,41294,49,228,278,-495,-50
2025-07-11,8932,749,5,41294,973,15818,16047,,19,16,0,41294,15,229,228,-229,1
2025-07-14,8932,478,0,41294,324,15972,15818,,2,5,0,41294,5,229,229,154,0
2025-07-15,8932,692,2,41294,1020,15642,15972,,5,19,0,41294,35,213,229,-330,-16
2025-07-16,8932,2360,1,41294,1862,16139,15642,,34,42,0,41294,15,240,213,497,27
2025-07-17,8932,523,0,41294,786,15876,16139,,4,15,30,41294,13,212,240,-263,-28
2025-07-18,8932,1317,2,41294,984,16207,15876,,9,55,0,41294,2,265,212,331,53
2025-07-21,8932,425,0,41294,966,15666,16207,,5,8,0,41294,12,261,265,-541,-4
2025-07-22,8932,687,0,41294,683,15670,15666,,1,3,0,41294,19,245,261,4,-16
2025-07-23,8932,513,1,41294,444,15738,15670,,1,40,0,41294,1,284,245,68,39
2025-07-24,8932,775,0,41294,695,15818,15738,,4,18,0,41294,57,245,284,80,-39
2025-07-25,8932,1221,5,41294,1298,15736,15818,,4,3,0,41294,8,240,245,-82,-5
2025-07-28,8932,1220,18,41294,1220,15718,15736,,8,31,0,41294,5,266,240,-18,26
2025-07-29,8932,1250,0,41294,951,16017,15718,,9,9,0,41294,14,261,266,299,-5
2025-07-30,8932,1136,2,41294,605,16546,16017,,5,64,0,41294,0,325,261,529,64
2025-07-31,8932,1184,0,41294,1235,16495,16546,,4,63,0,41294,12,376,325,-51,51
2025-08-01,8932,785,0,41294,1039,16241,16495,,2,14,0,41294,21,369,376,-254,-7
2025-08-04,8932,657,0,41294,992,15906,16241,,3,15,0,41294,29,355,369,-335,-14
2025-08-05,8932,544,1,41294,648,15801,15906,,6,14,0,41294,7,362,355,-105,7
2025-08-06,8932,884,0,41294,713,15972,15801,,4,16,0,41294,6,372,362,171,10
2025-08-07,8932,672,0,41294,1203,15441,15972,,1,1,0,41294,71,302,372,-531,-70
2025-08-08,8932,620,2,41294,666,15393,15441,,3,1,0,41294,1,302,302,-48,0
2025-08-11,8932,1011,0,41294,1176,15228,15393,,2,3,0,41294,10,295,302,-165,-7
2025-08-12,8932,602,1,41294,417,15412,15228,,1,25,0,41294,28,292,295,184,-3
2025-08-13,8932,953,0,41294,740,15625,15412,,8,44,0,41294,28,308,292,213,16
2025-08-14,8932,995,30,41294,641,15949,15625,,0,3,0,41294,29,282,308,324,-26
2025-08-15,8932,457,0,41294,564,15842,15949,,0,4,0,41294,25,261,282,-107,-21
2025-08-18,8932,857,1,41294,1008,15690,15842,,6,16,0,41294,39,238,261,-152,-23
2025-08-19,8932,605,1,41294,854,15440,15690,,1,4,1,41294,24,217,238,-250,-21
2025-08-20,8932,366,1,41294,395,15410,15440,,4,10,0,41294,1,226,217,-30,9
2025-08-21,8932,756,1,41294,529,15636,15410,,2,40,0,41294,30,236,226,226,10
2025-08-22,8932,317,0,41294,209,15744,15636,,1,1,0,41294,56,181,236,108,-55
2025-08-25,8932,571,0,41294,541,15774,15744,,3,42,0,41294,16,207,181,30,26
2025-08-26,8932,246,3,41294,545,15472,15774,,2,15,0,41294,30,192,207,-302,-15
2025-08-27,8932,330,0,41294,333,15469,15472,,1,1,0,41294,34,159,192,-3,-33
2025-08-28,8932,228,4,41294,395,15298,15469,,0,9,3,41294,5,160,159,-171,1
2025-08-29,8932,694,0,41294,567,15425,15298,,8,0,0,41294,27,133,160,127,-27
2025-09-01,8932,383,10,41294,396,15402,15425,X,0,0,0,41294,18,115,133,-23,-18
2025-09-02,8932,664,0,41294,926,15140,15402,X,0,0,29,41294,86,0,115,-262,-115
2025-09-03,8932,623,0,41294,298,15465,15140,X,0,0,0,41294,0,0,0,325,0
2025-09-04,8932,450,0,41294,154,15761,15465,X,0,0,0,41294,0,0,0,296,0
2025-09-05,8932,650,1,41294,761,15649,15761,,0,0,0,41294,0,0,0,-112,0
2025-09-08,8932,593,0,41294,546,15696,15649,,62,20,0,41294,0,20,0,47,20
2025-09-09,8932,895,0,41294,345,16246,15696,,100,1,0,41294,0,21,20,550,1
2025-09-10,8932,557,15,41294,351,16437,16246,,1,2,0,41294,10,13,21,191,-8
2025-09-11,8932,636,0,41294,1039,16034,16437,,2,1,0,41294,6,8,13,-403,-5
2025-09-12,8932,705,1,41294,1179,15559,16034,,1,6,0,41294,0,14,8,-475,6
2025-09-15,8932,575,3,41294,1203,14928,15559,,1,16,0,41294,3,27,14,-631,13
2025-09-16,8932,1079,1,41294,491,15515,14928,,11,14,0,41294,6,35,27,587,8
2025-09-17,8932,195,0,41294,361,15349,15515,,2,4,0,41294,12,27,35,-166,-8
2025-09-18,8932,133,0,41294,177,15305,15349,,5,22,0,41294,2,47,27,-44,20
2025-09-19,8932,327,0,41294,178,15454,15305,,1,1,0,41294,5,43,47,149,-4
