date,stock_id,MarginPurchaseBuy,MarginPurchaseCashRepayment,MarginPurchaseLimit,MarginPurchaseSell,MarginPurchaseTodayBalance,MarginPurchaseYesterdayBalance,Note,OffsetLoanAndShort,ShortSaleBuy,ShortSaleCashRepayment,ShortSaleLimit,ShortSaleSell,ShortSaleTodayBalance,ShortSaleYesterdayBalance,MarginPurchaseTodayBalance_delta,ShortSaleTodayBalance_delta
2025-06-25,1313,32,0,342088,48,5800,5816, ,0,0,0,342088,0,0,0,-16,0
2025-06-26,1313,45,14,342088,123,5708,5800, ,0,0,0,342088,0,0,0,-92,0
2025-06-27,1313,38,6,342088,55,5685,5708, ,0,0,0,342088,0,0,0,-23,0
2025-06-30,1313,15,4,342088,7,5689,5685, ,0,0,0,342088,0,0,0,4,0
2025-07-01,1313,9,0,342088,18,5680,5689, ,3,0,0,342088,3,3,0,-9,3
2025-07-02,1313,155,4,342088,29,5802,5680, ,0,0,0,342088,0,3,3,122,0
2025-07-03,1313,219,0,342088,284,5737,5802, ,0,0,0,342088,1,4,3,-65,1
2025-07-04,1313,6,0,342088,74,5669,5737, ,0,0,0,342088,0,4,4,-68,0
2025-07-07,1313,8,0,342088,20,5657,5669, ,0,0,0,342088,1,5,4,-12,1
2025-07-08,1313,11,0,342088,63,5605,5657, ,0,0,0,342088,2,7,5,-52,2
2025-07-09,1313,29,0,342088,1,5633,5605, ,0,2,0,342088,0,5,7,28,-2
2025-07-10,1313,16,0,342088,2,5647,5633, ,0,0,0,342088,1,6,5,14,1
2025-07-11,1313,63,3,342088,8,5699,5647, ,0,0,0,342088,0,6,6,52,0
2025-07-14,1313,71,0,342088,175,5595,5699, ,1,0,0,342088,0,6,6,-104,0
2025-07-15,1313,1707,0,342088,382,6920,5595, ,25,0,0,342088,43,49,6,1325,43
2025-07-16,1313,474,0,342088,644,6750,6920, ,24,1,0,342088,59,107,49,-170,58
2025-07-17,1313,1335,0,342088,954,7131,6750, ,57,0,0,342088,105,212,107,381,105
2025-07-18,1313,557,0,342088,324,7364,7131, ,16,6,0,342088,3,209,212,233,-3
2025-07-21,1313,637,2,342088,299,7700,7364, ,22,47,2,342088,14,174,209,336,-35
2025-07-22,1313,1266,0,342088,692,8271,7697, ,23,8,0,342088,70,236,174,574,62
2025-07-23,1313,1012,0,342088,722,8561,8271, ,24,5,0,342088,27,258,236,290,22
2025-07-24,1313,1088,0,342088,468,9181,8561, ,4,19,0,342088,23,262,258,620,4
2025-07-25,1313,703,0,342088,423,9461,9181, ,10,30,0,342088,4,236,262,280,-26
2025-07-28,1313,663,0,342088,734,9390,9461, ,9,0,0,342088,33,269,236,-71,33
2025-07-29,1313,576,1,342088,496,9469,9390, ,6,18,1,342088,37,287,269,79,18
2025-07-30,1313,1849,0,342088,634,10684,9469, ,21,39,0,342088,1,249,287,1215,-38
2025-07-31,1313,558,0,342088,506,10736,10684, ,6,16,0,342088,4,237,249,52,-12
2025-08-01,1313,468,0,342088,187,11017,10736, ,3,3,0,342088,22,256,237,281,19
2025-08-04,1313,1028,0,342088,1188,10857,11017, ,15,76,0,342088,23,203,256,-160,-53
2025-08-05,1313,87,0,342088,259,10685,10857, ,2,12,0,342088,0,191,203,-172,-12
2025-08-06,1313,392,0,342088,480,10597,10685, ,2,4,0,342088,0,187,191,-88,-4
2025-08-07,1313,160,0,342088,451,10306,10597, ,1,1,0,342088,1,187,187,-291,0
2025-08-08,1313,253,0,342088,665,9894,10306, ,4,2,0,342088,2,187,187,-412,0
2025-08-11,1313,180,0,342088,660,9414,9894, ,1,1,0,342088,0,186,187,-480,-1
2025-08-12,1313,562,45,342088,592,9339,9414, ,7,0,0,342088,13,199,186,-75,13
2025-08-13,1313,229,0,342088,480,9088,9339, ,4,1,0,342088,0,198,199,-251,-1
2025-08-14,1313,63,0,342278,88,9063,9088, ,15,6,0,342278,0,192,198,-25,-6
2025-08-15,1313,89,6,340112,268,8878,9063, ,0,0,0,340112,1,193,192,-185,1
2025-08-18,1313,1296,0,340112,882,9292,8878, ,23,3,0,340112,28,218,193,414,25
2025-08-19,1313,393,0,340112,618,9067,9292, ,5,13,0,340112,4,209,218,-225,-9
2025-08-20,1313,714,0,340112,937,8844,9067, ,2,10,0,340112,38,237,209,-223,28
2025-08-21,1313,763,0,340112,536,9071,8844, ,2,38,0,340112,1,200,237,227,-37
2025-08-22,1313,417,0,340112,444,9044,9071, ,6,5,0,340112,0,195,200,-27,-5
2025-08-25,1313,394,0,340112,516,8922,9044, ,1,0,0,340112,3,198,195,-122,3
2025-08-26,1313,692,0,340112,656,8958,8922, ,0,3,0,340112,0,195,198,36,-3
2025-08-27,1313,261,0,340112,452,8767,8958, ,0,2,0,340112,10,203,195,-191,8
2025-08-28,1313,156,0,340112,129,8794,8767, ,1,28,0,340112,0,175,203,27,-28
2025-08-29,1313,255,0,340112,265,8784,8794, ,14,3,0,340112,2,174,175,-10,-1
2025-09-01,1313,164,0,340112,146,8802,8784, ,0,0,0,340112,0,174,174,18,0
2025-09-02,1313,124,0,340112,205,8721,8802, ,4,2,0,340112,43,215,174,-81,41
2025-09-03,1313,210,0,340112,242,8689,8721, ,2,17,0,340112,0,198,215,-32,-17
2025-09-04,1313,119,0,340112,361,8447,8689, ,1,15,0,340112,0,183,198,-242,-15
2025-09-05,1313,51,0,340112,199,8299,8447, ,0,7,0,340112,5,181,183,-148,-2
2025-09-08,1313,85,0,340112,111,8273,8299, ,1,1,0,340112,5,185,181,-26,4
2025-09-09,1313,20,0,340112,90,8203,8273, ,0,14,0,340112,0,171,185,-70,-14
2025-09-10,1313,44,1,340112,106,8140,8203, ,0,0,0,340112,2,173,171,-63,2
2025-09-11,1313,72,1,340112,70,8141,8140, ,0,8,0,340112,0,165,173,1,-8
2025-09-12,1313,16,0,340211,247,7910,8141, ,0,2,0,340211,1,164,165,-231,-1
2025-09-15,1313,29,0,340211,5,7934,7910, ,0,0,0,340211,0,164,164,24,0
2025-09-16,1313,22,1,340211,55,7900,7934, ,0,0,0,340211,1,165,164,-34,1
2025-09-17,1313,19,0,340211,21,7898,7900, ,0,0,0,340211,0,165,165,-2,0
2025-09-18,1313,129,5,340211,386,7636,7898, ,0,2,0,340211,2,165,165,-262,0
2025-09-19,1313,136,0,340211,43,7729,7636, ,0,1,0,340211,0,164,165,93,-1
2025-09-22,1313,34,0,340211,94,7669,7729, ,0,1,0,340211,0,163,164,-60,-1
2025-09-23,1313,696,0,340211,510,7855,7669, ,0,1,0,340211,4,166,163,186,3
2025-06-25,1316,115,0,91690,133,21580,21598, ,0,2,0,91690,0,87,89,-18,-2
2025-06-26,1316,301,1,91690,233,21647,21580, ,4,1,0,91690,2,88,87,67,1
2025-06-27,1316,114,4,91690,84,21673,21647, ,0,1,0,91690,11,98,88,26,10
2025-06-30,1316,60,0,91690,117,21616,21673, ,2,5,0,91690,0,93,98,-57,-5
2025-07-01,1316,13,0,91690,172,21457,21616, ,0,0,0,91690,0,93,93,-159,0
2025-07-02,1316,514,0,91690,195,21776,21457, ,0,0,0,91690,33,126,93,319,33
2025-07-03,1316,76,0,91690,240,21612,21776, ,1,2,0,91690,0,124,126,-164,-2
2025-07-04,1316,229,0,91690,229,21612,21612, ,0,36,0,91690,0,88,124,0,-36
2025-07-07,1316,252,2,91690,139,21723,21612, ,4,0,0,91690,2,90,88,111,2
2025-07-08,1316,199,0,91690,26,21896,21723, ,1,10,0,91690,0,80,90,173,-10
2025-07-09,1316,106,12,91690,72,21918,21896, ,6,1,0,91690,22,101,80,22,21
2025-07-10,1316,71,30,91690,109,21850,21918, ,2,19,0,91690,0,82,101,-68,-19
2025-07-11,1316,750,0,91690,586,22014,21850, ,31,12,0,91690,46,116,82,164,34
2025-07-14,1316,227,0,91690,187,22054,22014, ,2,4,0,91690,2,114,116,40,-2
2025-07-15,1316,832,2,91690,409,22475,22054, ,10,0,0,91690,3,117,114,421,3
2025-07-16,1316,650,4,91690,938,22183,22475, ,2,0,0,91690,47,164,117,-292,47
2025-07-17,1316,142,0,91690,319,22006,22183, ,5,31,0,91690,12,145,164,-177,-19
2025-07-18,1316,290,0,91690,194,22102,22006, ,7,26,0,91690,0,119,145,96,-26
2025-07-21,1316,134,0,91690,197,22039,22102, ,8,2,0,91690,1,118,119,-63,-1
2025-07-22,1316,164,1,91690,163,22039,22039, ,1,29,0,91690,1,90,118,0,-28
2025-07-23,1316,51,1,91690,184,21905,22039, ,1,0,0,91690,17,107,90,-134,17
2025-07-24,1316,101,4,91690,56,21946,21905, ,0,14,0,91690,2,95,107,41,-12
2025-07-25,1316,70,25,91690,37,21954,21946, ,0,12,0,91690,0,83,95,8,-12
2025-07-28,1316,45,0,91690,61,21938,21954, ,1,2,0,91690,0,81,83,-16,-2
2025-07-29,1316,77,0,91690,103,21912,21938, ,0,0,0,91690,0,81,81,-26,0
2025-07-30,1316,50,3,91690,211,21748,21912, ,0,2,0,91690,3,82,81,-164,1
2025-07-31,1316,122,7,91690,102,21761,21748, ,0,2,0,91690,0,80,82,13,-2
2025-08-01,1316,50,2,91690,109,21700,21761, ,9,0,0,91690,20,100,80,-61,20
2025-08-04,1316,176,27,91690,157,21692,21700, ,1,5,0,91690,10,105,100,-8,5
2025-08-05,1316,195,7,91690,386,21494,21692, ,0,0,0,91690,1,106,105,-198,1
2025-08-06,1316,145,34,91690,465,21140,21494, ,0,0,0,91690,0,106,106,-354,0
2025-08-07,1316,298,122,91690,174,21142,21140, ,0,25,0,91690,4,85,106,2,-21
2025-08-08,1316,176,0,91690,33,21285,21142, ,0,13,0,91690,24,96,85,143,11
2025-08-11,1316,487,1,91690,391,21380,21285, ,3,13,0,91690,16,99,96,95,3
2025-08-12,1316,0,18,91690,0,21362,21380, ,0,0,0,91690,0,99,99,-18,0
2025-08-13,1316,2548,6,91690,907,22997,21362, ,20,15,0,91690,51,135,99,1635,36
2025-08-14,1316,767,1,91690,1982,21781,22997, ,2,24,0,91690,6,117,135,-1216,-18
2025-08-15,1316,408,32,91690,470,21687,21781, ,0,25,0,91690,10,102,117,-94,-15
2025-08-18,1316,325,12,91690,901,21099,21687, ,1,5,0,91690,5,102,102,-588,0
2025-08-19,1316,128,281,91690,610,20336,21099, ,0,28,0,91690,0,74,102,-763,-28
2025-08-20,1316,237,1,91690,278,20294,20336, ,2,0,0,91690,3,77,74,-42,3
2025-08-21,1316,168,0,91690,272,20190,20294, ,6,0,0,91690,0,77,77,-104,0
2025-08-22,1316,84,11,91690,315,19948,20190, ,0,6,0,91690,5,76,77,-242,-1
2025-08-25,1316,136,2,91690,608,19474,19948, ,1,5,0,91690,0,71,76,-474,-5
2025-08-26,1316,230,20,91690,792,18892,19474, ,0,1,0,91690,0,70,71,-582,-1
2025-08-27,1316,199,5,91690,1881,17205,18892, ,0,7,0,91690,3,66,70,-1687,-4
2025-08-28,1316,70,2,91690,51,17222,17205, ,0,0,0,91690,0,66,66,17,0
2025-08-29,1316,56,47,91690,92,17139,17222, ,0,0,0,91690,3,69,66,-83,3
2025-09-01,1316,148,3,91690,188,17096,17139, ,18,0,0,91690,40,109,69,-43,40
2025-09-02,1316,78,136,91690,147,16891,17096, ,0,0,0,91690,3,112,109,-205,3
2025-09-03,1316,417,0,91690,470,16838,16891, ,6,0,11,91690,15,116,112,-53,4
2025-09-04,1316,6446,4,91690,2105,21175,16838, ,127,40,0,91690,225,301,116,4337,185
2025-09-05,1316,2590,30,91690,6312,17423,21175, ,213,71,0,91690,46,276,301,-3752,-25
2025-09-08,1316,1122,64,91690,1103,17378,17423, ,18,96,0,91690,14,194,276,-45,-82
2025-09-09,1316,846,0,91690,1316,16908,17378, ,2,41,0,91690,7,160,194,-470,-34
2025-09-10,1316,410,214,91690,507,16597,16908, ,2,29,0,91690,4,135,160,-311,-25
2025-09-11,1316,627,10,91690,291,16923,16597, ,10,25,0,91690,14,124,135,326,-11
2025-09-12,1316,321,8,91690,443,16793,16923, ,11,0,0,91690,6,130,124,-130,6
2025-09-15,1316,317,2,91690,361,16747,16793, ,15,0,0,91690,0,130,130,-46,0
2025-09-16,1316,305,0,91690,281,16771,16747, ,1,4,0,91690,0,126,130,24,-4
2025-09-17,1316,597,1,91690,840,16527,16771, ,7,13,0,91690,11,124,126,-244,-2
2025-09-18,1316,169,0,91690,403,16293,16527, ,18,5,0,91690,0,119,124,-234,-5
2025-09-19,1316,231,6,91690,435,16083,16293, ,3,38,0,91690,4,85,119,-210,-34
2025-09-22,1316,328,0,91690,496,15915,16083, ,5,1,0,91690,8,92,85,-168,7
2025-09-23,1316,512,10,91690,630,15787,15915, ,49,4,0,91690,21,109,92,-128,17
2025-06-25,1414,10,0,55000,0,2739,2729, ,0,0,0,55000,0,0,0,10,0
2025-06-26,1414,0,0,55000,2,2737,2739, ,0,0,0,55000,0,0,0,-2,0
2025-06-27,1414,0,0,55000,28,2709,2737, ,0,0,0,55000,0,0,0,-28,0
2025-06-30,1414,39,0,55000,0,2748,2709, ,0,0,0,55000,0,0,0,39,0
2025-07-01,1414,10,0,55000,0,2758,2748, ,0,0,0,55000,0,0,0,10,0
2025-07-02,1414,0,0,55000,1,2757,2758, ,0,0,0,55000,0,0,0,-1,0
2025-07-03,1414,0,0,55000,38,2719,2757, ,0,0,0,55000,0,0,0,-38,0
2025-07-04,1414,44,0,55000,0,2763,2719, ,1,0,0,55000,0,0,0,44,0
2025-07-07,1414,0,0,55000,0,2763,2763, ,0,0,0,55000,0,0,0,0,0
2025-07-08,1414,2,0,55000,67,2698,2763, ,0,0,0,55000,0,0,0,-65,0
2025-07-09,1414,74,0,55000,0,2772,2698, ,0,0,0,55000,0,0,0,74,0
2025-07-10,1414,1,0,55000,112,2661,2772, ,0,0,0,55000,0,0,0,-111,0
2025-07-11,1414,79,0,55000,4,2736,2661, ,0,0,0,55000,0,0,0,75,0
2025-07-14,1414,34,0,55000,0,2770,2736, ,0,0,0,55000,0,0,0,34,0
2025-07-15,1414,1,0,55000,0,2771,2770, ,0,0,0,55000,0,0,0,1,0
2025-07-16,1414,2,0,55000,120,2653,2771, ,0,0,0,55000,0,0,0,-118,0
2025-07-17,1414,0,0,55000,111,2542,2653, ,0,0,0,55000,0,0,0,-111,0
2025-07-18,1414,65,0,55000,0,2607,2542, ,0,0,0,55000,0,0,0,65,0
2025-07-21,1414,4,0,55000,40,2571,2607, ,0,0,0,55000,0,0,0,-36,0
2025-07-22,1414,5,0,55000,62,2514,2571, ,0,0,0,55000,0,0,0,-57,0
2025-07-23,1414,0,0,55000,398,2116,2514, ,12,0,0,55000,0,0,0,-398,0
2025-07-24,1414,0,0,55000,4,2112,2116, ,0,0,0,55000,0,0,0,-4,0
2025-07-25,1414,0,0,55000,98,2014,2112, ,0,0,0,55000,0,0,0,-98,0
2025-07-28,1414,0,0,55000,128,1886,2014, ,0,0,0,55000,0,0,0,-128,0
2025-07-29,1414,1,0,55000,0,1887,1886, ,0,0,0,55000,0,0,0,1,0
2025-07-30,1414,0,0,55000,204,1683,1887, ,0,0,0,55000,0,0,0,-204,0
2025-07-31,1414,62,0,55000,66,1679,1683, ,0,0,0,55000,0,0,0,-4,0
2025-08-01,1414,98,0,55000,20,1757,1679, ,0,0,0,55000,0,0,0,78,0
2025-08-04,1414,1,0,55000,173,1585,1757, ,0,0,0,55000,0,0,0,-172,0
2025-08-05,1414,0,0,55000,109,1476,1585, ,0,0,0,55000,0,0,0,-109,0
2025-08-06,1414,0,0,55000,33,1443,1476, ,0,0,0,55000,0,0,0,-33,0
2025-08-07,1414,154,0,55000,0,1597,1443, ,0,0,0,55000,0,0,0,154,0
2025-08-08,1414,127,0,55000,30,1694,1597, ,0,0,0,55000,0,0,0,97,0
2025-08-11,1414,7,0,55000,92,1609,1694, ,0,0,0,55000,0,0,0,-85,0
2025-08-12,1414,0,0,55000,21,1588,1609, ,0,0,0,55000,0,0,0,-21,0
2025-08-13,1414,71,0,55000,0,1659,1588, ,0,0,0,55000,0,0,0,71,0
2025-08-14,1414,5,0,55000,43,1621,1659, ,0,0,0,55000,0,0,0,-38,0
2025-08-15,1414,0,0,55000,44,1577,1621, ,0,0,0,55000,0,0,0,-44,0
2025-08-18,1414,48,0,55000,20,1605,1577, ,0,0,0,55000,0,0,0,28,0
2025-08-19,1414,125,0,55000,35,1695,1605, ,0,0,0,55000,4,4,0,90,4
2025-08-20,1414,92,0,55000,0,1787,1695, ,0,0,0,55000,0,4,4,92,0
2025-08-21,1414,0,0,55000,82,1705,1787, ,0,4,0,55000,0,0,4,-82,-4
2025-08-22,1414,126,0,55000,10,1821,1705, ,0,0,0,55000,0,0,0,116,0
2025-08-25,1414,66,0,55000,0,1887,1821, ,0,0,0,55000,0,0,0,66,0
2025-08-26,1414,31,0,55000,0,1918,1887, ,0,0,0,55000,0,0,0,31,0
2025-08-27,1414,2,0,55000,50,1870,1918, ,0,0,0,55000,0,0,0,-48,0
2025-08-28,1414,0,0,55000,37,1833,1870, ,0,0,0,55000,0,0,0,-37,0
2025-08-29,1414,28,0,55000,0,1861,1833, ,0,0,0,55000,0,0,0,28,0
2025-09-01,1414,35,0,55000,1,1895,1861, ,0,0,0,55000,0,0,0,34,0
2025-09-02,1414,3,0,55000,216,1682,1895, ,0,0,0,55000,0,0,0,-213,0
2025-09-03,1414,139,0,55000,10,1811,1682, ,0,0,0,55000,0,0,0,129,0
2025-09-04,1414,0,0,55000,356,1455,1811, ,0,0,0,55000,0,0,0,-356,0
2025-09-05,1414,0,0,55000,4,1451,1455, ,0,0,0,55000,0,0,0,-4,0
2025-09-08,1414,25,0,55000,11,1465,1451, ,0,0,0,55000,0,0,0,14,0
2025-09-09,1414,0,0,55000,37,1428,1465, ,0,0,0,55000,0,0,0,-37,0
2025-09-10,1414,31,0,55000,0,1459,1428, ,0,0,0,55000,0,0,0,31,0
2025-09-11,1414,41,0,55000,0,1500,1459, ,0,0,0,55000,0,0,0,41,0
2025-09-12,1414,0,0,55000,51,1449,1500, ,0,0,0,55000,0,0,0,-51,0
2025-09-15,1414,0,0,55000,51,1398,1449, ,0,0,0,55000,0,0,0,-51,0
2025-09-16,1414,3,0,55000,0,1401,1398, ,0,0,0,55000,0,0,0,3,0
2025-09-17,1414,2,0,55000,2,1401,1401, ,0,0,0,55000,0,0,0,0,0
2025-09-18,1414,96,0,55000,8,1489,1401, ,0,0,0,55000,0,0,0,88,0
2025-09-19,1414,1,0,55000,44,1446,1489, ,0,0,0,55000,0,0,0,-43,0
2025-09-22,1414,59,0,55000,1,1504,1446, ,0,0,0,55000,0,0,0,58,0
2025-09-23,1414,1,0,55000,84,1421,1504, ,0,0,0,55000,0,0,0,-83,0
2025-06-25,1419,94,0,75010,91,2847,2844, ,0,4,0,75010,10,113,107,3,6
2025-06-26,1419,366,0,75010,170,3043,2847, ,1,2,0,75010,36,147,113,196,34
2025-06-27,1419,989,0,75010,473,3559,3043, ,10,11,0,75010,252,388,147,516,241
2025-06-30,1419,159,0,75010,256,3462,3559, ,1,225,0,75010,9,172,388,-97,-216
2025-07-01,1419,160,0,75010,320,3302,3462, ,10,15,0,75010,4,161,172,-160,-11
2025-07-02,1419,158,0,75010,506,2954,3302, ,1,18,0,75010,5,148,161,-348,-13
2025-07-03,1419,57,0,75010,65,2946,2954, ,0,0,0,75010,8,156,148,-8,8
2025-07-04,1419,60,0,75010,67,2939,2946, ,2,13,0,75010,7,150,156,-7,-6
2025-07-07,1419,24,0,75010,44,2919,2939, ,1,20,0,75010,3,133,150,-20,-17
2025-07-08,1419,65,0,75010,91,2893,2919, ,1,22,0,75010,3,114,133,-26,-19
2025-07-09,1419,26,0,75010,43,2876,2893, ,0,41,0,75010,0,73,114,-17,-41
2025-07-10,1419,72,0,75010,186,2762,2876, ,2,25,0,75010,2,50,73,-114,-23
2025-07-11,1419,24,0,75010,47,2739,2762, ,0,7,0,75010,4,47,50,-23,-3
2025-07-14,1419,54,0,75010,19,2774,2739, ,0,19,0,75010,6,34,47,35,-13
2025-07-15,1419,9,1,75010,18,2764,2774, ,0,8,0,75010,4,30,34,-10,-4
2025-07-16,1419,133,0,75010,118,2779,2764, ,3,5,0,75010,22,47,30,15,17
2025-07-17,1419,37,0,75010,47,2769,2779,X ,0,33,0,75010,5,19,47,-10,-28
2025-07-18,1419,40,0,75010,48,2761,2769,X ,0,10,0,75010,0,9,19,-8,-10
2025-07-21,1419,30,0,75010,22,2769,2761,X ,0,0,9,75010,0,0,9,8,-9
2025-07-22,1419,36,0,75010,25,2779,2768,X ,0,0,0,75010,0,0,0,11,0
2025-07-23,1419,13,0,75010,63,2729,2779, ,0,0,0,75010,0,0,0,-50,0
2025-07-24,1419,30,0,75010,97,2662,2729, ,4,0,0,75010,11,11,0,-67,11
2025-07-25,1419,120,2,75010,580,2200,2662, ,1,9,0,75010,5,7,11,-462,-4
2025-07-28,1419,118,0,75010,370,1948,2200, ,0,1,0,75010,38,44,7,-252,37
2025-07-29,1419,64,0,75010,23,1989,1948, ,0,3,0,75010,14,55,44,41,11
2025-07-30,1419,3,0,75010,10,1982,1989, ,0,5,0,75010,1,51,55,-7,-4
2025-07-31,1419,32,1,75010,22,1991,1982, ,0,11,0,75010,0,40,51,9,-11
2025-08-01,1419,17,0,75010,9,1999,1991, ,0,9,0,75010,0,31,40,8,-9
2025-08-04,1419,5,0,75010,0,2004,1999, ,0,0,0,75010,0,31,31,5,0
2025-08-05,1419,21,0,75010,23,2002,2004, ,0,26,0,75010,0,5,31,-2,-26
2025-08-06,1419,73,0,75010,40,2035,2002, ,0,0,0,75010,4,9,5,33,4
2025-08-07,1419,37,0,75010,17,2055,2035, ,0,1,0,75010,0,8,9,20,-1
2025-08-08,1419,9,0,75010,7,2057,2055, ,0,3,0,75010,0,5,8,2,-3
2025-08-11,1419,17,0,75010,35,2039,2057, ,0,0,0,75010,2,7,5,-18,2
2025-08-12,1419,233,0,75010,55,2217,2039, ,0,0,0,75010,6,13,7,178,6
2025-08-13,1419,30,0,75010,22,2225,2217, ,0,0,0,75010,5,18,13,8,5
2025-08-14,1419,75,0,75010,9,2291,2225, ,0,2,0,75010,0,16,18,66,-2
2025-08-15,1419,64,1,75010,109,2245,2291, ,0,0,0,75010,0,16,16,-46,0
2025-08-18,1419,106,0,75010,127,2224,2245, ,0,1,0,75010,3,18,16,-21,2
2025-08-19,1419,44,0,75010,129,2139,2224, ,0,0,0,75010,2,20,18,-85,2
2025-08-20,1419,19,1,75010,39,2118,2139, ,0,0,0,75010,0,20,20,-21,0
2025-08-21,1419,22,0,75010,40,2100,2118, ,0,0,0,75010,0,20,20,-18,0
2025-08-22,1419,238,0,75010,29,2309,2100, ,13,1,0,75010,3,22,20,209,2
2025-08-25,1419,132,0,75010,108,2333,2309, ,16,0,0,75010,2,24,22,24,2
2025-08-26,1419,38,0,75010,25,2346,2333, ,18,0,0,75010,0,24,24,13,0
2025-08-27,1419,6,0,75010,32,2320,2346, ,0,1,0,75010,0,23,24,-26,-1
2025-08-28,1419,33,0,75010,14,2339,2320, ,0,0,0,75010,1,24,23,19,1
2025-08-29,1419,25,0,75010,32,2332,2339, ,0,0,0,75010,0,24,24,-7,0
2025-09-01,1419,11,0,75010,35,2308,2332, ,0,2,0,75010,0,22,24,-24,-2
2025-09-02,1419,24,0,75010,54,2278,2308, ,0,0,0,75010,0,22,22,-30,0
2025-09-03,1419,14,5,75010,36,2251,2278, ,0,0,0,75010,0,22,22,-27,0
2025-09-04,1419,57,1,75010,129,2178,2251, ,0,0,0,75010,1,23,22,-73,1
2025-09-05,1419,36,0,75010,31,2183,2178, ,0,2,0,75010,0,21,23,5,-2
2025-09-08,1419,53,0,75010,67,2169,2183, ,0,0,0,75010,0,21,21,-14,0
2025-09-09,1419,38,0,75010,28,2179,2169, ,0,0,0,75010,0,21,21,10,0
2025-09-10,1419,38,0,75010,30,2187,2179, ,0,0,0,75010,0,21,21,8,0
2025-09-11,1419,104,0,75010,34,2257,2187, ,0,1,0,75010,1,21,21,70,0
2025-09-12,1419,36,0,75010,36,2257,2257, ,0,0,0,75010,0,21,21,0,0
2025-09-15,1419,7,8,75010,9,2247,2257, ,0,0,0,75010,0,21,21,-10,0
2025-09-16,1419,35,0,75010,17,2265,2247, ,0,0,0,75010,0,21,21,18,0
2025-09-17,1419,274,0,75010,69,2470,2265, ,1,1,0,75010,4,24,21,205,3
2025-09-18,1419,68,0,75010,57,2481,2470, ,0,1,0,75010,0,23,24,11,-1
2025-09-19,1419,48,0,75010,31,2498,2481, ,0,1,0,75010,1,23,23,17,0
2025-09-22,1419,62,0,75010,13,2547,2498, ,0,1,0,75010,0,22,23,49,-1
2025-09-23,1419,27,0,75010,48,2526,2547, ,0,0,0,75010,3,25,22,-21,3
2025-06-25,1504,64,0,534699,25,8127,8088, ,0,3,0,534699,1,37,39,39,-2
2025-06-26,1504,68,4,534699,119,8072,8127, ,0,1,0,534699,5,41,37,-55,4
2025-06-27,1504,36,0,534699,34,8074,8072, ,0,0,0,534699,0,41,41,2,0
2025-06-30,1504,141,0,534699,33,8182,8074, ,1,3,0,534699,21,59,41,108,18
2025-07-01,1504,67,0,534699,76,8173,8182, ,3,19,0,534699,7,47,59,-9,-12
2025-07-02,1504,101,0,534699,147,8127,8173, ,1,5,0,534699,25,67,47,-46,20
2025-07-03,1504,45,1,534699,14,8157,8127, ,0,0,0,534699,3,70,67,30,3
2025-07-04,1504,166,1,534699,23,8299,8157, ,0,42,0,534699,8,36,70,142,-34
2025-07-07,1504,34,0,534699,12,8321,8299, ,0,2,0,534699,2,36,36,22,0
2025-07-08,1504,120,3,534699,9,8429,8321, ,0,5,0,534699,65,96,36,108,60
2025-07-09,1504,21,5,534699,18,8427,8429, ,0,7,0,534699,2,91,96,-2,-5
2025-07-10,1504,28,0,534699,27,8428,8427, ,3,52,0,534699,13,52,91,1,-39
2025-07-11,1504,113,0,534699,10,8531,8428, ,0,6,0,534699,1,47,52,103,-5
2025-07-14,1504,86,0,534699,122,8495,8531, ,2,20,0,534699,42,69,47,-36,22
2025-07-15,1504,112,0,534699,61,8546,8495, ,0,24,0,534699,2,47,69,51,-22
2025-07-16,1504,232,6,534699,49,8723,8546, ,0,16,0,534699,0,31,47,177,-16
2025-07-17,1504,137,6,534699,32,8822,8723, ,0,0,0,534699,5,36,31,99,5
2025-07-18,1504,85,3,534699,43,8861,8822, ,0,2,0,534699,1,35,36,39,-1
2025-07-21,1504,430,0,534699,104,9187,8861, ,0,3,0,534699,4,36,35,326,1
2025-07-22,1504,300,2,534699,103,9382,9187, ,1,5,0,534699,2,33,36,195,-3
2025-07-23,1504,203,1,534699,96,9488,9382, ,0,5,0,534699,6,34,33,106,1
2025-07-24,1504,165,25,534699,15,9613,9488, ,2,1,0,534699,2,35,34,125,1
2025-07-25,1504,146,0,534699,41,9718,9613, ,0,17,0,534699,5,23,35,105,-12
2025-07-28,1504,95,1,534699,23,9789,9718, ,2,3,0,534699,0,20,23,71,-3
2025-07-29,1504,103,1,534699,49,9842,9789, ,0,2,0,534699,3,21,20,53,1
2025-07-30,1504,0,0,534699,0,9842,9842, ,0,0,0,534699,0,21,21,0,0
2025-07-31,1504,827,0,534699,221,10448,9842, ,0,0,0,534699,6,27,21,606,6
2025-08-01,1504,5713,3,534699,3214,12944,10448, ,65,12,0,534699,1045,1060,27,2496,1033
2025-08-04,1504,3376,1,534699,3207,13112,12944, ,88,870,0,534699,55,245,1060,168,-815
2025-08-05,1504,1303,1,534699,1548,12866,13112, ,9,117,3,534699,269,394,245,-246,149
2025-08-06,1504,1794,2,534699,709,13949,12866, ,7,129,1,534699,54,318,394,1083,-76
2025-08-07,1504,6308,4,534699,2755,17498,13949, ,100,22,3,534699,121,414,318,3549,96
2025-08-08,1504,869,33,534699,1472,16862,17498, ,11,48,0,534699,93,459,414,-636,45
2025-08-11,1504,785,0,534699,1023,16624,16862, ,0,61,0,534699,65,463,459,-238,4
2025-08-12,1504,1226,0,534699,1036,16814,16624, ,1,49,0,534699,2,416,463,190,-47
2025-08-13,1504,371,0,534699,1339,15846,16814, ,11,43,0,534699,41,414,416,-968,-2
2025-08-14,1504,1789,1,534699,811,16823,15846, ,4,222,1,534699,12,203,414,977,-211
2025-08-15,1504,1544,5,534699,2686,15676,16823, ,5,25,0,534699,175,353,203,-1147,150
2025-08-18,1504,3525,1,534699,3224,15976,15676, ,33,86,0,534699,33,300,353,300,-53
2025-08-19,1504,1278,0,534699,2064,15190,15976, ,0,54,0,534699,8,254,300,-786,-46
2025-08-20,1504,1430,0,534699,1409,15211,15190, ,9,17,0,534699,25,262,254,21,8
2025-08-21,1504,7283,2,534699,2307,20185,15211, ,125,20,1,534699,309,550,262,4974,288
2025-08-22,1504,8483,0,534699,9035,19633,20185, ,195,79,0,534699,1855,2326,550,-552,1776
2025-08-25,1504,9844,0,534699,6378,23099,19633, ,187,57,0,534699,2234,4503,2326,3466,2177
2025-08-26,1504,7685,1,534699,9400,21383,23099, ,93,989,1500,534699,109,2123,4503,-1716,-2380
2025-08-27,1504,4189,0,534699,3044,22528,21383, ,260,65,1200,534699,86,944,2123,1145,-1179
2025-08-28,1504,4118,16,534699,3638,22992,22528, ,26,188,1,534699,77,832,944,464,-112
2025-08-29,1504,2295,5,534699,1712,23570,22992, ,9,84,0,534699,72,820,832,578,-12
2025-09-01,1504,2260,11,534699,1923,23896,23570, ,50,149,1,534699,50,720,820,326,-100
2025-09-02,1504,1261,5,534699,2225,22927,23896, ,7,99,2,534699,79,698,720,-969,-22
2025-09-03,1504,1413,9,534699,657,23674,22927, ,11,40,1,534699,25,682,698,747,-16
2025-09-04,1504,3334,2,534699,2458,24548,23674, ,27,82,0,534699,20,620,682,874,-62
2025-09-05,1504,1246,5,534699,1168,24621,24548, ,4,25,0,534699,26,621,620,73,1
2025-09-08,1504,14114,0,534699,5075,33660,24621, ,79,38,0,534699,230,813,621,9039,192
2025-09-09,1504,14992,0,534699,11831,36821,33660, ,277,14,0,534699,1343,2142,813,3161,1329
2025-09-10,1504,8903,8,534699,5123,40593,36821, ,52,81,0,534699,1734,3795,2142,3772,1653
2025-09-11,1504,8802,1,534699,14861,34533,40593, ,443,577,6,534699,1664,4876,3795,-6060,1081
2025-09-12,1504,4717,4,534699,8293,30953,34533, ,120,1664,1,534699,749,3960,4876,-3580,-916
2025-09-15,1504,4139,1,534699,4027,31064,30953, ,102,421,1,534699,213,3751,3960,111,-209
2025-09-16,1504,2562,1,534699,4069,29556,31064, ,82,568,1,534699,1092,4274,3751,-1508,523
2025-09-17,1504,1209,4,534699,4565,26196,29556, ,26,223,4,534699,91,4138,4274,-3360,-136
2025-09-18,1504,2601,11,534699,3964,24822,26196, ,50,776,1,534699,256,3617,4138,-1374,-521
2025-09-19,1504,1345,5,534699,2512,23650,24822, ,18,399,2,534699,180,3396,3617,-1172,-221
2025-09-22,1504,5232,1,534699,2339,26542,23650, ,41,512,0,534699,326,3210,3396,2892,-186
2025-09-23,1504,10592,20,534699,7159,29955,26542, ,112,690,0,534699,2007,4527,3210,3413,1317
2025-06-25,1560,1053,0,36569,986,3705,3638, ,16,46,0,36569,26,500,520,67,-20
2025-06-26,1560,206,15,36569,541,3355,3705, ,21,12,2,36569,52,538,500,-350,38
2025-06-27,1560,195,0,36569,519,3031,3355, ,14,55,0,36569,21,504,538,-324,-34
2025-06-30,1560,197,3,36569,185,3040,3031, ,11,6,0,36569,32,530,504,9,26
2025-07-01,1560,135,2,36569,176,2997,3040, ,20,11,0,36569,28,547,530,-43,17
2025-07-02,1560,148,0,36569,140,3005,2997, ,21,10,0,36569,3,540,547,8,-7
2025-07-03,1560,621,0,36569,430,3196,3005, ,32,14,0,36569,67,593,540,191,53
2025-07-04,1560,263,0,36569,442,3017,3196, ,5,120,0,36569,1,474,593,-179,-119
2025-07-07,1560,149,0,36569,126,3040,3017, ,1,15,21,36569,7,445,474,23,-29
2025-07-08,1560,522,1,36569,475,3086,3040, ,6,30,0,36569,83,498,445,46,53
2025-07-09,1560,452,0,36569,290,3248,3086, ,2,31,0,36569,26,493,498,162,-5
2025-07-10,1560,340,12,36569,389,3187,3248, ,1,19,0,36569,6,480,493,-61,-13
2025-07-11,1560,313,0,36569,556,2944,3187, ,5,127,6,36569,7,354,480,-243,-126
2025-07-14,1560,94,0,36633,264,2774,2944,X ,1,112,0,36633,7,249,354,-170,-105
2025-07-15,1560,143,0,36633,212,2705,2774,X ,0,220,0,36633,0,29,249,-69,-220
2025-07-16,1560,230,0,36633,194,2741,2705,X ,0,0,29,36633,0,0,29,36,-29
2025-07-17,1560,238,0,36633,243,2736,2741,X ,0,0,0,36633,0,0,0,-5,0
2025-07-18,1560,287,0,36633,346,2677,2736, ,0,0,0,36633,0,0,0,-59,0
2025-07-21,1560,129,0,36633,170,2636,2677, ,57,0,0,36633,82,82,0,-41,82
2025-07-22,1560,300,3,36633,425,2508,2636, ,109,18,0,36633,26,90,82,-128,8
2025-07-23,1560,153,0,36633,54,2607,2508, ,1,8,0,36633,6,88,90,99,-2
2025-07-24,1560,147,0,36633,80,2674,2607, ,1,7,0,36633,7,88,88,67,0
2025-07-25,1560,96,0,36633,171,2599,2674, ,0,17,0,36633,61,132,88,-75,44
2025-07-28,1560,128,0,36633,131,2596,2599, ,2,3,0,36633,17,146,132,-3,14
2025-07-29,1560,106,0,36633,83,2619,2596, ,0,14,25,36633,8,115,146,23,-31
2025-07-30,1560,111,1,36633,75,2654,2619, ,0,0,0,36633,9,124,115,35,9
2025-07-31,1560,381,1,36633,312,2722,2654, ,1,35,0,36633,21,110,124,68,-14
2025-08-01,1560,382,7,36633,211,2886,2722, ,5,21,0,36633,40,129,110,164,19
2025-08-04,1560,437,1,36633,123,3199,2886, ,0,39,0,36633,8,98,129,313,-31
2025-08-05,1560,258,1,36633,111,3345,3199, ,1,14,0,36633,17,101,98,146,3
2025-08-06,1560,180,1,36633,349,3175,3345, ,0,18,0,36633,13,96,101,-170,-5
2025-08-07,1560,268,3,36633,149,3291,3175, ,4,12,0,36633,6,90,96,116,-6
2025-08-08,1560,204,0,36633,100,3395,3291, ,1,4,0,36633,4,90,90,104,0
2025-08-11,1560,199,0,36633,226,3368,3395, ,0,7,0,36633,9,92,90,-27,2
2025-08-12,1560,203,1,36633,38,3532,3368, ,2,11,0,36633,12,93,92,164,1
2025-08-13,1560,87,0,36633,117,3502,3532, ,0,17,0,36633,3,79,93,-30,-14
2025-08-14,1560,77,2,36681,133,3444,3502, ,0,2,0,36681,3,80,79,-58,1
2025-08-15,1560,114,0,36681,76,3482,3444, ,0,9,0,36681,3,74,80,38,-6
2025-08-18,1560,52,0,36681,114,3420,3482, ,0,3,0,36681,2,73,74,-62,-1
2025-08-19,1560,747,1,36681,287,3879,3420, ,7,2,0,36681,4,75,73,459,2
2025-08-20,1560,275,0,36681,269,3885,3879, ,1,2,0,36681,8,81,75,6,6
2025-08-21,1560,498,0,36681,762,3621,3885, ,11,5,0,36681,36,112,81,-264,31
2025-08-22,1560,537,0,36681,274,3884,3621, ,2,5,0,36681,3,110,112,263,-2
2025-08-25,1560,534,1,36681,442,3975,3884, ,0,8,0,36681,4,106,110,91,-4
2025-08-26,1560,240,0,36681,203,4012,3975, ,1,2,0,36681,7,111,106,37,5
2025-08-27,1560,387,2,36681,499,3898,4012, ,0,5,0,36681,12,118,111,-114,7
2025-08-28,1560,448,0,36681,549,3797,3898, ,4,4,0,36681,12,126,118,-101,8
2025-08-29,1560,244,0,36681,372,3669,3797, ,0,1,0,36681,6,131,126,-128,5
2025-09-01,1560,346,0,36681,410,3605,3669, ,3,8,0,36681,22,145,131,-64,14
2025-09-02,1560,379,1,36681,439,3544,3605, ,5,28,0,36681,65,182,145,-61,37
2025-09-03,1560,257,0,36681,110,3691,3544, ,0,7,0,36681,19,194,182,147,12
2025-09-04,1560,174,0,36681,231,3634,3691, ,0,4,0,36681,16,206,194,-57,12
2025-09-05,1560,160,2,36681,152,3640,3634, ,2,71,0,36681,6,141,206,6,-65
2025-09-08,1560,346,1,36681,214,3771,3640, ,1,4,0,36681,21,158,141,131,17
2025-09-09,1560,372,0,36681,324,3819,3771, ,1,23,0,36681,11,146,158,48,-12
2025-09-10,1560,112,0,36681,122,3809,3819, ,0,6,0,36681,24,164,146,-10,18
2025-09-11,1560,373,0,36681,184,3998,3809, ,2,44,0,36681,15,135,164,189,-29
2025-09-12,1560,113,0,36727,263,3848,3998, ,2,12,0,36727,18,141,135,-150,6
2025-09-15,1560,192,1,36727,188,3851,3848, ,4,11,0,36727,13,143,141,3,2
2025-09-16,1560,201,1,36727,214,3837,3851, ,3,34,0,36727,12,121,143,-14,-22
2025-09-17,1560,137,0,36727,50,3924,3837, ,0,10,0,36727,6,117,121,87,-4
2025-09-18,1560,45,0,36727,92,3877,3924, ,1,3,0,36727,21,135,117,-47,18
2025-09-19,1560,690,1,36727,582,3984,3877, ,4,11,0,36727,14,138,135,107,3
2025-09-22,1560,141,1,36727,280,3844,3984, ,1,7,0,36727,0,131,138,-140,-7
2025-09-23,1560,691,0,36727,531,4004,3844, ,4,1,0,36727,18,148,131,160,17
2025-06-25,1603,93,0,47922,58,3019,2984, ,0,1,0,47922,0,8,9,35,-1
2025-06-26,1603,17,0,47922,29,3007,3019, ,0,0,0,47922,1,9,8,-12,1
2025-06-27,1603,20,0,47922,168,2859,3007, ,0,0,0,47922,0,9,9,-148,0
2025-06-30,1603,21,0,47922,13,2867,2859, ,0,2,0,47922,0,7,9,8,-2
2025-07-01,1603,20,0,47922,10,2877,2867, ,0,1,0,47922,2,8,7,10,1
2025-07-02,1603,3,0,47922,7,2873,2877, ,0,2,0,47922,0,6,8,-4,-2
2025-07-03,1603,0,0,47922,7,2866,2873, ,0,0,0,47922,1,7,6,-7,1
2025-07-04,1603,28,0,47922,25,2869,2866, ,0,2,0,47922,0,5,7,3,-2
2025-07-07,1603,13,1,47922,14,2867,2869, ,0,1,0,47922,0,4,5,-2,-1
2025-07-08,1603,18,0,47922,43,2842,2867, ,0,1,0,47922,0,3,4,-25,-1
2025-07-09,1603,39,0,47922,17,2864,2842, ,0,0,0,47922,0,3,3,22,0
2025-07-10,1603,15,0,47922,10,2869,2864, ,0,0,0,47922,3,6,3,5,3
2025-07-11,1603,119,0,47922,40,2948,2869, ,0,3,0,47922,0,3,6,79,-3
2025-07-14,1603,4,0,47922,2,2950,2948, ,0,0,0,47922,0,3,3,2,0
2025-07-15,1603,3,6,47922,11,2936,2950, ,0,0,0,47922,0,3,3,-14,0
2025-07-16,1603,7,0,47922,8,2935,2936, ,0,0,0,47922,12,15,3,-1,12
2025-07-17,1603,2,0,47922,47,2890,2935, ,0,0,0,47922,6,21,15,-45,6
2025-07-18,1603,72,0,47922,30,2932,2890, ,0,18,0,47922,0,3,21,42,-18
2025-07-21,1603,10,4,47922,30,2908,2932, ,0,0,0,47922,0,3,3,-24,0
2025-07-22,1603,22,0,47922,154,2776,2908, ,0,0,0,47922,0,3,3,-132,0
2025-07-23,1603,25,0,47922,64,2737,2776, ,0,0,0,47922,0,3,3,-39,0
2025-07-24,1603,2,0,47922,7,2732,2737, ,0,0,0,47922,0,3,3,-5,0
2025-07-25,1603,6,0,47922,43,2695,2732, ,0,0,0,47922,0,3,3,-37,0
2025-07-28,1603,5,0,47922,0,2700,2695, ,0,0,0,47922,0,3,3,5,0
2025-07-29,1603,3,36,47922,12,2655,2700, ,0,0,0,47922,0,3,3,-45,0
2025-07-30,1603,53,0,47922,23,2685,2655, ,0,0,0,47922,0,3,3,30,0
2025-07-31,1603,35,0,47922,33,2687,2685, ,0,0,0,47922,0,3,3,2,0
2025-08-01,1603,44,6,47922,8,2717,2687, ,0,0,2,47922,0,1,3,30,-2
2025-08-04,1603,64,16,47922,21,2744,2717, ,0,0,0,47922,0,1,1,27,0
2025-08-05,1603,5,0,47922,105,2644,2744, ,0,0,0,47922,0,1,1,-100,0
2025-08-06,1603,21,0,47922,104,2561,2644, ,0,0,0,47922,0,1,1,-83,0
2025-08-07,1603,23,0,47922,21,2563,2561, ,0,0,0,47922,0,1,1,2,0
2025-08-08,1603,11,0,47922,27,2547,2563, ,0,0,0,47922,0,1,1,-16,0
2025-08-11,1603,21,0,47922,44,2524,2547, ,0,0,0,47922,0,1,1,-23,0
2025-08-12,1603,4,2,47922,56,2470,2524, ,0,0,0,47922,0,1,1,-54,0
2025-08-13,1603,93,0,47922,151,2412,2470, ,0,0,0,47922,0,1,1,-58,0
2025-08-14,1603,57,0,47922,81,2388,2412, ,0,0,0,47922,0,1,1,-24,0
2025-08-15,1603,61,1,47922,69,2379,2388, ,0,0,0,47922,0,1,1,-9,0
2025-08-18,1603,41,0,47922,71,2349,2379, ,0,0,0,47922,1,2,1,-30,1
2025-08-19,1603,8,0,47922,18,2339,2349, ,0,1,0,47922,0,1,2,-10,-1
2025-08-20,1603,17,1,47922,19,2336,2339, ,1,0,0,47922,0,1,1,-3,0
2025-08-21,1603,10,0,47922,30,2316,2336,X ,2,0,0,47922,0,1,1,-20,0
2025-08-22,1603,35,0,47922,8,2343,2316,X ,0,1,0,47922,0,0,1,27,-1
2025-08-25,1603,42,0,47922,8,2377,2343,X ,0,0,0,47922,0,0,0,34,0
2025-08-26,1603,19,0,47922,47,2349,2377,X ,0,0,0,47922,0,0,0,-28,0
2025-08-27,1603,10,0,47922,30,2329,2349, ,0,0,0,47922,0,0,0,-20,0
2025-08-28,1603,27,0,47922,39,2317,2329, ,0,0,0,47922,0,0,0,-12,0
2025-08-29,1603,8,0,47922,8,2317,2317, ,0,0,0,47922,0,0,0,0,0
2025-09-01,1603,27,0,47922,54,2290,2317, ,0,0,0,47922,1,1,0,-27,1
2025-09-02,1603,2,0,47922,6,2286,2290, ,0,1,0,47922,0,0,1,-4,-1
2025-09-03,1603,13,0,47922,11,2288,2286, ,0,0,0,47922,0,0,0,2,0
2025-09-04,1603,11,0,47922,32,2267,2288, ,0,0,0,47922,3,3,0,-21,3
2025-09-05,1603,7,0,47922,9,2265,2267, ,0,2,0,47922,0,1,3,-2,-2
2025-09-08,1603,20,1,47922,1,2283,2265, ,0,0,0,47922,0,1,1,18,0
2025-09-09,1603,28,1,47922,15,2295,2283, ,2,0,0,47922,0,1,1,12,0
2025-09-10,1603,53,0,47922,33,2315,2295, ,1,1,0,47922,2,2,1,20,1
2025-09-11,1603,283,0,47922,121,2477,2315, ,0,0,0,47922,1,3,2,162,1
2025-09-12,1603,39,0,47922,83,2433,2477, ,1,0,0,47922,0,3,3,-44,0
2025-09-15,1603,143,0,47922,79,2497,2433, ,0,0,0,47922,0,3,3,64,0
2025-09-16,1603,138,0,47922,84,2551,2497, ,0,0,0,47922,0,3,3,54,0
2025-09-17,1603,13,10,47922,20,2534,2551, ,0,1,0,47922,0,2,3,-17,-1
2025-09-18,1603,22,0,47922,77,2479,2534, ,0,0,0,47922,0,2,2,-55,0
2025-09-19,1603,8,1,47922,23,2463,2479, ,0,0,0,47922,0,2,2,-16,0
2025-09-22,1603,48,11,47922,2,2498,2463, ,0,0,0,47922,0,2,2,35,0
2025-09-23,1603,45,0,47922,29,2514,2498, ,0,0,0,47922,0,2,2,16,0
2025-06-25,1605,490,4,1007833,642,30837,30993, ,5,49,502,1007833,501,7982,8032,-156,-50
2025-06-26,1605,376,2,1107833,717,30494,30837, ,2,20,0,1107833,1345,9307,7982,-343,1325
2025-06-27,1605,1851,1,1107833,1096,31248,30494, ,56,4837,2703,1107833,117,1884,9307,754,-7423
2025-06-30,1605,1132,7,1107833,471,31902,31248, ,11,557,197,1107833,45,1175,1884,654,-709
2025-07-01,1605,429,7,1107833,514,31810,31902, ,1,196,87,1107833,108,1000,1175,-92,-175
2025-07-02,1605,613,7,1107833,198,32218,31810, ,1,281,67,1107833,26,678,1000,408,-322
2025-07-03,1605,136,25,1107833,328,32001,32218, ,2,40,17,1107833,58,679,678,-217,1
2025-07-04,1605,535,40,1107833,510,31986,32001, ,5,147,33,1107833,19,518,679,-15,-161
2025-07-07,1605,219,37,1107833,165,32003,31986, ,7,51,6,1107833,44,505,518,17,-13
2025-07-08,1605,763,12,1107833,352,32402,32003, ,3,180,18,1107833,134,441,505,399,-64
2025-07-09,1605,1973,23,1107833,159,34193,32402, ,19,57,17,1107833,7,374,441,1791,-67
2025-07-10,1605,906,14,1107833,312,34773,34193, ,7,25,19,1107833,49,379,374,580,5
2025-07-11,1605,274,4,1107833,667,34376,34773, ,26,10,3,1107833,45,411,379,-397,32
2025-07-14,1605,493,3,1107833,419,34447,34376, ,1,54,0,1107833,43,400,411,71,-11
2025-07-15,1605,723,32,1107833,345,34793,34447, ,0,58,1,1107833,7,348,400,346,-52
2025-07-16,1605,409,6,1107833,136,35060,34793, ,2,77,0,1107833,3,274,348,267,-74
2025-07-17,1605,260,9,1107833,989,34322,35060, ,5,35,0,1107833,109,348,274,-738,74
2025-07-18,1605,699,11,1107833,882,34128,34322, ,3,1,1,1107833,41,387,348,-194,39
2025-07-21,1605,820,5,1107833,1387,33556,34128, ,22,31,0,1107833,245,601,387,-572,214
2025-07-22,1605,881,36,1107833,1088,33311,33554, ,16,219,0,1107833,13,395,601,-243,-206
2025-07-23,1605,257,70,1107833,1282,32216,33311, ,5,1,0,1107833,175,569,395,-1095,174
2025-07-24,1605,512,12,1107833,413,32303,32216, ,10,63,0,1107833,25,531,569,87,-38
2025-07-25,1605,467,3,1107833,264,32503,32303, ,0,109,0,1107833,23,445,531,200,-86
2025-07-28,1605,430,55,1107833,199,32679,32503, ,4,4,30,1107833,44,455,445,176,10
2025-07-29,1605,298,3,1107833,235,32739,32679, ,3,70,0,1107833,19,404,455,60,-51
2025-07-30,1605,6392,11,1107833,3362,35758,32739, ,34,60,0,1107833,440,784,404,3019,380
2025-07-31,1605,8514,12,1107833,6176,38084,35758, ,151,152,0,1107833,149,781,784,2326,-3
2025-08-01,1605,2926,12,1107833,3331,37667,38084, ,139,262,2,1107833,89,606,781,-417,-175
2025-08-04,1605,984,5,1107833,1172,37474,37667, ,43,141,0,1107833,87,552,606,-193,-54
2025-08-05,1605,672,0,1107833,1276,36870,37474, ,1,41,1,1107833,45,555,552,-604,3
2025-08-06,1605,394,4,1107833,941,36319,36870, ,1,36,0,1107833,46,565,555,-551,10
2025-08-07,1605,572,5,1107833,1124,35762,36319, ,4,33,0,1107833,63,595,565,-557,30
2025-08-08,1605,674,5,1107833,708,35723,35762, ,43,40,0,1107833,21,576,595,-39,-19
2025-08-11,1605,693,1,1107833,774,35641,35723, ,25,50,0,1107833,36,562,576,-82,-14
2025-08-12,1605,434,18,1107833,605,35452,35641, ,1,0,0,1107833,18,580,562,-189,18
2025-08-13,1605,1295,9,1107833,1435,35303,35452, ,10,15,1,1107833,19,583,580,-149,3
2025-08-14,1605,1752,3,1107833,3616,33436,35303, ,60,17,0,1107833,309,875,583,-1867,292
2025-08-15,1605,1474,4,1107833,1149,33757,33436, ,25,120,0,1107833,81,836,875,321,-39
2025-08-18,1605,2023,9,1107833,2912,32859,33757, ,9,40,0,1107833,166,962,836,-898,126
2025-08-19,1605,2287,2,1107833,1171,33973,32859, ,6,46,1,1107833,17,932,962,1114,-30
2025-08-20,1605,982,39,1107833,773,34143,33973, ,12,206,0,1107833,24,750,932,170,-182
2025-08-21,1605,459,5,1107833,469,34128,34143, ,2,9,0,1107833,20,761,750,-15,11
2025-08-22,1605,884,5,1107833,454,34553,34128, ,5,45,0,1107833,12,728,761,425,-33
2025-08-25,1605,1113,3,1107833,1862,33801,34553, ,11,8,1,1107833,33,752,728,-752,24
2025-08-26,1605,876,4,1107833,668,34005,33801, ,3,50,0,1107833,4,706,752,204,-46
2025-08-27,1605,747,105,1107833,858,33789,34005, ,2,7,0,1107833,6,705,706,-216,-1
2025-08-28,1605,1083,5,1107833,1092,33775,33789, ,2,5,0,1107833,24,724,705,-14,19
2025-08-29,1605,2193,109,1107833,1037,34822,33775, ,0,43,0,1107833,0,681,724,1047,-43
2025-09-01,1605,827,11,1107833,850,34788,34822, ,13,71,0,1107833,18,628,681,-34,-53
2025-09-02,1605,407,5,1107833,651,34539,34788, ,8,47,0,1107833,14,595,628,-249,-33
2025-09-03,1605,844,1,1107833,203,35179,34539, ,3,61,0,1107833,1,535,595,640,-60
2025-09-04,1605,5842,5,1107833,2928,38088,35179, ,108,3,0,1107833,218,750,535,2909,215
2025-09-05,1605,3239,101,1107833,4177,37049,38088, ,31,112,0,1107833,54,692,750,-1039,-58
2025-09-08,1605,2660,6,1107833,1421,38282,37049, ,8,104,0,1107833,6,594,692,1233,-98
2025-09-09,1605,745,21,1107833,1171,37835,38282, ,5,9,0,1107833,12,597,594,-447,3
2025-09-10,1605,1154,11,1107833,2880,36098,37835, ,12,5,0,1107833,128,720,597,-1737,123
2025-09-11,1605,1625,0,1107833,786,36937,36098, ,21,111,0,1107833,0,609,720,839,-111
2025-09-12,1605,726,10,1107833,1289,36364,36937, ,5,1,0,1107833,3,611,609,-573,2
2025-09-15,1605,1188,10,1107833,601,36941,36364, ,3,5,0,1107833,1,607,611,577,-4
2025-09-16,1605,276,53,1107833,520,36644,36941, ,1,1,1,1107833,2,607,607,-297,0
2025-09-17,1605,2494,7,1107833,811,38320,36644, ,4,0,0,1107833,15,622,607,1676,15
2025-09-18,1605,2855,4,1107833,2053,39118,38320, ,17,14,0,1107833,46,654,622,798,32
2025-09-19,1605,1894,106,1107833,3786,37120,39118, ,35,6,0,1107833,118,766,654,-1998,112
2025-09-22,1605,3701,103,1107833,2642,38076,37120, ,38,24,0,1107833,62,804,766,956,38
2025-09-23,1605,2611,4,1107833,1742,38941,38076, ,80,51,0,1107833,109,862,804,865,58
2025-06-25,1721,8,0,41428,4,4226,4222, ,2,8,0,41428,1,23,30,4,-7
2025-06-26,1721,46,0,41428,17,4255,4226, ,0,0,0,41428,7,30,23,29,7
2025-06-27,1721,19,0,41428,33,4241,4255, ,2,0,0,41428,21,51,30,-14,21
2025-06-30,1721,109,0,41428,28,4322,4241, ,2,35,0,41428,0,16,51,81,-35
2025-07-01,1721,4,0,41428,9,4317,4322, ,0,0,0,41428,2,18,16,-5,2
2025-07-02,1721,23,0,41428,10,4330,4317, ,0,0,0,41428,0,18,18,13,0
2025-07-03,1721,13,0,41428,26,4317,4330, ,0,0,0,41428,10,28,18,-13,10
2025-07-04,1721,534,0,41428,79,4772,4317, ,26,0,0,41428,53,81,28,455,53
2025-07-07,1721,225,0,41428,298,4699,4772, ,43,10,0,41428,43,114,81,-73,33
2025-07-08,1721,90,0,41428,92,4697,4699, ,1,32,0,41428,13,95,114,-2,-19
2025-07-09,1721,121,0,41428,112,4706,4697, ,2,35,0,41428,4,64,95,9,-31
2025-07-10,1721,28,0,41428,106,4628,4706, ,7,8,0,41428,2,58,64,-78,-6
2025-07-11,1721,44,0,41428,90,4582,4628, ,5,2,0,41428,24,80,58,-46,22
2025-07-14,1721,30,0,41428,16,4596,4582, ,1,32,0,41428,4,52,80,14,-28
2025-07-15,1721,14,0,41428,11,4599,4596, ,2,2,0,41428,0,50,52,3,-2
2025-07-16,1721,230,0,41428,221,4608,4599, ,17,1,0,41428,10,59,50,9,9
2025-07-17,1721,105,0,41428,60,4653,4608, ,1,0,0,41428,24,83,59,45,24
2025-07-18,1721,271,0,41428,174,4750,4653, ,5,8,0,41428,12,87,83,97,4
2025-07-21,1721,34,20,41428,216,4548,4750, ,1,5,0,41428,11,93,87,-202,6
2025-07-22,1721,71,0,41428,74,4545,4548, ,3,5,0,41428,2,90,93,-3,-3
2025-07-23,1721,121,0,41428,123,4543,4545, ,1,0,0,41428,19,109,90,-2,19
2025-07-24,1721,103,1,41428,128,4517,4543, ,4,0,0,41428,5,114,109,-26,5
2025-07-25,1721,57,0,41428,73,4501,4517, ,0,0,0,41428,4,118,114,-16,4
2025-07-28,1721,888,0,41428,131,5258,4501, ,11,13,0,41428,45,150,118,757,32
2025-07-29,1721,386,0,41428,241,5403,5258, ,2,20,0,41428,23,153,150,145,3
2025-07-30,1721,71,0,41428,203,5271,5403, ,0,8,0,41428,20,165,153,-132,12
2025-07-31,1721,81,0,41428,156,5196,5271, ,3,12,0,41428,0,153,165,-75,-12
2025-08-01,1721,34,0,41428,107,5123,5196, ,1,29,0,41428,6,130,153,-73,-23
2025-08-04,1721,15,1,41428,84,5053,5123, ,1,50,0,41428,3,83,130,-70,-47
2025-08-05,1721,16,0,41428,40,5029,5053, ,0,15,0,41428,7,75,83,-24,-8
2025-08-06,1721,58,0,41428,90,4997,5029, ,2,0,0,41428,13,88,75,-32,13
2025-08-07,1721,35,6,41428,42,4984,4997, ,0,16,0,41428,4,76,88,-13,-12
2025-08-08,1721,66,0,41428,81,4969,4984, ,0,8,0,41428,1,69,76,-15,-7
2025-08-11,1721,75,520,41428,164,4360,4969, ,0,2,0,41428,11,78,69,-609,9
2025-08-12,1721,600,0,41428,535,4425,4360, ,7,0,0,41428,18,96,78,65,18
2025-08-13,1721,274,0,41428,407,4292,4425, ,7,1,0,41428,3,98,96,-133,2
2025-08-14,1721,58,6,41428,90,4254,4292, ,0,8,0,41428,0,90,98,-38,-8
2025-08-15,1721,240,6,41428,252,4236,4254, ,0,0,0,41428,4,94,90,-18,4
2025-08-18,1721,588,4,41428,221,4599,4236, ,11,0,0,41428,4,98,94,363,4
2025-08-19,1721,411,0,41428,475,4535,4599, ,10,1,0,41428,48,145,98,-64,47
2025-08-20,1721,690,1,41428,453,4771,4535, ,18,41,0,41428,5,109,145,236,-36
2025-08-21,1721,159,0,0,362,4568,4771,OX ,3,0,0,0,11,120,109,-203,11
2025-08-22,1721,0,0,0,341,4227,4568,OX ,0,7,0,0,0,113,120,-341,-7
2025-08-25,1721,0,0,0,101,4126,4227,OX ,0,5,0,0,0,108,113,-101,-5
2025-08-26,1721,0,1,0,105,4020,4126,OX ,0,15,0,0,0,93,108,-106,-15
2025-08-27,1721,0,0,0,68,3952,4020,OX ,0,0,0,0,0,93,93,-68,0
2025-08-28,1721,0,0,0,37,3915,3952,OX ,0,3,0,0,0,90,93,-37,-3
2025-08-29,1721,0,1,0,15,3899,3915,OX ,0,0,0,0,0,90,90,-16,0
2025-09-01,1721,0,0,0,41,3858,3899,OX ,0,0,0,0,0,90,90,-41,0
2025-09-02,1721,0,0,0,393,3465,3858,OX ,0,6,0,0,0,84,90,-393,-6
2025-09-03,1721,0,8,0,4,3453,3465,OX ,0,2,0,0,0,82,84,-12,-2
2025-09-04,1721,0,0,0,7,3446,3453,OX ,0,1,0,0,0,81,82,-7,-1
2025-09-05,1721,0,3,0,4,3439,3446,OX ,0,0,0,0,0,81,81,-7,0
2025-09-08,1721,0,0,0,89,3350,3439,OX ,0,0,0,0,0,81,81,-89,0
2025-09-09,1721,0,5,0,33,3312,3350,OX ,0,0,0,0,0,81,81,-38,0
2025-09-10,1721,0,0,0,64,3248,3312,OX ,0,0,0,0,0,81,81,-64,0
2025-09-11,1721,0,1,0,8,3239,3248,OX ,0,0,0,0,0,81,81,-9,0
2025-09-12,1721,0,4,0,11,3224,3239,OX ,0,0,0,0,0,81,81,-15,0
2025-09-15,1721,0,1,0,1,3222,3224,OX ,0,0,0,0,0,81,81,-2,0
2025-09-16,1721,0,0,0,33,3189,3222,OX ,0,0,0,0,0,81,81,-33,0
2025-09-17,1721,0,0,0,15,3174,3189,OX ,0,0,0,0,0,81,81,-15,0
2025-09-18,1721,0,0,0,2,3172,3174,OX ,0,0,0,0,0,81,81,-2,0
2025-09-19,1721,0,0,0,0,3172,3172,OX ,0,0,0,0,0,81,81,0,0
2025-09-22,1721,0,10,0,0,3162,3172,OX ,0,0,0,0,0,81,81,-10,0
2025-09-23,1721,0,4,0,5,3153,3162,OX ,0,0,0,0,0,81,81,-9,0
2025-06-25,2023,0,1,487999,47,2681,2729, ,0,1,0,487999,1,7,7,-48,0
2025-06-26,2023,35,0,487999,45,2671,2681, ,0,0,0,487999,0,7,7,-10,0
2025-06-27,2023,15,8,487999,37,2641,2671, ,0,0,0,487999,0,7,7,-30,0
2025-06-30,2023,17,1,487999,16,2641,2641, ,0,0,0,487999,0,7,7,0,0
2025-07-01,2023,58,0,487999,325,2374,2641, ,0,0,0,487999,0,7,7,-267,0
2025-07-02,2023,51,1,487999,6,2418,2374, ,0,0,0,487999,0,7,7,44,0
2025-07-03,2023,140,0,487999,19,2539,2418, ,0,0,0,487999,1,8,7,121,1
2025-07-04,2023,0,1,487999,55,2483,2539, ,0,0,0,487999,1,9,8,-56,1
2025-07-07,2023,121,1,487999,62,2541,2483, ,1,0,0,487999,1,10,9,58,1
2025-07-08,2023,2,2,487999,9,2532,2541, ,0,0,0,487999,3,13,10,-9,3
2025-07-09,2023,61,0,487999,251,2342,2532, ,0,1,0,487999,0,12,13,-190,-1
2025-07-10,2023,30,0,487999,78,2294,2342, ,0,1,0,487999,0,11,12,-48,-1
2025-07-11,2023,15,4,487999,15,2290,2294, ,0,1,0,487999,0,10,11,-4,-1
2025-07-14,2023,4,0,487999,6,2288,2290, ,0,2,0,487999,0,8,10,-2,-2
2025-07-15,2023,16,0,487999,6,2298,2288, ,0,0,0,487999,6,14,8,10,6
2025-07-16,2023,31,0,487999,68,2261,2298, ,0,2,0,487999,13,25,14,-37,11
2025-07-17,2023,80,0,487999,36,2305,2261, ,0,0,0,487999,0,25,25,44,0
2025-07-18,2023,197,0,487999,28,2474,2305, ,8,11,0,487999,0,14,25,169,-11
2025-07-21,2023,36,0,487999,60,2450,2474, ,0,3,0,487999,0,11,14,-24,-3
2025-07-22,2023,43,0,487999,12,2481,2450, ,0,0,0,487999,0,11,11,31,0
2025-07-23,2023,153,0,487999,40,2594,2481, ,0,0,0,487999,0,11,11,113,0
2025-07-24,2023,6,1,487999,47,2552,2594, ,0,0,0,487999,0,11,11,-42,0
2025-07-25,2023,73,0,487999,3,2622,2552, ,0,0,0,487999,0,11,11,70,0
2025-07-28,2023,117,0,487999,14,2725,2622, ,0,0,0,487999,0,11,11,103,0
2025-07-29,2023,39,0,487999,2,2762,2725, ,0,0,0,487999,0,11,11,37,0
2025-07-30,2023,142,0,487999,11,2893,2762, ,0,4,0,487999,0,7,11,131,-4
2025-07-31,2023,13,0,487999,48,2858,2893, ,0,0,0,487999,0,7,7,-35,0
2025-08-01,2023,45,0,487999,86,2817,2858, ,0,0,0,487999,15,22,7,-41,15
2025-08-04,2023,16,0,487999,43,2790,2817, ,0,21,0,487999,0,1,22,-27,-21
2025-08-05,2023,7,0,487999,5,2792,2790, ,0,0,0,487999,0,1,1,2,0
2025-08-06,2023,27,0,487999,0,2819,2792, ,0,0,0,487999,0,1,1,27,0
2025-08-07,2023,35,0,487999,82,2772,2819, ,0,0,0,487999,14,15,1,-47,14
2025-08-08,2023,22,0,487999,7,2787,2772, ,1,0,0,487999,0,15,15,15,0
2025-08-11,2023,54,0,487999,92,2749,2787, ,0,14,0,487999,0,1,15,-38,-14
2025-08-12,2023,112,3,487999,20,2838,2749, ,0,0,0,487999,0,1,1,89,0
2025-08-13,2023,133,0,487999,152,2819,2838, ,0,0,0,487999,0,1,1,-19,0
2025-08-14,2023,130,6,487999,3,2940,2819, ,0,0,0,487999,5,6,1,121,5
2025-08-15,2023,61,9,487999,89,2903,2940, ,0,0,0,487999,13,19,6,-37,13
2025-08-18,2023,144,0,487999,62,2985,2903, ,0,18,0,487999,105,106,19,82,87
2025-08-19,2023,76,0,487999,106,2955,2985, ,0,0,0,487999,25,131,106,-30,25
2025-08-20,2023,11,34,487999,9,2923,2955, ,0,0,0,487999,0,131,131,-32,0
2025-08-21,2023,47,0,487999,80,2890,2923, ,0,0,0,487999,0,131,131,-33,0
2025-08-22,2023,5,0,487999,167,2728,2890, ,0,0,0,487999,0,131,131,-162,0
2025-08-25,2023,60,0,487999,3,2785,2728, ,0,0,0,487999,0,131,131,57,0
2025-08-26,2023,17,0,487999,40,2762,2785, ,0,0,0,487999,20,151,131,-23,20
2025-08-27,2023,20,0,487999,1,2781,2762, ,0,18,0,487999,0,133,151,19,-18
2025-08-28,2023,5,3,487999,55,2728,2781, ,0,1,0,487999,30,162,133,-53,29
2025-08-29,2023,5,0,487999,0,2733,2728, ,0,32,0,487999,0,130,162,5,-32
2025-09-01,2023,8,0,487999,28,2713,2733, ,0,0,0,487999,0,130,130,-20,0
2025-09-02,2023,19,0,487999,24,2708,2713, ,0,0,0,487999,0,130,130,-5,0
2025-09-03,2023,20,0,487999,114,2614,2708, ,0,0,0,487999,0,130,130,-94,0
2025-09-04,2023,20,0,481589,110,2524,2614, ,1,0,0,481589,0,130,130,-90,0
2025-09-05,2023,50,0,481589,26,2548,2524, ,0,0,0,481589,0,130,130,24,0
2025-09-08,2023,7,0,481589,161,2394,2548, ,0,100,0,481589,0,30,130,-154,-100
2025-09-09,2023,9,0,481589,5,2398,2394, ,0,30,0,481589,0,0,30,4,-30
2025-09-10,2023,9,0,481589,22,2385,2398, ,0,0,0,481589,0,0,0,-13,0
2025-09-11,2023,4,0,481589,34,2355,2385, ,0,0,0,481589,0,0,0,-30,0
2025-09-12,2023,13,0,481589,36,2332,2355, ,0,0,0,481589,0,0,0,-23,0
2025-09-15,2023,30,0,481589,17,2345,2332, ,0,0,0,481589,0,0,0,13,0
2025-09-16,2023,7,0,481589,26,2326,2345, ,0,0,0,481589,0,0,0,-19,0
2025-09-17,2023,22,0,481589,23,2325,2326, ,7,0,0,481589,0,0,0,-1,0
2025-09-18,2023,43,0,481589,11,2357,2325, ,0,0,0,481589,0,0,0,32,0
2025-09-19,2023,25,21,481589,32,2329,2357, ,3,0,0,481589,0,0,0,-28,0
2025-09-22,2023,13,0,481589,41,2301,2329, ,0,0,0,481589,0,0,0,-28,0
2025-09-23,2023,24,0,481589,12,2313,2301, ,10,0,0,481589,0,0,0,12,0
2025-06-25,2033,35,0,20173,7,7746,7718, ,0,0,0,20173,0,2,2,28,0
2025-06-26,2033,0,0,20173,4,7742,7746, ,0,0,0,20173,0,2,2,-4,0
2025-06-27,2033,0,0,20173,2,7740,7742, ,0,0,0,20173,0,2,2,-2,0
2025-06-30,2033,15,0,20173,2,7753,7740, ,0,0,0,20173,0,2,2,13,0
2025-07-01,2033,1,0,20173,4,7750,7753, ,0,0,0,20173,0,2,2,-3,0
2025-07-02,2033,6,0,20173,0,7756,7750, ,0,0,0,20173,0,2,2,6,0
2025-07-03,2033,8,0,20173,0,7764,7756, ,0,0,0,20173,0,2,2,8,0
2025-07-04,2033,11,0,20173,0,7775,7764, ,0,0,0,20173,0,2,2,11,0
2025-07-07,2033,15,0,20173,3,7787,7775, ,0,0,0,20173,1,3,2,12,1
2025-07-08,2033,7,0,20173,22,7772,7787, ,0,1,0,20173,0,2,3,-15,-1
2025-07-09,2033,20,0,20173,10,7782,7772, ,0,0,0,20173,0,2,2,10,0
2025-07-10,2033,0,0,20173,3,7779,7782, ,0,0,0,20173,0,2,2,-3,0
2025-07-11,2033,17,0,20173,1,7795,7779, ,0,0,0,20173,0,2,2,16,0
2025-07-14,2033,14,0,20173,1,7808,7795, ,0,0,0,20173,0,2,2,13,0
2025-07-15,2033,5,0,20173,4,7809,7808, ,0,0,0,20173,0,2,2,1,0
2025-07-16,2033,1,0,20173,0,7810,7809, ,0,0,0,20173,0,2,2,1,0
2025-07-17,2033,2,0,20173,0,7812,7810, ,0,0,0,20173,0,2,2,2,0
2025-07-18,2033,10,0,20173,6,7816,7812, ,0,0,0,20173,0,2,2,4,0
2025-07-21,2033,32,0,20173,9,7839,7816, ,0,0,0,20173,0,2,2,23,0
2025-07-22,2033,2,0,20173,15,7826,7839, ,0,0,0,20173,0,2,2,-13,0
2025-07-23,2033,8,0,20173,10,7824,7826, ,0,0,0,20173,0,2,2,-2,0
2025-07-24,2033,0,0,20173,6,7818,7824, ,0,0,0,20173,0,2,2,-6,0
2025-07-25,2033,17,0,20173,4,7831,7818, ,0,2,0,20173,0,0,2,13,-2
2025-07-28,2033,4,0,20173,0,7835,7831, ,0,0,0,20173,0,0,0,4,0
2025-07-29,2033,13,0,20173,0,7848,7835, ,0,0,0,20173,0,0,0,13,0
2025-07-30,2033,1,0,20173,1,7848,7848, ,0,0,0,20173,0,0,0,0,0
2025-07-31,2033,92,0,20173,8,7932,7848,X ,0,0,0,20173,0,0,0,84,0
2025-08-01,2033,46,0,20173,41,7937,7932,X ,0,0,0,20173,0,0,0,5,0
2025-08-04,2033,16,558,20173,5,7390,7937,X ,0,0,0,20173,0,0,0,-547,0
2025-08-05,2033,0,0,20173,5,7385,7390,X ,0,0,0,20173,0,0,0,-5,0
2025-08-06,2033,14,0,20173,23,7376,7385, ,0,0,0,20173,0,0,0,-9,0
2025-08-07,2033,5,0,20173,0,7381,7376, ,0,0,0,20173,0,0,0,5,0
2025-08-08,2033,7,0,20173,5,7383,7381, ,0,0,0,20173,0,0,0,2,0
2025-08-11,2033,0,0,20173,1,7382,7383, ,0,0,0,20173,0,0,0,-1,0
2025-08-12,2033,2,0,20173,1,7383,7382, ,0,0,0,20173,0,0,0,1,0
2025-08-13,2033,7,0,20173,0,7390,7383, ,0,0,0,20173,0,0,0,7,0
2025-08-14,2033,0,0,20173,0,7390,7390, ,0,0,0,20173,0,0,0,0,0
2025-08-15,2033,2,0,20173,0,7392,7390, ,0,0,0,20173,0,0,0,2,0
2025-08-18,2033,0,0,20173,10,7382,7392, ,0,0,0,20173,0,0,0,-10,0
2025-08-19,2033,33,0,20173,6,7409,7382, ,0,0,0,20173,0,0,0,27,0
2025-08-20,2033,5,1,20173,21,7392,7409, ,0,0,0,20173,0,0,0,-17,0
2025-08-21,2033,45,0,20173,24,7413,7392, ,0,0,0,20173,0,0,0,21,0
2025-08-22,2033,0,0,20173,3,7410,7413, ,0,0,0,20173,0,0,0,-3,0
2025-08-25,2033,0,0,20173,2,7408,7410, ,0,0,0,20173,0,0,0,-2,0
2025-08-26,2033,0,0,20173,1,7407,7408, ,0,0,0,20173,0,0,0,-1,0
2025-08-27,2033,1,0,20173,0,7408,7407, ,0,0,0,20173,0,0,0,1,0
2025-08-28,2033,4,0,20173,14,7398,7408, ,0,0,0,20173,0,0,0,-10,0
2025-08-29,2033,25,0,20173,7,7416,7398, ,0,0,0,20173,0,0,0,18,0
2025-09-01,2033,15,0,20173,18,7413,7416, ,0,0,0,20173,0,0,0,-3,0
2025-09-02,2033,0,0,20173,1,7412,7413, ,0,0,0,20173,0,0,0,-1,0
2025-09-03,2033,25,0,20173,1,7436,7412, ,0,0,0,20173,0,0,0,24,0
2025-09-04,2033,74,0,20173,27,7483,7436, ,0,0,0,20173,0,0,0,47,0
2025-09-05,2033,25,0,20173,11,7497,7483, ,0,0,0,20173,0,0,0,14,0
2025-09-08,2033,6,0,20173,2,7501,7497, ,0,0,0,20173,0,0,0,4,0
2025-09-09,2033,25,0,20173,0,7526,7501, ,0,0,0,20173,0,0,0,25,0
2025-09-10,2033,42,0,20173,0,7568,7526, ,0,0,0,20173,0,0,0,42,0
2025-09-11,2033,5,0,20173,12,7561,7568, ,0,0,0,20173,0,0,0,-7,0
2025-09-12,2033,36,0,20173,9,7588,7561, ,0,0,0,20173,0,0,0,27,0
2025-09-15,2033,12,0,20173,8,7592,7588, ,0,0,0,20173,0,0,0,4,0
2025-09-16,2033,1,0,20173,12,7581,7592, ,0,0,0,20173,0,0,0,-11,0
2025-09-17,2033,1,0,20173,0,7582,7581, ,0,0,0,20173,0,0,0,1,0
2025-09-18,2033,18,0,20173,4,7596,7582, ,0,0,0,20173,0,0,0,14,0
2025-09-19,2033,1,0,20173,0,7597,7596, ,0,0,0,20173,0,0,0,1,0
2025-09-22,2033,46,0,20173,0,7643,7597, ,0,0,0,20173,0,0,0,46,0
2025-09-23,2033,143,0,20173,83,7703,7643, ,1,0,0,20173,4,4,0,60,4
2025-06-25,2239,1,15,30086,5,1293,1312, ,0,0,0,30086,0,0,0,-19,0
2025-06-26,2239,7,0,30086,2,1298,1293, ,0,0,0,30086,0,0,0,5,0
2025-06-27,2239,3,0,30086,0,1301,1298, ,0,0,0,30086,0,0,0,3,0
2025-06-30,2239,4,0,30086,0,1305,1301, ,0,0,0,30086,0,0,0,4,0
2025-07-01,2239,2,0,30086,0,1307,1305, ,0,0,0,30086,0,0,0,2,0
2025-07-02,2239,8,0,30086,7,1308,1307, ,0,0,0,30086,0,0,0,1,0
2025-07-03,2239,6,0,30086,0,1314,1308, ,0,0,0,30086,0,0,0,6,0
2025-07-04,2239,13,0,30086,0,1327,1314, ,0,0,0,30086,0,0,0,13,0
2025-07-07,2239,1,0,30086,0,1328,1327, ,0,0,0,30086,0,0,0,1,0
2025-07-08,2239,18,6,30086,3,1337,1328, ,0,0,0,30086,0,0,0,9,0
2025-07-09,2239,2,0,30086,0,1339,1337, ,0,0,0,30086,0,0,0,2,0
2025-07-10,2239,2,0,30086,0,1341,1339, ,0,0,0,30086,0,0,0,2,0
2025-07-11,2239,14,0,30086,0,1355,1341, ,0,0,0,30086,0,0,0,14,0
2025-07-14,2239,3,0,30086,0,1358,1355, ,0,0,0,30086,0,0,0,3,0
2025-07-15,2239,30,0,30086,7,1381,1358, ,0,0,0,30086,0,0,0,23,0
2025-07-16,2239,31,0,30086,0,1412,1381, ,0,0,0,30086,0,0,0,31,0
2025-07-17,2239,39,0,30086,2,1449,1412, ,0,0,0,30086,0,0,0,37,0
2025-07-18,2239,71,0,30086,8,1512,1449, ,0,0,0,30086,0,0,0,63,0
2025-07-21,2239,74,0,30086,18,1568,1512, ,0,0,0,30086,1,1,0,56,1
2025-07-22,2239,69,8,30086,46,1583,1568, ,0,1,0,30086,0,0,1,15,-1
2025-07-23,2239,56,2,30086,2,1635,1583, ,0,0,0,30086,0,0,0,52,0
2025-07-24,2239,36,16,30086,13,1642,1635, ,0,0,0,30086,0,0,0,7,0
2025-07-25,2239,26,0,30086,9,1659,1642, ,0,0,0,30086,0,0,0,17,0
2025-07-28,2239,21,0,30086,0,1680,1659, ,0,0,0,30086,0,0,0,21,0
2025-07-29,2239,0,0,30086,7,1673,1680, ,0,0,0,30086,0,0,0,-7,0
2025-07-30,2239,7,0,30086,0,1680,1673, ,0,0,0,30086,0,0,0,7,0
2025-07-31,2239,1,0,30086,0,1681,1680, ,0,0,0,30086,0,0,0,1,0
2025-08-01,2239,18,0,30086,1,1698,1681, ,0,0,0,30086,0,0,0,17,0
2025-08-04,2239,36,0,30086,34,1700,1698, ,0,0,0,30086,0,0,0,2,0
2025-08-05,2239,5,0,30086,10,1695,1700, ,0,0,0,30086,0,0,0,-5,0
2025-08-06,2239,11,19,30086,0,1687,1695, ,0,0,0,30086,0,0,0,-8,0
2025-08-07,2239,24,14,30086,1,1696,1687, ,0,0,0,30086,0,0,0,9,0
2025-08-08,2239,2,0,30086,0,1698,1696, ,0,0,0,30086,0,0,0,2,0
2025-08-11,2239,1,1,30086,0,1698,1698, ,0,0,0,30086,0,0,0,0,0
2025-08-12,2239,0,0,30086,1,1697,1698, ,0,0,0,30086,0,0,0,-1,0
2025-08-13,2239,3,1,30086,2,1697,1697, ,0,0,0,30086,0,0,0,0,0
2025-08-14,2239,2,0,30086,0,1699,1697, ,0,0,0,30086,0,0,0,2,0
2025-08-15,2239,12,0,30086,0,1711,1699, ,0,0,0,30086,0,0,0,12,0
2025-08-18,2239,2,10,30086,0,1703,1711, ,0,0,0,30086,0,0,0,-8,0
2025-08-19,2239,2,0,30086,0,1705,1703, ,0,0,0,30086,0,0,0,2,0
2025-08-20,2239,5,0,30086,0,1710,1705, ,0,0,0,30086,0,0,0,5,0
2025-08-21,2239,3,0,30086,2,1711,1710, ,0,0,0,30086,0,0,0,1,0
2025-08-22,2239,3,0,30086,1,1713,1711, ,0,0,0,30086,0,0,0,2,0
2025-08-25,2239,33,0,30086,30,1716,1713, ,0,0,0,30086,0,0,0,3,0
2025-08-26,2239,42,3,30086,20,1735,1716, ,0,0,0,30086,0,0,0,19,0
2025-08-27,2239,4,0,30086,0,1739,1735, ,0,0,0,30086,0,0,0,4,0
2025-08-28,2239,2,15,30086,0,1726,1739, ,0,0,0,30086,0,0,0,-13,0
2025-08-29,2239,77,0,30086,23,1780,1726, ,0,0,0,30086,0,0,0,54,0
2025-09-01,2239,36,0,30086,16,1800,1780, ,0,0,0,30086,0,0,0,20,0
2025-09-02,2239,86,21,30086,24,1841,1800, ,0,0,0,30086,0,0,0,41,0
2025-09-03,2239,85,0,30086,5,1921,1841, ,1,0,0,30086,0,0,0,80,0
2025-09-04,2239,28,0,30086,2,1947,1921, ,0,0,0,30086,0,0,0,26,0
2025-09-05,2239,273,0,30086,14,2206,1947, ,0,0,0,30086,0,0,0,259,0
2025-09-08,2239,77,0,30086,26,2257,2206, ,0,0,0,30086,0,0,0,51,0
2025-09-09,2239,15,0,30086,6,2266,2257, ,0,0,0,30086,0,0,0,9,0
2025-09-10,2239,10,0,30086,11,2265,2266, ,0,0,0,30086,0,0,0,-1,0
2025-09-11,2239,39,0,30086,30,2274,2265, ,0,0,0,30086,0,0,0,9,0
2025-09-12,2239,2,0,30086,0,2276,2274, ,0,0,0,30086,0,0,0,2,0
2025-09-15,2239,15,0,30086,4,2287,2276, ,0,0,0,30086,0,0,0,11,0
2025-09-16,2239,22,0,30086,6,2303,2287, ,0,0,0,30086,0,0,0,16,0
2025-09-17,2239,35,0,30086,0,2338,2303, ,0,0,0,30086,0,0,0,35,0
2025-09-18,2239,42,0,30086,4,2376,2338, ,0,0,0,30086,0,0,0,38,0
2025-09-19,2239,197,0,30086,152,2421,2376, ,0,0,0,30086,0,0,0,45,0
2025-09-22,2239,375,0,30086,342,2454,2421, ,0,0,0,30086,8,8,0,33,8
2025-09-23,2239,257,0,30086,163,2548,2454, ,0,8,0,30086,0,0,8,94,-8
2025-06-25,2241,31,1,26150,7,4909,4886, ,0,0,0,26150,0,8,8,23,0
2025-06-26,2241,235,0,26150,40,5104,4909, ,0,0,0,26150,17,25,8,195,17
2025-06-27,2241,128,4,26150,275,4953,5104, ,0,15,0,26150,10,20,25,-151,-5
2025-06-30,2241,13,0,26150,13,4953,4953, ,0,7,0,26150,1,14,20,0,-6
2025-07-01,2241,173,1,26150,14,5111,4953, ,1,1,0,26150,12,25,14,158,11
2025-07-02,2241,16,0,26150,7,5120,5111, ,0,0,0,26150,1,26,25,9,1
2025-07-03,2241,9,0,26150,12,5117,5120, ,0,4,0,26150,0,22,26,-3,-4
2025-07-04,2241,16,0,26150,25,5108,5117, ,0,3,0,26150,6,25,22,-9,3
2025-07-07,2241,19,0,26150,213,4914,5108, ,0,3,0,26150,2,24,25,-194,-1
2025-07-08,2241,0,0,26150,34,4880,4914, ,0,0,0,26150,1,25,24,-34,1
2025-07-09,2241,2,0,26150,2,4880,4880, ,0,1,0,26150,0,24,25,0,-1
2025-07-10,2241,12,0,26150,11,4881,4880, ,0,0,0,26150,3,27,24,1,3
2025-07-11,2241,5,4,26150,1,4881,4881, ,0,5,0,26150,0,22,27,0,-5
2025-07-14,2241,0,94,26150,59,4728,4881, ,0,0,0,26150,0,22,22,-153,0
2025-07-15,2241,4,1,26150,101,4630,4728, ,0,0,0,26150,0,22,22,-98,0
2025-07-16,2241,0,0,26150,25,4605,4630, ,0,0,0,26150,0,22,22,-25,0
2025-07-17,2241,5,15,26150,0,4595,4605, ,0,0,0,26150,0,22,22,-10,0
2025-07-18,2241,9,0,26150,0,4604,4595, ,0,0,0,26150,0,22,22,9,0
2025-07-21,2241,3,108,26150,0,4499,4604, ,0,0,0,26150,0,22,22,-105,0
2025-07-22,2241,3,0,26150,6,4496,4499, ,0,0,0,26150,0,22,22,-3,0
2025-07-23,2241,2,0,26150,7,4491,4496, ,0,0,0,26150,2,24,22,-5,2
2025-07-24,2241,5,0,26150,0,4496,4491, ,0,0,0,26150,0,24,24,5,0
2025-07-25,2241,1,1,26150,0,4496,4496, ,0,0,0,26150,2,26,24,0,2
2025-07-28,2241,8,0,26150,5,4499,4496, ,0,0,0,26150,1,27,26,3,1
2025-07-29,2241,11,0,26150,4,4506,4499, ,0,1,0,26150,0,26,27,7,-1
2025-07-30,2241,4,0,26150,0,4510,4506, ,0,0,0,26150,0,26,26,4,0
2025-07-31,2241,4,0,26150,15,4499,4510, ,0,0,0,26150,0,26,26,-11,0
2025-08-01,2241,6,2,26150,5,4498,4499, ,0,1,0,26150,0,25,26,-1,-1
2025-08-04,2241,11,1,26150,10,4498,4498, ,0,2,0,26150,7,30,25,0,5
2025-08-05,2241,4,0,26150,4,4498,4498, ,0,0,0,26150,0,30,30,0,0
2025-08-06,2241,1,0,26150,11,4488,4498, ,0,0,0,26150,0,30,30,-10,0
2025-08-07,2241,5,0,26150,1,4492,4488, ,0,6,0,26150,0,24,30,4,-6
2025-08-08,2241,4,0,26150,58,4438,4492, ,0,2,0,26150,0,22,24,-54,-2
2025-08-11,2241,0,0,26150,18,4420,4438, ,0,0,0,26150,0,22,22,-18,0
2025-08-12,2241,4,0,26150,0,4424,4420, ,0,0,0,26150,0,22,22,4,0
2025-08-13,2241,29,0,26150,26,4427,4424, ,0,0,0,26150,1,23,22,3,1
2025-08-14,2241,8,0,26150,4,4431,4427, ,0,1,0,26150,0,22,23,4,-1
2025-08-15,2241,13,0,26150,2,4442,4431, ,0,0,0,26150,0,22,22,11,0
2025-08-18,2241,101,6,26150,177,4360,4442, ,0,1,0,26150,8,29,22,-82,7
2025-08-19,2241,30,1,26150,22,4367,4360, ,0,7,0,26150,4,26,29,7,-3
2025-08-20,2241,13,0,26150,17,4363,4367, ,0,5,0,26150,2,23,26,-4,-3
2025-08-21,2241,52,0,26150,33,4382,4363, ,0,0,0,26150,4,27,23,19,4
2025-08-22,2241,20,0,26150,8,4394,4382, ,0,2,0,26150,0,25,27,12,-2
2025-08-25,2241,17,0,26150,8,4403,4394, ,0,2,0,26150,1,24,25,9,-1
2025-08-26,2241,34,9,26150,32,4396,4403, ,0,0,0,26150,0,24,24,-7,0
2025-08-27,2241,38,0,26150,9,4425,4396, ,0,2,0,26150,0,22,24,29,-2
2025-08-28,2241,9,1,26150,15,4418,4425, ,0,0,0,26150,1,23,22,-7,1
2025-08-29,2241,12,20,26150,2,4408,4418, ,0,0,0,26150,0,23,23,-10,0
2025-09-01,2241,20,11,26150,9,4408,4408, ,0,1,0,26150,2,24,23,0,1
2025-09-02,2241,10,0,26150,24,4394,4408, ,0,0,0,26150,0,24,24,-14,0
2025-09-03,2241,28,11,26150,67,4344,4394, ,0,1,0,26150,1,24,24,-50,0
2025-09-04,2241,9,0,26150,4,4349,4344, ,0,0,0,26150,0,24,24,5,0
2025-09-05,2241,11,0,26150,22,4338,4349, ,0,1,0,26150,1,24,24,-11,0
2025-09-08,2241,32,199,26150,4,4167,4338, ,0,0,0,26150,7,31,24,-171,7
2025-09-09,2241,9,0,26150,32,4144,4167, ,0,5,0,26150,0,26,31,-23,-5
2025-09-10,2241,14,1,26150,5,4152,4144, ,0,1,0,26150,0,25,26,8,-1
2025-09-11,2241,11,0,26150,39,4124,4152, ,0,0,0,26150,2,27,25,-28,2
2025-09-12,2241,8,0,26150,30,4102,4124, ,0,2,0,26150,0,25,27,-22,-2
2025-09-15,2241,37,0,26150,69,4070,4102, ,0,5,0,26150,4,24,25,-32,-1
2025-09-16,2241,84,150,26150,60,3944,4070, ,0,3,0,26150,0,21,24,-126,-3
2025-09-17,2241,59,0,26150,40,3963,3944, ,0,0,0,26150,0,21,21,19,0
2025-09-18,2241,340,0,26150,88,4215,3963, ,0,0,0,26150,3,24,21,252,3
2025-09-19,2241,206,0,26150,81,4340,4215, ,0,0,0,26150,3,27,24,125,3
2025-09-22,2241,404,0,26150,87,4657,4340, ,0,3,0,26150,5,29,27,317,2
2025-09-23,2241,94,0,26150,95,4656,4657, ,0,5,0,26150,0,24,29,-1,-5
2025-06-25,2301,82,0,585294,63,6914,6895, ,0,6,0,585294,26,736,716,19,20
2025-06-26,2301,255,0,585294,299,6870,6914, ,0,38,0,585294,31,729,736,-44,-7
2025-06-27,2301,515,0,585294,144,7241,6870, ,5,10,0,585294,14,733,729,371,4
2025-06-30,2301,83,0,585294,86,7238,7241, ,1,14,0,585294,5,724,733,-3,-9
2025-07-01,2301,56,0,585294,143,7151,7238, ,5,3,0,585294,8,729,724,-87,5
2025-07-02,2301,92,5,585294,103,7135,7151, ,1,7,0,585294,15,737,729,-16,8
2025-07-03,2301,347,0,585294,806,6676,7135, ,0,4,0,585294,54,787,737,-459,50
2025-07-04,2301,350,0,585294,245,6781,6676, ,1,31,0,585294,8,764,787,105,-23
2025-07-07,2301,82,2,585294,261,6600,6781, ,1,17,0,585294,30,777,764,-181,13
2025-07-08,2301,60,0,585294,101,6559,6600, ,3,18,0,585294,9,768,777,-41,-9
2025-07-09,2301,48,1,585294,212,6394,6559, ,0,14,0,585294,31,785,768,-165,17
2025-07-10,2301,317,1,585294,206,6504,6394, ,4,12,0,585294,13,786,785,110,1
2025-07-11,2301,139,0,585294,202,6441,6504, ,3,9,0,585294,15,792,786,-63,6
2025-07-14,2301,224,15,585294,199,6451,6441, ,0,31,0,585294,17,778,792,10,-14
2025-07-15,2301,228,1,585294,179,6499,6451, ,1,9,2,585294,8,775,778,48,-3
2025-07-16,2301,138,1,585294,121,6515,6499, ,0,11,0,585294,9,773,775,16,-2
2025-07-17,2301,256,0,585294,185,6586,6515, ,3,10,0,585294,11,774,773,71,1
2025-07-18,2301,55,1,585294,181,6459,6586, ,1,4,0,585294,1,771,774,-127,-3
2025-07-21,2301,183,0,585294,105,6537,6459, ,3,5,0,585294,7,773,771,78,2
2025-07-22,2301,169,2,585294,235,6468,6536, ,2,23,0,585294,18,768,773,-68,-5
2025-07-23,2301,293,0,585294,122,6639,6468, ,0,1,0,585294,19,786,768,171,18
2025-07-24,2301,349,0,585294,100,6888,6639, ,1,10,0,585294,10,786,786,249,0
2025-07-25,2301,239,0,585294,175,6952,6888, ,0,3,0,585294,14,797,786,64,11
2025-07-28,2301,4139,0,585294,1089,10002,6952, ,23,29,0,585294,92,860,797,3050,63
2025-07-29,2301,823,0,585294,1948,8877,10002, ,2,43,0,585294,14,831,860,-1125,-29
2025-07-30,2301,2666,5,585294,567,10971,8877, ,10,7,0,585294,10,834,831,2094,3
2025-07-31,2301,1611,22,585294,4000,8560,10971, ,106,83,1,585294,13,763,834,-2411,-71
2025-08-01,2301,295,0,585294,784,8071,8560, ,1,7,0,585294,29,785,763,-489,22
2025-08-04,2301,654,150,585294,244,8331,8071, ,5,17,0,585294,9,777,785,260,-8
2025-08-05,2301,4353,1,585294,2561,10122,8331, ,31,54,0,585294,833,1556,777,1791,779
2025-08-06,2301,6624,0,585294,2120,14626,10122, ,103,618,0,585294,48,986,1556,4504,-570
2025-08-07,2301,4586,2,585294,1966,17244,14626, ,61,65,380,585294,128,669,986,2618,-317
2025-08-08,2301,2318,3,585294,4677,14882,17244, ,59,110,1,585294,12,570,669,-2362,-99
2025-08-11,2301,5165,1,585294,2169,17877,14882, ,15,83,8,585294,17,496,570,2995,-74
2025-08-12,2301,1034,0,585294,3732,15179,17877,X ,2,194,0,585294,2,304,496,-2698,-192
2025-08-13,2301,1488,17,585294,3398,13252,15179,X ,0,299,4,585294,0,1,304,-1927,-303
2025-08-14,2301,1602,16,585294,2076,12762,13252,X ,0,0,1,585294,0,0,1,-490,-1
2025-08-15,2301,725,1,585294,731,12755,12762,X ,0,0,0,585294,0,0,0,-7,0
2025-08-18,2301,1152,1,585294,779,13127,12755, ,0,0,0,585294,0,0,0,372,0
2025-08-19,2301,1371,8,585294,1265,13225,13127, ,45,0,0,585294,12,12,0,98,12
2025-08-20,2301,916,2,585294,1139,13000,13225, ,23,5,0,585294,29,36,12,-225,24
2025-08-21,2301,1005,0,585294,773,13232,13000, ,1,7,0,585294,10,39,36,232,3
2025-08-22,2301,296,6,585294,520,13002,13232, ,2,3,0,585294,10,46,39,-230,7
2025-08-25,2301,267,0,585294,338,12931,13002, ,2,5,0,585294,3,44,46,-71,-2
2025-08-26,2301,1704,2,585294,185,14448,12931, ,0,5,0,585294,2,41,44,1517,-3
2025-08-27,2301,1938,1,585294,1759,14626,14448, ,10,8,0,585294,25,58,41,178,17
2025-08-28,2301,335,1,585294,534,14426,14626, ,0,7,0,585294,3,54,58,-200,-4
2025-08-29,2301,2050,1,585294,485,15990,14426, ,5,6,0,585294,4,52,54,1564,-2
2025-09-01,2301,754,0,585294,682,16062,15990, ,1,17,0,585294,35,70,52,72,18
2025-09-02,2301,361,20,585294,1074,15329,16062, ,1,34,0,585294,26,62,70,-733,-8
2025-09-03,2301,144,1,585294,182,15290,15329, ,0,11,0,585294,6,57,62,-39,-5
2025-09-04,2301,690,6,585294,183,15791,15290, ,0,3,0,585294,1,55,57,501,-2
2025-09-05,2301,726,6,585294,1028,15483,15791, ,7,7,0,585294,87,135,55,-308,80
2025-09-08,2301,1091,1,585294,1006,15567,15483, ,5,7,0,585294,27,155,135,84,20
2025-09-09,2301,4112,0,585294,2345,17334,15567, ,28,15,0,585294,228,368,155,1767,213
2025-09-10,2301,2845,1,585294,1969,18209,17334, ,0,1,0,585294,120,487,368,875,119
2025-09-11,2301,5841,0,585294,6380,17670,18209, ,173,63,0,585294,457,881,487,-539,394
2025-09-12,2301,4290,25,585294,3009,18926,17670, ,83,271,0,585294,63,673,881,1256,-208
2025-09-15,2301,4844,30,585294,1881,21859,18926, ,66,151,0,585294,41,563,673,2933,-110
2025-09-16,2301,3891,2,585294,2875,22873,21859, ,20,34,2,585294,252,779,563,1014,216
2025-09-17,2301,2659,0,585294,4774,20758,22873, ,29,186,0,585294,26,619,779,-2115,-160
2025-09-18,2301,2341,11,585294,2568,20520,20758, ,25,10,0,585294,160,769,619,-238,150
2025-09-19,2301,2524,1,579193,3184,19859,20520, ,24,27,3,579193,52,791,769,-661,22
2025-09-22,2301,6402,17,579193,3332,22912,19859, ,27,49,0,579193,715,1457,791,3053,666
2025-09-23,2301,2539,4,579193,6956,18491,22912, ,43,239,2,579193,89,1305,1457,-4421,-152
2025-06-25,2317,2529,16,3472925,1386,61400,60273,X ,4,171,12,3472925,21,539,701,1127,-162
2025-06-26,2317,1695,54,3472925,2535,60506,61400,X ,0,494,5,3472925,0,40,539,-894,-499
2025-06-27,2317,1325,158,3472925,2213,59460,60506,X ,0,1,39,3472925,0,0,40,-1046,-40
2025-06-30,2317,2696,38,3472925,1612,60506,59460,X ,0,0,0,3472925,0,0,0,1046,0
2025-07-01,2317,2575,24,3472925,4578,58479,60506, ,0,0,0,3472925,0,0,0,-2027,0
2025-07-02,2317,2344,5,3472925,1735,59083,58479, ,91,0,0,3472925,693,693,0,604,693
2025-07-03,2317,727,82,3472925,2139,57589,59083, ,252,54,0,3472925,194,833,693,-1494,140
2025-07-04,2317,1399,66,3472925,1899,57023,57589, ,1,176,0,3472925,333,990,833,-566,157
2025-07-07,2317,514,145,3472925,843,56549,57023, ,3,213,0,3472925,559,1336,990,-474,346
2025-07-08,2317,1005,13,3472925,957,56584,56549, ,0,481,0,3472925,192,1047,1336,35,-289
2025-07-09,2317,786,52,3472925,459,56859,56584, ,2,112,0,3472925,178,1113,1047,275,66
2025-07-10,2317,517,108,3472925,1214,56054,56859, ,0,104,0,3472925,222,1231,1113,-805,118
2025-07-11,2317,262,39,3472925,466,55811,56054, ,5,165,0,3472925,34,1100,1231,-243,-131
2025-07-14,2317,433,21,3472935,979,55244,55811, ,8,35,0,3472935,46,1111,1100,-567,11
2025-07-15,2317,329,23,3472935,760,54790,55244, ,0,241,0,3472935,59,929,1111,-454,-182
2025-07-16,2317,730,17,3472935,813,54690,54790, ,0,143,1,3472935,16,801,929,-100,-128
2025-07-17,2317,507,263,3472935,834,54100,54690, ,0,27,0,3472935,16,790,801,-590,-11
2025-07-18,2317,737,85,3472935,1001,53751,54100, ,0,10,0,3472935,241,1021,790,-349,231
2025-07-21,2317,603,10,3472935,465,53879,53751, ,1,17,20,3472935,46,1030,1021,128,9
2025-07-22,2317,739,50,3472935,1207,53364,53882, ,8,108,0,3472935,384,1306,1030,-518,276
2025-07-23,2317,2615,24,3472935,1179,54776,53364, ,6,264,3,3472935,555,1594,1306,1412,288
2025-07-24,2317,4801,55,3472935,3076,56446,54776, ,36,361,0,3472935,627,1860,1594,1670,266
2025-07-25,2317,1739,19,3472935,3429,54737,56446, ,15,46,0,3472935,109,1923,1860,-1709,63
2025-07-28,2317,2283,46,3472935,3101,53873,54737, ,3,158,0,3472935,102,1867,1923,-864,-56
2025-07-29,2317,2063,22,3472935,3226,52688,53873, ,7,298,0,3472935,62,1631,1867,-1185,-236
2025-07-30,2317,0,18,3472935,0,52670,52688, ,0,0,0,3472935,0,1631,1631,-18,0
2025-07-31,2317,3479,150,3472935,2311,53688,52670, ,1206,152,4,3472935,206,1681,1631,1018,50
2025-08-01,2317,2050,132,3472935,2357,53249,53688, ,12,148,7,3472935,241,1767,1681,-439,86
2025-08-04,2317,1135,41,3472935,1287,53056,53249, ,6,113,0,3472935,62,1716,1767,-193,-51
2025-08-05,2317,1418,52,3472935,1755,52667,53056, ,11,60,2,3472935,222,1876,1716,-389,160
2025-08-06,2317,1543,41,3472935,1677,52492,52667, ,10,90,2,3472935,265,2049,1876,-175,173
2025-08-07,2317,2174,80,3472935,2863,51723,52492, ,38,127,0,3472935,490,2412,2049,-769,363
2025-08-08,2317,1957,60,3472935,1790,51830,51723, ,6,112,2,3472935,150,2448,2412,107,36
2025-08-11,2317,2061,40,3472935,1975,51876,51830, ,3,262,0,3472935,142,2328,2448,46,-120
2025-08-12,2317,1417,50,3472935,1130,52113,51876, ,3,42,0,3472935,52,2338,2328,237,10
2025-08-13,2317,3356,21,3472935,3336,52112,52113, ,26,102,1,3472935,194,2429,2338,-1,91
2025-08-14,2317,3645,42,3472935,2519,53196,52112, ,13,29,0,3472935,211,2611,2429,1084,182
2025-08-15,2317,4725,103,3472935,5128,52690,53196, ,68,199,1,3472935,306,2717,2611,-506,106
2025-08-18,2317,1811,100,3472935,1617,52784,52690, ,22,152,42,3472935,126,2649,2717,94,-68
2025-08-19,2317,1672,57,3472935,2377,52022,52784, ,9,58,83,3472935,53,2561,2649,-762,-88
2025-08-20,2317,4010,18,3472935,4855,51159,52022, ,15,368,3,3472935,197,2387,2561,-863,-174
2025-08-21,2317,4257,57,3472935,2614,52745,51159, ,8,68,0,3472935,242,2561,2387,1586,174
2025-08-22,2317,2026,17,3472935,1825,52929,52745, ,13,122,1,3472935,78,2516,2561,184,-45
2025-08-25,2317,2598,71,3472935,3235,52221,52929, ,18,39,9,3472935,92,2560,2516,-708,44
2025-08-26,2317,1306,60,3472935,762,52705,52221, ,3,48,0,3472935,68,2580,2560,484,20
2025-08-27,2317,1528,12,3472935,2117,52104,52705, ,18,95,0,3472935,16,2501,2580,-601,-79
2025-08-28,2317,601,34,3472935,1757,50914,52104, ,9,54,2,3472935,52,2497,2501,-1190,-4
2025-08-29,2317,1521,29,3472935,1614,50792,50914, ,7,82,0,3472935,60,2475,2497,-122,-22
2025-09-01,2317,2221,17,3472935,3046,49950,50792, ,6,292,0,3472935,158,2341,2475,-842,-134
2025-09-02,2317,1423,9,3472935,1852,49512,49950, ,8,114,0,3472935,94,2321,2341,-438,-20
2025-09-03,2317,1255,20,3472935,681,50066,49512, ,1,117,0,3472935,85,2289,2321,554,-32
2025-09-04,2317,3459,22,3472935,1123,52380,50066, ,8,123,0,3472935,77,2243,2289,2314,-46
2025-09-05,2317,1822,32,3472935,1437,52733,52380, ,7,54,0,3472935,97,2286,2243,353,43
2025-09-08,2317,1677,48,3472935,3368,50994,52733, ,15,131,0,3472935,21,2176,2286,-1739,-110
2025-09-09,2317,1479,53,3472935,2305,50115,50994, ,4,60,0,3472935,189,2305,2176,-879,129
2025-09-10,2317,3417,30,3472935,2410,51092,50115, ,4,55,0,3472935,71,2321,2305,977,16
2025-09-11,2317,5339,39,3472935,4078,52314,51092, ,89,39,0,3472935,294,2576,2321,1222,255
2025-09-12,2317,2949,46,3472935,2565,52652,52314, ,7,29,0,3472935,148,2695,2576,338,119
2025-09-15,2317,1735,42,3472935,2852,51493,52652, ,3,109,0,3472935,196,2782,2695,-1159,87
2025-09-16,2317,958,93,3472935,1372,50986,51493, ,3,58,0,3472935,41,2765,2782,-507,-17
2025-09-17,2317,1277,22,3472935,3084,49157,50986, ,2,127,0,3472935,32,2670,2765,-1829,-95
2025-09-18,2317,2375,8,3472935,2303,49221,49157, ,22,246,1,3472935,113,2536,2670,64,-134
2025-09-19,2317,1263,37,3472935,1345,49102,49221, ,5,27,1,3472935,42,2550,2536,-119,14
2025-09-22,2317,1128,20,3472935,1004,49206,49102, ,9,48,2,3472935,19,2519,2550,104,-31
2025-09-23,2317,5068,31,3472935,2829,51414,49206, ,29,137,1,3472935,171,2552,2519,2208,33
2025-06-25,2331,25,0,139350,127,10419,10521, ,0,3,0,139350,0,61,64,-102,-3
2025-06-26,2331,40,2,139350,113,10344,10419, ,0,0,0,139350,1,62,61,-75,1
2025-06-27,2331,47,9,139350,88,10294,10344, ,0,1,0,139350,0,61,62,-50,-1
2025-06-30,2331,31,5,139350,47,10273,10294, ,0,2,0,139350,0,59,61,-21,-2
2025-07-01,2331,57,1,139350,81,10248,10273, ,0,0,0,139350,0,59,59,-25,0
2025-07-02,2331,118,1,139350,24,10341,10248, ,20,1,0,139350,0,58,59,93,-1
2025-07-03,2331,110,0,139350,80,10371,10341, ,5,0,0,139350,3,61,58,30,3
2025-07-04,2331,80,0,139350,151,10300,10371, ,0,3,0,139350,0,58,61,-71,-3
2025-07-07,2331,12,0,139350,59,10253,10300, ,2,0,0,139350,0,58,58,-47,0
2025-07-08,2331,49,0,139350,77,10225,10253, ,2,0,0,139350,0,58,58,-28,0
2025-07-09,2331,94,1,139350,200,10118,10225, ,0,0,0,139350,0,58,58,-107,0
2025-07-10,2331,63,28,139350,68,10085,10118, ,0,0,0,139350,6,64,58,-33,6
2025-07-11,2331,35,1,139350,31,10088,10085, ,0,5,0,139350,1,60,64,3,-4
2025-07-14,2331,34,0,139350,26,10096,10088, ,0,0,0,139350,0,60,60,8,0
2025-07-15,2331,10,0,139350,43,10063,10096, ,0,5,0,139350,1,56,60,-33,-4
2025-07-16,2331,69,0,139350,114,10018,10063, ,0,1,0,139350,1,56,56,-45,0
2025-07-17,2331,57,2,139350,44,10029,10018, ,1,1,1,139350,0,54,56,11,-2
2025-07-18,2331,76,0,139350,9,10096,10029, ,0,1,0,139350,0,53,54,67,-1
2025-07-21,2331,21,1,139350,18,10098,10096, ,0,0,0,139350,1,54,53,2,1
2025-07-22,2331,150,27,139350,153,10068,10098, ,0,5,0,139350,0,49,54,-30,-5
2025-07-23,2331,18,0,139350,42,10044,10068, ,0,0,0,139350,1,50,49,-24,1
2025-07-24,2331,35,8,139350,9,10062,10044, ,0,5,0,139350,0,45,50,18,-5
2025-07-25,2331,13,3,139350,41,10031,10062, ,0,0,0,139350,0,45,45,-31,0
2025-07-28,2331,64,0,139350,29,10066,10031, ,0,7,0,139350,0,38,45,35,-7
2025-07-29,2331,276,0,139350,23,10319,10066,X ,0,10,0,139350,0,28,38,253,-10
2025-07-30,2331,9,0,139350,21,10307,10319,X ,0,28,0,139350,0,0,28,-12,-28
2025-07-31,2331,103,3,139350,22,10385,10307,X ,0,0,0,139350,0,0,0,78,0
2025-08-01,2331,27,0,139350,53,10359,10385,X ,0,0,0,139350,0,0,0,-26,0
2025-08-04,2331,75,0,139350,137,10297,10359, ,0,0,0,139350,0,0,0,-62,0
2025-08-05,2331,57,9,139350,113,10232,10297, ,1,0,0,139350,5,5,0,-65,5
2025-08-06,2331,17,1,139350,86,10162,10232, ,0,0,0,139350,10,15,5,-70,10
2025-08-07,2331,190,0,139350,494,9858,10162, ,0,6,0,139350,11,20,15,-304,5
2025-08-08,2331,84,0,139350,212,9730,9858, ,10,8,0,139350,0,12,20,-128,-8
2025-08-11,2331,50,1,139350,16,9763,9730, ,0,1,0,139350,1,12,12,33,0
2025-08-12,2331,62,0,139350,103,9722,9763, ,1,0,0,139350,6,18,12,-41,6
2025-08-13,2331,85,2,139350,81,9724,9722, ,3,0,0,139350,0,18,18,2,0
2025-08-14,2331,73,5,139350,104,9688,9724, ,0,1,0,139350,2,19,18,-36,1
2025-08-15,2331,1071,8,139350,559,10192,9688, ,7,0,0,139350,63,82,19,504,63
2025-08-18,2331,597,14,139350,257,10518,10192, ,0,28,0,139350,3,57,82,326,-25
2025-08-19,2331,229,1,139350,137,10609,10518, ,0,10,0,139350,4,51,57,91,-6
2025-08-20,2331,249,5,139350,110,10743,10609, ,0,30,0,139350,6,27,51,134,-24
2025-08-21,2331,214,0,139350,238,10719,10743, ,0,0,0,139350,2,29,27,-24,2
2025-08-22,2331,81,5,139350,150,10645,10719, ,0,0,0,139350,8,37,29,-74,8
2025-08-25,2331,240,0,139350,294,10591,10645, ,0,0,0,139350,8,45,37,-54,8
2025-08-26,2331,260,0,139350,238,10613,10591, ,3,4,0,139350,0,41,45,22,-4
2025-08-27,2331,121,0,139350,184,10550,10613, ,0,1,0,139350,5,45,41,-63,4
2025-08-28,2331,544,0,139350,419,10675,10550, ,0,1,0,139350,15,59,45,125,14
2025-08-29,2331,180,0,139350,121,10734,10675, ,0,5,0,139350,0,54,59,59,-5
2025-09-01,2331,740,0,139350,242,11232,10734, ,2,0,0,139350,3,57,54,498,3
2025-09-02,2331,138,0,139350,41,11329,11232, ,0,22,0,139350,0,35,57,97,-22
2025-09-03,2331,144,68,139350,81,11324,11329, ,0,1,0,139350,2,36,35,-5,1
2025-09-04,2331,63,8,139350,119,11260,11324, ,0,0,0,139350,5,41,36,-64,5
2025-09-05,2331,33,0,139350,104,11189,11260, ,0,4,0,139350,0,37,41,-71,-4
2025-09-08,2331,155,51,139350,105,11188,11189, ,0,2,0,139350,20,55,37,-1,18
2025-09-09,2331,105,0,139350,73,11220,11188, ,0,0,0,139350,0,55,55,32,0
2025-09-10,2331,95,4,139350,98,11213,11220, ,0,20,0,139350,6,41,55,-7,-14
2025-09-11,2331,1464,10,139350,995,11672,11213, ,2,6,0,139350,57,92,41,459,51
2025-09-12,2331,1403,0,139350,1500,11575,11672, ,16,49,0,139350,33,76,92,-97,-16
2025-09-15,2331,135,1,139350,143,11566,11575, ,1,23,0,139350,6,59,76,-9,-17
2025-09-16,2331,115,1,139350,279,11401,11566, ,0,16,0,139350,16,59,59,-165,0
2025-09-17,2331,424,0,139350,262,11563,11401, ,0,12,0,139350,45,92,59,162,33
2025-09-18,2331,377,0,139350,635,11308,11566, ,0,20,0,139350,16,88,92,-258,-4
2025-09-19,2331,176,12,139350,220,11252,11308, ,0,6,0,139350,3,85,88,-56,-3
2025-09-22,2331,176,1,139350,165,11262,11252, ,2,0,0,139350,0,85,85,10,0
2025-09-23,2331,554,62,139350,372,11382,11262, ,0,0,0,139350,23,108,85,120,23
2025-06-25,2344,4422,7,1125000,4894,51679,52158, ,331,90,0,1125000,503,6628,6215,-479,413
2025-06-26,2344,6445,23,1125000,8948,49153,51679, ,403,196,0,1125000,743,7175,6628,-2526,547
2025-06-27,2344,5698,15,1125000,4502,50334,49153, ,124,1794,2,1125000,569,5948,7175,1181,-1227
2025-06-30,2344,3809,15,1125000,6282,47846,50334, ,102,829,3,1125000,339,5455,5948,-2488,-493
2025-07-01,2344,2700,71,1125000,2621,47854,47846, ,102,994,3,1125000,342,4800,5455,8,-655
2025-07-02,2344,4560,60,1125000,1265,51089,47854, ,38,556,5,1125000,118,4357,4800,3235,-443
2025-07-03,2344,1239,29,1125000,1726,50573,51089, ,15,136,0,1125000,722,4943,4357,-516,586
2025-07-04,2344,2475,17,1125000,2675,50356,50573, ,29,1139,0,1125000,128,3932,4943,-217,-1011
2025-07-07,2344,692,11,1125000,696,50341,50356, ,39,126,0,1125000,1122,4928,3932,-15,996
2025-07-08,2344,1303,13,1125000,1786,49845,50341, ,9,1276,3,1125000,101,3750,4928,-496,-1178
2025-07-09,2344,475,28,1125000,930,49362,49845, ,2,150,0,1125000,53,3653,3750,-483,-97
2025-07-10,2344,1601,0,1125000,3497,47466,49362, ,8,346,0,1125000,37,3344,3653,-1896,-309
2025-07-11,2344,629,20,1125000,3163,44912,47466, ,139,365,0,1125000,275,3254,3344,-2554,-90
2025-07-14,2344,931,8,1125000,320,45515,44912, ,15,234,35,1125000,54,3039,3254,603,-215
2025-07-15,2344,2020,147,1125000,1287,46101,45515, ,2,455,0,1125000,122,2706,3039,586,-333
2025-07-16,2344,2496,7,1125000,1341,47249,46101, ,2,138,0,1125000,62,2630,2706,1148,-76
2025-07-17,2344,1312,38,1125000,1117,47406,47249, ,4,217,0,1125000,127,2540,2630,157,-90
2025-07-18,2344,1124,21,1125000,337,48172,47406, ,21,141,0,1125000,47,2446,2540,766,-94
2025-07-21,2344,919,145,1125000,548,48398,48172, ,31,127,10,1125000,53,2362,2446,226,-84
2025-07-22,2344,1098,23,1125000,911,48566,48402, ,15,114,0,1125000,99,2346,2361,164,-15
2025-07-23,2344,1069,14,1125000,1838,47783,48566, ,3,63,0,1125000,197,2480,2346,-783,134
2025-07-24,2344,2071,14,1125000,270,49570,47783, ,63,94,1,1125000,44,2429,2480,1787,-51
2025-07-25,2344,352,36,1125000,775,49111,49570, ,0,21,0,1125000,37,2445,2429,-459,16
2025-07-28,2344,634,6,1125000,378,49361,49111, ,10,89,0,1125000,13,2369,2445,250,-76
2025-07-29,2344,1778,3,1125000,967,50169,49361, ,23,114,0,1125000,49,2304,2369,808,-65
2025-07-30,2344,954,9,1125000,1471,49643,50169, ,2,43,0,1125000,151,2412,2304,-526,108
2025-07-31,2344,1056,41,1125000,507,50151,49643, ,6,185,0,1125000,21,2248,2412,508,-164
2025-08-01,2344,1124,4,1125000,1283,49988,50151, ,0,77,0,1125000,142,2313,2248,-163,65
2025-08-04,2344,1799,53,1125000,516,51218,49988, ,6,185,0,1125000,20,2148,2313,1230,-165
2025-08-05,2344,579,0,1125000,955,50842,51218, ,4,38,0,1125000,625,2735,2148,-376,587
2025-08-06,2344,3474,523,1125000,878,52915,50842, ,2,376,0,1125000,115,2474,2735,2073,-261
2025-08-07,2344,2772,14,1125000,3123,52550,52915, ,17,492,0,1125000,1430,3412,2474,-365,938
2025-08-08,2344,6596,2,1125000,5833,53311,52550, ,195,1367,0,1125000,389,2434,3412,761,-978
2025-08-11,2344,2051,8,1125000,2108,53246,53311, ,14,82,0,1125000,30,2382,2434,-65,-52
2025-08-12,2344,8457,4,1125000,6337,55362,53246, ,159,106,50,1125000,459,2685,2382,2116,303
2025-08-13,2344,4270,34,1125000,10072,49526,55362, ,22,363,0,1125000,85,2407,2685,-5836,-278
2025-08-14,2344,2183,15,1125000,693,51001,49526, ,15,40,1,1125000,48,2414,2407,1475,7
2025-08-15,2344,2374,6,1125000,2484,50885,51001, ,43,82,0,1125000,142,2474,2414,-116,60
2025-08-18,2344,12045,16,1125000,6122,56792,50885, ,263,29,1,1125000,273,2717,2474,5907,243
2025-08-19,2344,3012,1,1125000,5846,53957,56792, ,7,149,0,1125000,31,2599,2717,-2835,-118
2025-08-20,2344,4027,36,1125000,4636,53312,53957, ,34,129,0,1125000,13,2483,2599,-645,-116
2025-08-21,2344,1147,46,1125000,2269,52144,53312, ,16,8,0,1125000,28,2503,2483,-1168,20
2025-08-22,2344,1239,1,1125000,1459,51923,52144, ,0,98,0,1125000,20,2425,2503,-221,-78
2025-08-25,2344,2111,1,1125000,2410,51623,51923, ,20,12,0,1125000,68,2481,2425,-300,56
2025-08-26,2344,3369,7,1125000,1722,53263,51623, ,6,50,0,1125000,126,2557,2481,1640,76
2025-08-27,2344,4458,1,1125000,9110,48610,53263, ,283,104,0,1125000,421,2874,2557,-4653,317
2025-08-28,2344,3316,55,1125000,3915,47956,48610, ,54,206,0,1125000,67,2735,2874,-654,-139
2025-08-29,2344,3840,116,1125000,6139,45541,47956, ,178,27,1,1125000,76,2783,2735,-2415,48
2025-09-01,2344,6268,55,1125000,4270,47484,45541, ,117,59,1,1125000,467,3190,2783,1943,407
2025-09-02,2344,5580,4,1125000,4732,48328,47484, ,51,275,1,1125000,114,3028,3190,844,-162
2025-09-03,2344,2349,65,1125000,2778,47834,48328, ,45,23,0,1125000,132,3137,3028,-494,109
2025-09-04,2344,3192,43,1125000,3668,47315,47834, ,45,131,0,1125000,168,3174,3137,-519,37
2025-09-05,2344,7454,10,1125000,8587,46172,47315, ,186,117,2,1125000,2347,5402,3174,-1143,2228
2025-09-08,2344,43561,24,1125000,9814,79895,46172, ,349,556,1,1125000,1393,6238,5402,33723,836
2025-09-09,2344,17701,9,1125000,10853,86734,79895, ,277,614,35,1125000,933,6522,6238,6839,284
2025-09-10,2344,31877,29,1125000,20083,98499,86734, ,240,487,2,1125000,476,6509,6522,11765,-13
2025-09-11,2344,17760,9,1125000,19436,96814,98499, ,876,296,0,1125000,427,6640,6509,-1685,131
2025-09-12,2344,18184,21,1125000,32889,82088,96814, ,377,229,1,1125000,769,7179,6640,-14726,539
2025-09-15,2344,42052,39,1125000,16485,107616,82088, ,655,429,1,1125000,2463,9212,7179,25528,2033
2025-09-16,2344,41047,0,1125000,32543,116120,107616, ,806,1311,859,1125000,4775,11817,9212,8504,2605
2025-09-17,2344,29226,60,1125000,34999,110287,116120, ,542,1416,7,1125000,4431,14825,11817,-5833,3008
2025-09-18,2344,23461,1,1125000,16199,117548,110287, ,568,746,58,1125000,10088,24109,14825,7261,9284
2025-09-19,2344,26296,120,1125000,25415,118309,117548, ,875,3513,10,1125000,4009,24595,24109,761,486
2025-09-22,2344,29210,33,1125000,24105,123381,118309, ,443,1800,71,1125000,4517,27241,24595,5072,2646
2025-09-23,2344,25126,30,1125000,23243,125234,123381, ,1021,6428,7,1125000,6176,26982,27241,1853,-259
2025-06-25,2356,323,7,896868,264,26909,26857, ,1,384,0,896868,11,528,901,52,-373
2025-06-26,2356,184,34,896868,581,26478,26909, ,3,3,0,896868,21,546,528,-431,18
2025-06-27,2356,395,6,896868,441,26426,26478, ,0,30,0,896868,1,517,546,-52,-29
2025-06-30,2356,97,15,896868,683,25825,26426, ,3,17,0,896868,4,504,517,-601,-13
2025-07-01,2356,149,21,896868,385,25568,25825, ,0,21,0,896868,4,487,504,-257,-17
2025-07-02,2356,254,8,896868,1035,24779,25568, ,19,20,2,896868,26,491,487,-789,4
2025-07-03,2356,420,190,896868,510,24499,24779,X ,3,31,5,896868,19,474,491,-280,-17
2025-07-04,2356,186,7,896868,949,23729,24499,X ,0,462,1,896868,0,11,474,-770,-463
2025-07-07,2356,268,61,896868,294,23642,23729,X ,0,1,10,896868,0,0,11,-87,-11
2025-07-08,2356,269,48,896868,296,23567,23642,X ,0,0,0,896868,0,0,0,-75,0
2025-07-09,2356,646,19,896868,1130,23064,23567, ,0,0,0,896868,0,0,0,-503,0
2025-07-10,2356,1012,32,896868,278,23766,23064, ,290,0,0,896868,326,326,0,702,326
2025-07-11,2356,537,508,896868,199,23596,23766, ,97,9,0,896868,298,615,326,-170,289
2025-07-14,2356,156,51,896868,149,23552,23596, ,0,1,0,896868,215,829,615,-44,214
2025-07-15,2356,2961,16,896868,1100,25397,23552, ,30,62,0,896868,189,956,829,1845,127
2025-07-16,2356,1570,2,896868,2661,24304,25397, ,25,100,0,896868,37,893,956,-1093,-63
2025-07-17,2356,449,31,896868,260,24462,24304, ,12,34,0,896868,28,887,893,158,-6
2025-07-18,2356,628,34,896868,936,24120,24462, ,21,5,0,896868,31,913,887,-342,26
2025-07-21,2356,618,12,896868,480,24246,24120, ,14,14,65,896868,27,861,913,126,-52
2025-07-22,2356,378,31,896868,1162,23425,24240, ,18,43,0,896868,23,841,861,-815,-20
2025-07-23,2356,791,21,896868,172,24023,23425, ,1,6,0,896868,11,846,841,598,5
2025-07-24,2356,691,69,896868,686,23959,24023, ,3,106,0,896868,251,991,846,-64,145
2025-07-25,2356,692,9,896868,689,23953,23959, ,4,2,0,896868,23,1012,991,-6,21
2025-07-28,2356,358,21,896868,756,23534,23953, ,1,4,0,896868,13,1021,1012,-419,9
2025-07-29,2356,558,1,896868,575,23516,23534, ,4,10,0,896868,6,1017,1021,-18,-4
2025-07-30,2356,294,2,896868,959,22849,23516, ,0,5,0,896868,40,1052,1017,-667,35
2025-07-31,2356,410,25,896868,539,22695,22849, ,20,24,0,896868,17,1045,1052,-154,-7
2025-08-01,2356,344,22,896868,164,22853,22695, ,6,23,0,896868,5,1027,1045,158,-18
2025-08-04,2356,299,17,896868,245,22890,22853, ,2,14,0,896868,0,1013,1027,37,-14
2025-08-05,2356,467,15,896868,546,22796,22890, ,0,11,0,896868,24,1026,1013,-94,13
2025-08-06,2356,463,36,896868,349,22874,22796, ,0,17,0,896868,5,1014,1026,78,-12
2025-08-07,2356,937,14,896868,751,23046,22874, ,1,35,0,896868,29,1008,1014,172,-6
2025-08-08,2356,1340,17,896868,662,23707,23046, ,43,59,0,896868,13,962,1008,661,-46
2025-08-11,2356,212,19,896868,248,23652,23707, ,0,5,0,896868,141,1098,962,-55,136
2025-08-12,2356,864,5,896868,445,24066,23652, ,20,54,0,896868,3,1047,1098,414,-51
2025-08-13,2356,654,58,896868,365,24297,24066, ,53,40,0,896868,549,1556,1047,231,509
2025-08-14,2356,503,7,896868,152,24641,24297, ,3,67,0,896868,60,1549,1556,344,-7
2025-08-15,2356,698,15,896868,261,25063,24641, ,2,67,0,896868,13,1495,1549,422,-54
2025-08-18,2356,331,35,896868,455,24904,25063, ,3,7,0,896868,699,2187,1495,-159,692
2025-08-19,2356,694,49,896868,301,25248,24904, ,15,320,0,896868,13,1880,2187,344,-307
2025-08-20,2356,623,46,896868,352,25473,25248, ,0,85,0,896868,79,1874,1880,225,-6
2025-08-21,2356,783,23,896868,83,26150,25473, ,22,11,0,896868,16,1879,1874,677,5
2025-08-22,2356,541,16,896868,602,26073,26150, ,3,3,0,896868,77,1953,1879,-77,74
2025-08-25,2356,394,86,896868,297,26084,26073, ,5,27,0,896868,302,2228,1953,11,275
2025-08-26,2356,218,68,896868,366,25868,26084, ,0,2,0,896868,13,2239,2228,-216,11
2025-08-27,2356,514,62,896868,556,25764,25868, ,1,0,0,896868,8,2247,2239,-104,8
2025-08-28,2356,362,77,896868,107,25942,25764, ,3,31,0,896868,1,2217,2247,178,-30
2025-08-29,2356,473,17,896868,283,26115,25942, ,0,2,0,896868,5,2220,2217,173,3
2025-09-01,2356,959,12,896868,344,26718,26115, ,1,4,0,896868,87,2303,2220,603,83
2025-09-02,2356,419,25,896868,712,26400,26718, ,0,904,0,896868,20,1419,2303,-318,-884
2025-09-03,2356,166,11,896868,351,26204,26400, ,0,7,1,896868,5,1416,1419,-196,-3
2025-09-04,2356,275,6,896868,603,25870,26204, ,0,10,0,896868,13,1419,1416,-334,3
2025-09-05,2356,136,25,896868,544,25437,25870, ,6,4,1,896868,6,1420,1419,-433,1
2025-09-08,2356,1173,23,896868,368,26219,25437, ,2,8,0,896868,4,1416,1420,782,-4
2025-09-09,2356,849,69,896868,1325,25674,26219, ,2,7,0,896868,437,1846,1416,-545,430
2025-09-10,2356,352,11,896868,856,25159,25674, ,4,3,0,896868,863,2706,1846,-515,860
2025-09-11,2356,335,17,896868,615,24862,25159, ,3,64,0,896868,774,3416,2706,-297,710
2025-09-12,2356,1033,79,896868,1940,23876,24862, ,18,26,597,896868,42,2835,3416,-986,-581
2025-09-15,2356,339,173,896868,707,23335,23876, ,3,12,211,896868,13,2625,2835,-541,-210
2025-09-16,2356,445,30,896868,613,23137,23335, ,1,21,1,896868,3,2606,2625,-198,-19
2025-09-17,2356,483,2,896868,596,23022,23137, ,0,5,80,896868,2,2523,2606,-115,-83
2025-09-18,2356,285,11,896868,412,22884,23022, ,1,1,505,896868,56,2073,2523,-138,-450
2025-09-19,2356,1385,71,896868,1483,22715,22884, ,15,82,12,896868,56,2035,2073,-169,-38
2025-09-22,2356,504,133,896868,751,22335,22715, ,4,3,0,896868,7,2039,2035,-380,4
2025-09-23,2356,713,36,896868,930,22082,22335, ,3,1,0,896868,52,2090,2039,-253,51
2025-06-25,2375,7,0,27168,7,2438,2438, ,0,0,0,27168,0,3,3,0,0
2025-06-26,2375,26,0,27168,6,2458,2438, ,0,0,0,27168,1,4,3,20,1
2025-06-27,2375,7,0,27168,26,2439,2458, ,0,0,0,27168,0,4,4,-19,0
2025-06-30,2375,7,0,27168,11,2435,2439, ,0,0,0,27168,0,4,4,-4,0
2025-07-01,2375,5,1,27168,7,2432,2435, ,0,0,0,27168,0,4,4,-3,0
2025-07-02,2375,5,0,27168,5,2432,2432, ,0,1,0,27168,8,11,4,0,7
2025-07-03,2375,8,2,27168,11,2427,2432, ,0,0,0,27168,0,11,11,-5,0
2025-07-04,2375,10,2,27168,23,2412,2427, ,0,8,0,27168,1,4,11,-15,-7
2025-07-07,2375,16,0,27168,16,2412,2412, ,0,0,0,27168,0,4,4,0,0
2025-07-08,2375,15,0,27168,0,2427,2412, ,0,1,0,27168,1,4,4,15,0
2025-07-09,2375,23,0,27168,1,2449,2427, ,0,0,0,27168,0,4,4,22,0
2025-07-10,2375,5,0,27168,9,2445,2449, ,0,0,0,27168,0,4,4,-4,0
2025-07-11,2375,16,4,27168,3,2454,2445, ,0,0,0,27168,0,4,4,9,0
2025-07-14,2375,13,19,27168,12,2436,2454, ,0,0,0,27168,0,4,4,-18,0
2025-07-15,2375,4,1,27168,14,2425,2436, ,0,0,0,27168,0,4,4,-11,0
2025-07-16,2375,14,0,27168,17,2422,2425, ,0,3,0,27168,0,1,4,-3,-3
2025-07-17,2375,9,5,27168,33,2393,2422, ,0,0,0,27168,0,1,1,-29,0
2025-07-18,2375,13,12,27168,8,2386,2393, ,0,0,0,27168,0,1,1,-7,0
2025-07-21,2375,8,0,27168,9,2385,2386, ,0,0,0,27168,0,1,1,-1,0
2025-07-22,2375,12,0,27168,30,2367,2385, ,1,0,0,27168,0,1,1,-18,0
2025-07-23,2375,11,0,27168,18,2360,2367, ,0,0,0,27168,0,1,1,-7,0
2025-07-24,2375,4,0,27168,17,2347,2360, ,0,0,0,27168,0,1,1,-13,0
2025-07-25,2375,23,1,27168,14,2355,2347, ,0,0,0,27168,0,1,1,8,0
2025-07-28,2375,14,0,27168,28,2341,2355, ,0,0,0,27168,0,1,1,-14,0
2025-07-29,2375,13,3,27168,38,2313,2341, ,0,1,0,27168,0,0,1,-28,-1
2025-07-30,2375,17,0,27168,3,2327,2313,X ,0,0,0,27168,0,0,0,14,0
2025-07-31,2375,29,0,27168,5,2351,2327,X ,0,0,0,27168,0,0,0,24,0
2025-08-01,2375,11,0,27168,23,2339,2351,X ,0,0,0,27168,0,0,0,-12,0
2025-08-04,2375,8,0,27168,9,2338,2339,X ,0,0,0,27168,0,0,0,-1,0
2025-08-05,2375,102,1,27168,51,2388,2338, ,0,0,0,27168,0,0,0,50,0
2025-08-06,2375,69,15,27168,24,2418,2388, ,1,0,0,27168,0,0,0,30,0
2025-08-07,2375,15,0,27168,14,2419,2418, ,0,0,0,27168,0,0,0,1,0
2025-08-08,2375,11,0,27168,52,2378,2419, ,0,0,0,27168,2,2,0,-41,2
2025-08-11,2375,36,0,27168,2,2412,2378, ,0,0,0,27168,1,3,2,34,1
2025-08-12,2375,50,15,27168,60,2387,2412, ,1,1,0,27168,7,9,3,-25,6
2025-08-13,2375,54,0,27168,87,2354,2387, ,1,0,0,27168,27,36,9,-33,27
2025-08-14,2375,63,0,27168,16,2401,2354, ,0,28,0,27168,1,9,36,47,-27
2025-08-15,2375,13,10,27168,21,2383,2401, ,0,2,0,27168,0,7,9,-18,-2
2025-08-18,2375,15,2,27168,28,2368,2383, ,0,0,0,27168,0,7,7,-15,0
2025-08-19,2375,11,2,27168,37,2340,2368, ,0,1,0,27168,0,6,7,-28,-1
2025-08-20,2375,23,8,27168,37,2318,2340, ,0,1,0,27168,1,6,6,-22,0
2025-08-21,2375,33,0,27168,16,2335,2318, ,0,1,0,27168,0,5,6,17,-1
2025-08-22,2375,20,9,27168,29,2317,2335, ,0,1,0,27168,0,4,5,-18,-1
2025-08-25,2375,53,23,27168,106,2241,2317, ,0,0,0,27168,0,4,4,-76,0
2025-08-26,2375,7,0,27168,23,2225,2241, ,0,0,0,27168,0,4,4,-16,0
2025-08-27,2375,31,0,27168,23,2233,2225, ,0,0,0,27168,1,5,4,8,1
2025-08-28,2375,18,0,27168,51,2200,2233, ,0,0,0,27168,0,5,5,-33,0
2025-08-29,2375,17,5,27168,31,2181,2200, ,0,0,0,27168,0,5,5,-19,0
2025-09-01,2375,16,2,27168,29,2166,2181, ,0,0,0,27168,2,7,5,-15,2
2025-09-02,2375,21,0,27168,3,2184,2166, ,0,2,0,27168,0,5,7,18,-2
2025-09-03,2375,5,1,27168,14,2174,2184, ,0,0,0,27168,0,5,5,-10,0
2025-09-04,2375,1,0,27168,12,2163,2174, ,0,0,0,27168,0,5,5,-11,0
2025-09-05,2375,1,0,27168,7,2157,2163, ,0,0,0,27168,0,5,5,-6,0
2025-09-08,2375,9,8,27168,7,2151,2157, ,0,0,0,27168,0,5,5,-6,0
2025-09-09,2375,6,0,27168,16,2141,2151, ,0,0,0,27168,0,5,5,-10,0
2025-09-10,2375,34,0,27168,14,2161,2141, ,0,0,0,27168,0,5,5,20,0
2025-09-11,2375,18,0,27168,20,2159,2161, ,0,0,0,27168,0,5,5,-2,0
2025-09-12,2375,319,2,27168,199,2277,2159, ,1,0,0,27168,14,19,5,118,14
2025-09-15,2375,362,0,27168,254,2385,2277, ,4,13,0,27168,6,12,19,108,-7
2025-09-16,2375,58,0,27168,50,2393,2385, ,1,3,0,27168,5,14,12,8,2
2025-09-17,2375,645,0,27168,328,2710,2393, ,5,1,1,27168,17,29,14,317,15
2025-09-18,2375,1138,0,27168,668,3180,2710, ,27,4,0,27168,26,51,29,470,22
2025-09-19,2375,1617,0,27168,1130,3667,3180, ,27,21,0,27168,93,123,51,487,72
2025-09-22,2375,1549,0,27168,1486,3730,3667, ,38,25,0,27168,15,113,123,63,-10
2025-09-23,2375,753,0,27168,786,3697,3730, ,12,37,2,27168,110,184,113,-33,71
2025-06-25,2431,8,0,27731,5,4202,4199, ,0,0,0,27731,2,17,15,3,2
2025-06-26,2431,9,253,27731,22,3936,4202, ,0,0,0,27731,0,17,17,-266,0
2025-06-27,2431,2,0,27731,3,3935,3936, ,0,0,0,27731,0,17,17,-1,0
2025-06-30,2431,157,0,27731,84,4008,3935, ,2,8,0,27731,40,49,17,73,32
2025-07-01,2431,48,0,27731,27,4029,4008, ,5,34,0,27731,2,17,49,21,-32
2025-07-02,2431,4,0,27731,2,4031,4029, ,1,1,0,27731,2,18,17,2,1
2025-07-03,2431,9,0,27731,11,4029,4031, ,1,0,0,27731,0,18,18,-2,0
2025-07-04,2431,55,0,27731,85,3999,4029, ,3,3,0,27731,11,26,18,-30,8
2025-07-07,2431,1,0,27731,2,3998,3999, ,1,5,0,27731,3,24,26,-1,-2
2025-07-08,2431,20,0,27731,0,4018,3998, ,0,13,0,27731,2,13,24,20,-11
2025-07-09,2431,72,0,27731,111,3979,4018, ,0,0,0,27731,9,22,13,-39,9
2025-07-10,2431,44,0,27731,6,4017,3979, ,16,21,0,27731,0,1,22,38,-21
2025-07-11,2431,38,0,27731,3,4052,4017, ,0,0,0,27731,8,9,1,35,8
2025-07-14,2431,47,0,27731,2,4097,4052, ,4,8,0,27731,3,4,9,45,-5
2025-07-15,2431,5,0,27731,8,4094,4097, ,0,0,0,27731,0,4,4,-3,0
2025-07-16,2431,17,0,27731,26,4085,4094, ,1,2,0,27731,0,2,4,-9,-2
2025-07-17,2431,21,0,27731,21,4085,4085, ,0,0,0,27731,1,3,2,0,1
2025-07-18,2431,80,3,27731,135,4027,4085, ,3,0,0,27731,0,3,3,-58,0
2025-07-21,2431,46,16,27731,15,4042,4027, ,0,2,0,27731,2,3,3,15,0
2025-07-22,2431,122,0,27731,25,4139,4042, ,0,2,0,27731,0,1,3,97,-2
2025-07-23,2431,13,0,27731,23,4129,4139, ,0,0,0,27731,4,5,1,-10,4
2025-07-24,2431,38,0,27731,3,4164,4129, ,2,2,0,27731,1,4,5,35,-1
2025-07-25,2431,29,0,27731,5,4188,4164, ,0,1,0,27731,1,4,4,24,0
2025-07-28,2431,41,0,27731,30,4199,4188, ,0,0,0,27731,0,4,4,11,0
2025-07-29,2431,73,0,27731,12,4260,4199, ,6,1,0,27731,42,45,4,61,41
2025-07-30,2431,522,0,27731,166,4616,4260, ,4,41,0,27731,10,14,45,356,-31
2025-07-31,2431,508,0,27731,432,4692,4616, ,15,1,0,27731,45,58,14,76,44
2025-08-01,2431,314,0,27731,478,4528,4692, ,13,16,0,27731,10,52,58,-164,-6
2025-08-04,2431,148,280,27731,151,4245,4528, ,2,6,0,27731,22,68,52,-283,16
2025-08-05,2431,455,0,27731,169,4531,4245, ,13,0,0,27731,0,68,68,286,0
2025-08-06,2431,332,0,27731,235,4628,4531, ,3,0,0,27731,6,74,68,97,6
2025-08-07,2431,353,0,27731,256,4725,4628, ,8,3,0,27731,1,72,74,97,-2
2025-08-08,2431,146,0,27731,74,4797,4725, ,2,6,0,27731,4,70,72,72,-2
2025-08-11,2431,51,1,27731,82,4765,4797, ,0,32,0,27731,41,79,70,-32,9
2025-08-12,2431,60,0,27731,22,4803,4765, ,1,1,0,27731,0,78,79,38,-1
2025-08-13,2431,135,0,27731,172,4766,4803, ,5,48,0,27731,1,31,78,-37,-47
2025-08-14,2431,111,0,27731,112,4765,4766, ,6,0,0,27731,1,32,31,-1,1
2025-08-15,2431,106,0,27731,114,4757,4765, ,2,2,0,27731,0,30,32,-8,-2
2025-08-18,2431,89,8,27731,157,4681,4757, ,4,0,0,27731,2,32,30,-76,2
2025-08-19,2431,75,0,27731,43,4713,4681, ,4,2,0,27731,0,30,32,32,-2
2025-08-20,2431,23,0,27731,56,4680,4713, ,0,0,0,27731,2,32,30,-33,2
2025-08-21,2431,104,0,27731,161,4623,4680, ,2,1,0,27731,2,33,32,-57,1
2025-08-22,2431,181,0,27731,164,4640,4623, ,3,0,0,27731,0,33,33,17,0
2025-08-25,2431,87,1,27731,201,4525,4640, ,2,0,0,27731,2,35,33,-115,2
2025-08-26,2431,98,0,27731,82,4541,4525, ,0,1,0,27731,1,35,35,16,0
2025-08-27,2431,26,0,27731,115,4452,4541, ,0,4,0,27731,0,31,35,-89,-4
2025-08-28,2431,22,1,27731,28,4445,4452, ,1,3,0,27731,0,28,31,-7,-3
2025-08-29,2431,69,2,27731,73,4439,4445, ,0,0,0,27731,4,32,28,-6,4
2025-09-01,2431,218,0,27731,122,4535,4439, ,3,2,0,27731,2,32,32,96,0
2025-09-02,2431,180,0,27731,34,4681,4535, ,2,1,0,27731,0,31,32,146,-1
2025-09-03,2431,31,30,27731,48,4634,4681, ,1,0,0,27731,0,31,31,-47,0
2025-09-04,2431,61,0,27731,93,4602,4634, ,1,0,0,27731,0,31,31,-32,0
2025-09-05,2431,64,7,27731,51,4608,4602, ,0,0,0,27731,1,32,31,6,1
2025-09-08,2431,47,0,27731,21,4634,4608, ,1,1,0,27731,1,32,32,26,0
2025-09-09,2431,33,0,27731,72,4595,4634, ,1,0,0,27731,0,32,32,-39,0
2025-09-10,2431,712,0,27731,302,5005,4595, ,11,0,0,27731,44,76,32,410,44
2025-09-11,2431,1349,0,27731,876,5478,5005, ,23,14,0,27731,69,131,76,473,55
2025-09-12,2431,392,0,27731,636,5234,5478, ,28,69,0,27731,7,69,131,-244,-62
2025-09-15,2431,346,0,27731,596,4984,5234, ,2,25,0,27731,1,45,69,-250,-24
2025-09-16,2431,296,0,27731,174,5106,4984, ,2,5,0,27731,0,40,45,122,-5
2025-09-17,2431,182,0,27731,370,4918,5106, ,0,5,0,27731,2,37,40,-188,-3
2025-09-18,2431,225,0,27731,227,4916,4918, ,0,2,0,27731,0,35,37,-2,-2
2025-09-19,2431,115,0,27731,237,4794,4916, ,0,1,0,27731,0,34,35,-122,-1
2025-09-22,2431,140,0,27731,81,4853,4794, ,4,3,0,27731,1,32,34,59,-2
2025-09-23,2431,959,425,27731,625,4762,4853, ,10,1,0,27731,43,74,32,-91,42
2025-06-25,2492,9,2,121451,47,5834,5874, ,0,0,0,121451,0,14,14,-40,0
2025-06-26,2492,12,2,121451,79,5765,5834, ,0,0,0,121451,0,14,14,-69,0
2025-06-27,2492,54,8,121451,87,5724,5765, ,0,4,0,121451,3,13,14,-41,-1
2025-06-30,2492,40,0,121451,202,5562,5724, ,0,3,0,121451,0,10,13,-162,-3
2025-07-01,2492,14,10,121451,38,5528,5562, ,0,0,0,121451,0,10,10,-34,0
2025-07-02,2492,23,0,121451,27,5524,5528,X ,0,2,0,121451,0,8,10,-4,-2
2025-07-03,2492,54,0,121451,124,5454,5524,X ,0,8,0,121451,0,0,8,-70,-8
2025-07-04,2492,39,4,121451,40,5449,5454,X ,0,0,0,121451,0,0,0,-5,0
2025-07-07,2492,7,1,121451,9,5446,5449,X ,0,0,0,121451,0,0,0,-3,0
2025-07-08,2492,78,0,121451,12,5512,5446, ,0,0,0,121451,0,0,0,66,0
2025-07-09,2492,36,2,121451,36,5510,5512, ,0,0,0,121451,3,3,0,-2,3
2025-07-10,2492,9,2,121451,8,5509,5510, ,0,0,0,121451,3,6,3,-1,3
2025-07-11,2492,4,30,121451,36,5447,5509, ,0,0,0,121451,7,13,6,-62,7
2025-07-14,2492,75,0,121451,6,5516,5447, ,0,0,0,121451,1,14,13,69,1
2025-07-15,2492,37,0,121451,93,5460,5516, ,0,1,0,121451,1,14,14,-56,0
2025-07-16,2492,136,9,121451,127,5460,5460, ,0,1,0,121451,3,16,14,0,2
2025-07-17,2492,142,13,121451,80,5509,5460, ,0,0,0,121451,6,22,16,49,6
2025-07-18,2492,79,4,121451,47,5537,5509, ,0,1,0,121451,3,24,22,28,2
2025-07-21,2492,360,4,121451,111,5782,5537, ,0,1,1,121451,16,38,24,245,14
2025-07-22,2492,236,5,121451,385,5628,5782, ,4,16,0,121451,7,29,38,-154,-9
2025-07-23,2492,40,9,121451,61,5598,5628, ,0,1,0,121451,13,41,29,-30,12
2025-07-24,2492,74,0,121451,34,5638,5598, ,0,10,0,121451,0,31,41,40,-10
2025-07-25,2492,54,1,121451,68,5623,5638, ,0,3,0,121451,0,28,31,-15,-3
2025-07-28,2492,77,1,121451,92,5607,5623, ,0,0,0,121451,3,31,28,-16,3
2025-07-29,2492,146,4,121451,121,5628,5607, ,0,4,0,121451,1,28,31,21,-3
2025-07-30,2492,33,22,121451,53,5586,5628, ,0,2,0,121451,1,27,28,-42,-1
2025-07-31,2492,19,21,121451,81,5503,5586, ,0,9,0,121451,3,21,27,-83,-6
2025-08-01,2492,37,0,121451,73,5467,5503, ,0,4,6,121451,11,22,21,-36,1
2025-08-04,2492,29,2,121451,17,5477,5467, ,0,2,0,121451,3,23,22,10,1
2025-08-05,2492,88,0,121451,83,5482,5477, ,0,3,0,121451,7,27,23,5,4
2025-08-06,2492,36,55,121451,41,5422,5482, ,0,3,0,121451,22,46,27,-60,19
2025-08-07,2492,83,9,121451,32,5464,5422, ,0,1,0,121451,60,105,46,42,59
2025-08-08,2492,318,6,121451,77,5699,5464, ,3,91,0,121451,51,65,105,235,-40
2025-08-11,2492,57,0,121451,34,5722,5699, ,0,8,0,121451,14,71,65,23,6
2025-08-12,2492,122,33,121451,21,5790,5722, ,0,0,0,121451,1,72,71,68,1
2025-08-13,2492,28,1,121451,102,5715,5790, ,0,0,0,121451,0,72,72,-75,0
2025-08-14,2492,43,5,121451,31,5722,5715, ,0,5,0,121451,0,67,72,7,-5
2025-08-15,2492,140,0,121451,28,5834,5722, ,0,1,0,121451,2,68,67,112,1
2025-08-18,2492,53,1,121451,147,5739,5834, ,0,1,0,121451,0,67,68,-95,-1
2025-08-19,2492,35,2,121451,52,5720,5739, ,0,0,0,121451,0,67,67,-19,0
2025-08-20,2492,67,1,121451,44,5742,5720, ,0,2,0,121451,0,65,67,22,-2
2025-08-21,2492,27,2,121451,57,5710,5742, ,0,0,0,121451,4,69,65,-32,4
2025-08-22,2492,65,21,121451,54,5700,5710, ,0,1,0,121451,1,69,69,-10,0
2025-08-25,2492,137,2,121451,55,5780,5700, ,0,1,0,121451,1,69,69,80,0
2025-08-26,2492,23,5,121451,19,5779,5780, ,0,0,0,121451,1,70,69,-1,1
2025-08-27,2492,17,0,121451,12,5784,5779, ,0,2,0,121451,0,68,70,5,-2
2025-08-28,2492,80,47,121451,42,5775,5784, ,0,0,0,121451,1,69,68,-9,1
2025-08-29,2492,18,0,121451,29,5764,5775, ,0,0,0,121451,0,69,69,-11,0
2025-09-01,2492,174,6,121451,23,5909,5764, ,2,0,0,121451,54,123,69,145,54
2025-09-02,2492,29,0,121451,19,5919,5909, ,0,5,0,121451,5,123,123,10,0
2025-09-03,2492,81,21,121451,39,5940,5919, ,0,5,0,121451,0,118,123,21,-5
2025-09-04,2492,64,3,121451,90,5911,5940, ,0,2,0,121451,2,118,118,-29,0
2025-09-05,2492,62,1,121451,37,5935,5911, ,0,41,0,121451,5,82,118,24,-36
2025-09-08,2492,14,4,121451,93,5852,5935, ,0,4,0,121451,1,79,82,-83,-3
2025-09-09,2492,27,6,121451,22,5851,5852, ,0,0,0,121451,2,81,79,-1,2
2025-09-10,2492,33,0,121451,43,5841,5851, ,0,0,0,121451,0,81,81,-10,0
2025-09-11,2492,119,3,121451,51,5906,5841, ,0,8,0,121451,1,74,81,65,-7
2025-09-12,2492,516,2,121451,359,6061,5906, ,2,5,0,121451,29,98,74,155,24
2025-09-15,2492,198,20,121451,102,6137,6061, ,1,6,0,121451,0,92,98,76,-6
2025-09-16,2492,164,2,121451,133,6166,6137, ,0,0,1,121451,1,92,92,29,0
2025-09-17,2492,355,5,121451,199,6317,6166, ,9,0,0,121451,4,96,92,151,4
2025-09-18,2492,207,3,121451,303,6218,6317, ,2,0,0,121451,11,107,96,-99,11
2025-09-19,2492,807,27,121451,536,6462,6218, ,5,0,1,121451,130,236,107,244,129
2025-09-22,2492,3295,2,121451,924,8831,6462, ,4,11,0,121451,502,727,236,2369,491
2025-09-23,2492,2529,2,121451,3311,8047,8831, ,36,490,2,121451,88,323,727,-784,-404
2025-06-25,2753,71,0,16661,4,3583,3516, ,0,0,0,16661,1,1,0,67,1
2025-06-26,2753,22,0,16661,10,3595,3583, ,0,0,0,16661,0,1,1,12,0
2025-06-27,2753,90,0,16661,50,3635,3595, ,0,0,0,16661,2,3,1,40,2
2025-06-30,2753,7,0,16661,11,3631,3635, ,0,1,0,16661,0,2,3,-4,-1
2025-07-01,2753,25,0,16661,9,3647,3631, ,0,0,0,16661,0,2,2,16,0
2025-07-02,2753,29,0,16661,13,3663,3647, ,0,0,0,16661,1,3,2,16,1
2025-07-03,2753,18,0,16661,17,3664,3663, ,0,0,0,16661,0,3,3,1,0
2025-07-04,2753,23,0,16661,15,3672,3664, ,0,1,0,16661,0,2,3,8,-1
2025-07-07,2753,41,0,16661,21,3692,3672, ,0,0,0,16661,0,2,2,20,0
2025-07-08,2753,79,0,16661,48,3723,3692, ,0,0,0,16661,6,8,2,31,6
2025-07-09,2753,64,0,16661,14,3773,3723, ,0,0,0,16661,1,9,8,50,1
2025-07-10,2753,38,0,16661,16,3795,3773, ,0,4,0,16661,0,5,9,22,-4
2025-07-11,2753,69,0,16661,65,3799,3795, ,0,0,0,16661,1,6,5,4,1
2025-07-14,2753,297,0,16661,137,3959,3799, ,0,0,0,16661,30,36,6,160,30
2025-07-15,2753,146,0,16661,178,3927,3959, ,0,19,0,16661,0,17,36,-32,-19
2025-07-16,2753,65,4,16661,138,3850,3927, ,0,2,0,16661,0,15,17,-77,-2
2025-07-17,2753,88,0,16661,101,3837,3850, ,0,5,0,16661,0,10,15,-13,-5
2025-07-18,2753,45,0,16661,744,3138,3837, ,0,3,0,16661,0,7,10,-699,-3
2025-07-21,2753,150,0,16661,831,2457,3138, ,0,3,0,16661,3,7,7,-681,0
2025-07-22,2753,119,0,16661,27,2549,2457, ,0,0,0,16661,1,8,7,92,1
2025-07-23,2753,16,0,16661,29,2536,2549, ,0,1,0,16661,0,7,8,-13,-1
2025-07-24,2753,28,0,16661,18,2546,2536, ,0,0,0,16661,0,7,7,10,0
2025-07-25,2753,15,0,16661,5,2556,2546, ,0,0,0,16661,3,10,7,10,3
2025-07-28,2753,161,3,16661,13,2701,2556, ,0,0,0,16661,0,10,10,145,0
2025-07-29,2753,59,0,16661,21,2739,2701, ,0,0,3,16661,0,7,10,38,-3
2025-07-30,2753,17,0,16661,1,2755,2739, ,0,0,0,16661,0,7,7,16,0
2025-07-31,2753,65,0,16661,76,2744,2755, ,0,1,0,16661,1,7,7,-11,0
2025-08-01,2753,78,0,16661,31,2791,2744, ,0,0,0,16661,1,8,7,47,1
2025-08-04,2753,35,0,16661,359,2467,2791, ,0,1,0,16661,0,7,8,-324,-1
2025-08-05,2753,8,0,16661,2,2473,2467, ,0,0,0,16661,1,8,7,6,1
2025-08-06,2753,21,0,16661,7,2487,2473, ,0,0,0,16661,1,9,8,14,1
2025-08-07,2753,8,0,16661,24,2471,2487, ,0,0,0,16661,0,9,9,-16,0
2025-08-08,2753,16,0,16661,25,2462,2471, ,0,0,0,16661,0,9,9,-9,0
2025-08-11,2753,68,0,16661,137,2393,2462, ,0,2,0,16661,0,7,9,-69,-2
2025-08-12,2753,54,0,16661,36,2411,2393, ,0,0,0,16661,0,7,7,18,0
2025-08-13,2753,234,0,16661,177,2468,2411, ,4,1,0,16661,4,10,7,57,3
2025-08-14,2753,168,0,16661,338,2298,2468, ,0,4,0,16661,0,6,10,-170,-4
2025-08-15,2753,65,0,16661,88,2275,2298, ,0,0,0,16661,0,6,6,-23,0
2025-08-18,2753,111,0,16661,277,2109,2275, ,0,0,0,16661,0,6,6,-166,0
2025-08-19,2753,37,0,16661,348,1798,2109, ,0,0,0,16661,0,6,6,-311,0
2025-08-20,2753,52,0,16661,38,1812,1798, ,0,0,0,16661,0,6,6,14,0
2025-08-21,2753,74,0,16661,344,1542,1812, ,0,0,0,16661,0,6,6,-270,0
2025-08-22,2753,22,0,16661,78,1486,1542, ,0,0,0,16661,0,6,6,-56,0
2025-08-25,2753,94,0,16661,189,1391,1486, ,27,0,0,16661,2,8,6,-95,2
2025-08-26,2753,82,0,16661,43,1430,1391, ,0,1,0,16661,1,8,8,39,0
2025-08-27,2753,4,0,16661,4,1430,1430, ,0,0,0,16661,1,9,8,0,1
2025-08-28,2753,6,1,16661,44,1391,1430, ,0,0,0,16661,0,9,9,-39,0
2025-08-29,2753,4,0,16661,20,1375,1391, ,0,0,0,16661,0,9,9,-16,0
2025-09-01,2753,75,0,16661,172,1278,1375, ,0,1,0,16661,0,8,9,-97,-1
2025-09-02,2753,9,0,16661,17,1270,1278, ,0,0,0,16661,1,9,8,-8,1
2025-09-03,2753,330,0,16661,118,1482,1270, ,1,2,0,16661,1,8,9,212,-1
2025-09-04,2753,106,0,16661,50,1538,1482, ,2,0,0,16661,0,8,8,56,0
2025-09-05,2753,69,0,16661,61,1546,1538, ,0,0,0,16661,1,9,8,8,1
2025-09-08,2753,5,0,16661,37,1514,1546, ,0,0,0,16661,0,9,9,-32,0
2025-09-09,2753,29,0,16661,8,1535,1514, ,0,2,0,16661,0,7,9,21,-2
2025-09-10,2753,22,0,16661,9,1548,1535, ,0,0,0,16661,0,7,7,13,0
2025-09-11,2753,84,0,16661,79,1553,1548, ,0,0,0,16661,3,10,7,5,3
2025-09-12,2753,74,0,16661,91,1536,1553, ,0,0,0,16661,2,12,10,-17,2
2025-09-15,2753,52,0,16661,38,1550,1536, ,0,0,0,16661,1,13,12,14,1
2025-09-16,2753,40,0,16661,20,1570,1550, ,0,6,0,16661,1,8,13,20,-5
2025-09-17,2753,2,0,16661,9,1563,1570, ,0,0,0,16661,0,8,8,-7,0
2025-09-18,2753,4,0,16661,23,1544,1563, ,0,0,0,16661,0,8,8,-19,0
2025-09-19,2753,3,0,16661,56,1491,1544, ,0,0,0,16661,0,8,8,-53,0
2025-09-22,2753,59,0,16661,23,1527,1491, ,0,0,0,16661,0,8,8,36,0
2025-09-23,2753,61,0,16661,17,1571,1527, ,0,0,0,16661,0,8,8,44,0
2025-06-25,2812,10,23,1379689,8,3287,3308, ,0,1,0,1379689,0,16,17,-21,-1
2025-06-26,2812,22,0,1379689,42,3267,3287, ,0,5,0,1379689,10,21,16,-20,5
2025-06-27,2812,201,0,1379689,49,3419,3267, ,0,0,0,1379689,9,30,21,152,9
2025-06-30,2812,27,0,1379689,125,3321,3419, ,0,0,0,1379689,26,56,30,-98,26
2025-07-01,2812,66,0,1379689,11,3376,3321, ,0,4,0,1379689,0,52,56,55,-4
2025-07-02,2812,23,0,1379689,36,3363,3376, ,0,1,0,1379689,53,104,52,-13,52
2025-07-03,2812,135,0,1379689,238,3260,3363, ,0,0,0,1379689,2,106,104,-103,2
2025-07-04,2812,156,1,1379689,114,3301,3260, ,0,0,0,1379689,10,116,106,41,10
2025-07-07,2812,84,0,1379689,3,3382,3301, ,10,0,0,1379689,18,134,116,81,18
2025-07-08,2812,7,1,1379689,101,3287,3382, ,0,0,0,1379689,0,134,134,-95,0
2025-07-09,2812,30,77,1379689,32,3208,3287, ,0,10,0,1379689,0,124,134,-79,-10
2025-07-10,2812,34,0,1379689,25,3217,3208, ,0,15,0,1379689,13,122,124,9,-2
2025-07-11,2812,142,0,1379689,46,3313,3217, ,0,1,0,1379689,0,121,122,96,-1
2025-07-14,2812,60,0,1379689,152,3221,3313, ,0,1,0,1379689,0,120,121,-92,-1
2025-07-15,2812,42,0,1379689,1,3262,3221, ,0,50,0,1379689,0,70,120,41,-50
2025-07-16,2812,72,1,1379689,2,3331,3262, ,0,0,0,1379689,0,70,70,69,0
2025-07-17,2812,11,0,1379689,16,3326,3331, ,0,0,0,1379689,0,70,70,-5,0
2025-07-18,2812,3,0,1379689,21,3308,3326, ,0,10,0,1379689,0,60,70,-18,-10
2025-07-21,2812,17,0,1379689,12,3313,3308, ,0,0,0,1379689,0,60,60,5,0
2025-07-22,2812,72,0,1379689,140,3245,3313, ,0,0,0,1379689,2,62,60,-68,2
2025-07-23,2812,140,0,1379689,8,3377,3245, ,0,0,0,1379689,0,62,62,132,0
2025-07-24,2812,7,0,1379689,0,3384,3377, ,0,1,0,1379689,0,61,62,7,-1
2025-07-25,2812,9,0,1379689,9,3384,3384, ,0,0,0,1379689,0,61,61,0,0
2025-07-28,2812,25,0,1379689,9,3400,3384, ,0,0,0,1379689,0,61,61,16,0
2025-07-29,2812,89,1,1379689,21,3467,3400, ,0,0,0,1379689,0,61,61,67,0
2025-07-30,2812,470,0,1379689,27,3910,3467, ,0,1,0,1379689,1,61,61,443,0
2025-07-31,2812,225,0,1379689,72,4063,3910, ,0,2,0,1379689,0,59,61,153,-2
2025-08-01,2812,106,0,1379689,215,3954,4063, ,5,0,2,1379689,2,59,59,-109,0
2025-08-04,2812,135,0,1379689,28,4061,3954, ,2,0,0,1379689,0,59,59,107,0
2025-08-05,2812,147,0,1379689,129,4079,4061, ,2,0,0,1379689,2,61,59,18,2
2025-08-06,2812,352,0,1379689,41,4390,4079,X ,0,2,0,1379689,0,59,61,311,-2
2025-08-07,2812,261,0,1379689,421,4230,4390,X ,0,59,0,1379689,0,0,59,-160,-59
2025-08-08,2812,182,0,1379689,89,4323,4230,X ,0,0,0,1379689,0,0,0,93,0
2025-08-11,2812,331,0,1379689,251,4403,4323,X ,0,0,0,1379689,0,0,0,80,0
2025-08-12,2812,502,37,1379689,57,4811,4403, ,0,0,0,1379689,0,0,0,408,0
2025-08-13,2812,173,18,1379689,836,4130,4811, ,150,0,0,1379689,37,37,0,-681,37
2025-08-14,2812,97,1,1379689,188,4038,4130, ,42,20,0,1379689,1,18,37,-92,-19
2025-08-15,2812,56,0,1379689,110,3984,4038, ,0,0,0,1379689,1,19,18,-54,1
2025-08-18,2812,61,0,1379689,46,3999,3984, ,0,2,0,1379689,0,17,19,15,-2
2025-08-19,2812,292,0,1379689,53,4238,3999, ,0,0,0,1379689,0,17,17,239,0
2025-08-20,2812,271,1,1379689,39,4469,4238, ,0,0,0,1379689,0,17,17,231,0
2025-08-21,2812,232,0,1379689,72,4629,4469, ,0,0,0,1379689,0,17,17,160,0
2025-08-22,2812,218,0,1379689,3,4844,4629, ,0,0,0,1379689,0,17,17,215,0
2025-08-25,2812,117,0,1379689,26,4935,4844, ,0,0,0,1379689,0,17,17,91,0
2025-08-26,2812,119,0,1379689,23,5031,4935, ,0,0,0,1379689,0,17,17,96,0
2025-08-27,2812,174,0,1379689,5,5200,5031, ,0,0,0,1379689,3,20,17,169,3
2025-08-28,2812,2,0,1379689,5,5197,5200, ,0,0,0,1379689,0,20,20,-3,0
2025-08-29,2812,193,1,1379689,69,5320,5197, ,0,0,0,1379689,0,20,20,123,0
2025-09-01,2812,7,0,1379689,14,5313,5320, ,0,0,0,1379689,0,20,20,-7,0
2025-09-02,2812,18,1,1379689,37,5293,5313, ,0,0,0,1379689,0,20,20,-20,0
2025-09-03,2812,105,0,1379689,317,5081,5293, ,0,0,0,1379689,0,20,20,-212,0
2025-09-04,2812,10,0,1379689,44,5047,5081, ,0,0,0,1379689,0,20,20,-34,0
2025-09-05,2812,27,0,1379689,7,5067,5047, ,0,0,0,1379689,0,20,20,20,0
2025-09-08,2812,231,0,1379689,14,5284,5067, ,0,10,0,1379689,0,10,20,217,-10
2025-09-09,2812,20,0,1379689,18,5286,5284, ,0,0,0,1379689,0,10,10,2,0
2025-09-10,2812,4,0,1379689,116,5174,5286, ,0,0,0,1379689,0,10,10,-112,0
2025-09-11,2812,184,0,1379689,368,4990,5174, ,0,0,0,1379689,0,10,10,-184,0
2025-09-12,2812,184,0,1379689,51,5123,4990, ,0,0,0,1379689,25,35,10,133,25
2025-09-15,2812,11,0,1379689,55,5079,5123, ,0,0,0,1379689,20,55,35,-44,20
2025-09-16,2812,48,0,1480406,39,5088,5079, ,0,0,0,1480406,0,55,55,9,0
2025-09-17,2812,84,1,1480406,19,5152,5088, ,0,40,3,1480406,0,12,55,64,-43
2025-09-18,2812,16,0,1480406,79,5089,5152, ,0,5,0,1480406,0,7,12,-63,-5
2025-09-19,2812,219,0,1480406,93,5215,5089, ,0,0,0,1480406,0,7,7,126,0
2025-09-22,2812,88,1,1480406,32,5270,5215, ,0,0,0,1480406,0,7,7,55,0
2025-09-23,2812,71,0,1480406,180,5161,5270, ,0,0,0,1480406,15,22,7,-109,15
2025-06-25,2832,11,0,90550,21,1298,1308, ,0,0,0,90550,0,0,0,-10,0
2025-06-26,2832,4,0,90550,81,1221,1298, ,0,0,0,90550,0,0,0,-77,0
2025-06-27,2832,25,0,90550,5,1241,1221, ,0,0,0,90550,0,0,0,20,0
2025-06-30,2832,0,0,90550,2,1239,1241, ,0,0,0,90550,0,0,0,-2,0
2025-07-01,2832,0,0,90550,6,1233,1239, ,0,0,0,90550,5,5,0,-6,5
2025-07-02,2832,10,0,90550,43,1200,1233, ,0,0,0,90550,0,5,5,-33,0
2025-07-03,2832,36,0,90550,109,1127,1200, ,0,0,0,90550,3,8,5,-73,3
2025-07-04,2832,7,0,90550,8,1126,1127, ,0,0,0,90550,5,13,8,-1,5
2025-07-07,2832,14,0,90550,16,1124,1126, ,0,0,0,90550,0,13,13,-2,0
2025-07-08,2832,0,0,90550,14,1110,1124, ,0,0,0,90550,0,13,13,-14,0
2025-07-09,2832,119,0,90550,1,1228,1110, ,0,0,0,90550,0,13,13,118,0
2025-07-10,2832,84,0,90550,11,1301,1228, ,0,1,0,90550,0,12,13,73,-1
2025-07-11,2832,8,0,90550,34,1275,1301, ,2,2,0,90550,0,10,12,-26,-2
2025-07-14,2832,1,0,90550,0,1276,1275, ,0,0,0,90550,0,10,10,1,0
2025-07-15,2832,4,0,90550,96,1184,1276, ,0,0,0,90550,0,10,10,-92,0
2025-07-16,2832,6,0,90550,150,1040,1184, ,0,0,0,90550,6,16,10,-144,6
2025-07-17,2832,11,0,90550,20,1031,1040, ,0,0,0,90550,0,16,16,-9,0
2025-07-18,2832,6,0,90550,10,1027,1031, ,0,6,0,90550,1,11,16,-4,-5
2025-07-21,2832,4,0,90550,12,1019,1027, ,0,0,0,90550,0,11,11,-8,0
2025-07-22,2832,10,0,90550,7,1022,1019, ,0,0,0,90550,0,11,11,3,0
2025-07-23,2832,1,0,90550,30,993,1022, ,0,2,0,90550,1,10,11,-29,-1
2025-07-24,2832,0,0,90550,8,985,993, ,0,0,0,90550,0,10,10,-8,0
2025-07-25,2832,0,0,90550,10,975,985, ,0,0,0,90550,0,10,10,-10,0
2025-07-28,2832,11,0,90550,0,986,975, ,0,1,0,90550,0,9,10,11,-1
2025-07-29,2832,8,29,90550,5,960,986, ,0,0,0,90550,0,9,9,-26,0
2025-07-30,2832,5,13,90550,5,947,960, ,0,0,0,90550,3,12,9,-13,3
2025-07-31,2832,27,0,90550,41,933,947, ,0,4,0,90550,1,9,12,-14,-3
2025-08-01,2832,29,0,90550,8,954,933, ,0,0,0,90550,0,9,9,21,0
2025-08-04,2832,16,0,90550,20,950,954, ,0,0,0,90550,0,9,9,-4,0
2025-08-05,2832,21,0,90550,6,965,950, ,0,0,0,90550,2,11,9,15,2
2025-08-06,2832,22,0,90550,6,981,965, ,0,0,0,90550,0,11,11,16,0
2025-08-07,2832,16,0,90550,4,993,981, ,1,0,0,90550,1,12,11,12,1
2025-08-08,2832,3,0,90550,96,900,993, ,0,0,0,90550,1,13,12,-93,1
2025-08-11,2832,29,0,90550,44,885,900, ,0,0,0,90550,0,13,13,-15,0
2025-08-12,2832,2,0,90550,25,862,885, ,0,1,0,90550,0,12,13,-23,-1
2025-08-13,2832,1,0,90550,0,863,862, ,0,0,0,90550,0,12,12,1,0
2025-08-14,2832,30,0,90550,24,869,863, ,0,0,0,90550,1,13,12,6,1
2025-08-15,2832,32,0,90550,25,876,869, ,0,0,0,90550,0,13,13,7,0
2025-08-18,2832,1,0,90550,13,864,876, ,0,0,0,90550,0,13,13,-12,0
2025-08-19,2832,11,0,90550,10,865,864, ,0,2,0,90550,0,11,13,1,-2
2025-08-20,2832,1,0,90550,24,842,865, ,0,0,0,90550,0,11,11,-23,0
2025-08-21,2832,21,0,90550,8,855,842, ,0,0,0,90550,0,11,11,13,0
2025-08-22,2832,0,0,90550,5,850,855, ,0,0,0,90550,0,11,11,-5,0
2025-08-25,2832,6,0,90550,1,855,850, ,0,0,0,90550,0,11,11,5,0
2025-08-26,2832,3,0,90550,36,822,855, ,0,0,0,90550,0,11,11,-33,0
2025-08-27,2832,2,0,90550,4,820,822, ,0,0,0,90550,0,11,11,-2,0
2025-08-28,2832,10,0,90550,26,804,820, ,0,0,0,90550,0,11,11,-16,0
2025-08-29,2832,4,0,90550,3,805,804, ,0,0,0,90550,0,11,11,1,0
2025-09-01,2832,3,0,90550,10,798,805, ,0,0,0,90550,0,11,11,-7,0
2025-09-02,2832,4,0,90550,1,801,798, ,0,0,0,90550,0,11,11,3,0
2025-09-03,2832,0,0,90550,4,797,801, ,0,0,0,90550,0,11,11,-4,0
2025-09-04,2832,8,0,90550,0,805,797, ,0,0,0,90550,0,11,11,8,0
2025-09-05,2832,1,0,90550,6,800,805, ,0,0,0,90550,0,11,11,-5,0
2025-09-08,2832,4,0,90550,5,799,800, ,0,0,0,90550,0,11,11,-1,0
2025-09-09,2832,4,0,90550,0,803,799, ,0,0,0,90550,0,11,11,4,0
2025-09-10,2832,12,0,90550,19,796,803, ,0,0,0,90550,0,11,11,-7,0
2025-09-11,2832,37,0,90550,27,806,796, ,0,0,0,90550,0,11,11,10,0
2025-09-12,2832,7,0,90550,1,812,806, ,0,0,0,90550,0,11,11,6,0
2025-09-15,2832,9,0,90550,13,808,812, ,0,0,0,90550,0,11,11,-4,0
2025-09-16,2832,6,0,90550,6,808,808, ,0,3,0,90550,0,8,11,0,-3
2025-09-17,2832,14,0,90550,0,822,808, ,0,0,0,90550,0,8,8,14,0
2025-09-18,2832,5,0,90550,13,814,822, ,0,0,0,90550,0,8,8,-8,0
2025-09-19,2832,5,0,90550,22,797,814, ,0,0,0,90550,0,8,8,-17,0
2025-09-22,2832,23,0,90550,7,813,797, ,0,0,0,90550,0,8,8,16,0
2025-09-23,2832,4,0,90550,8,809,813, ,0,0,0,90550,0,8,8,-4,0
2025-06-25,2855,17,200,363957,10,3800,3993, ,0,11,0,363957,0,24,35,-193,-11
2025-06-26,2855,40,45,363957,15,3780,3800, ,0,9,0,363957,0,15,24,-20,-9
2025-06-27,2855,35,0,363957,30,3785,3780, ,0,11,0,363957,0,4,15,5,-11
2025-06-30,2855,60,0,363957,9,3836,3785, ,0,0,0,363957,0,4,4,51,0
2025-07-01,2855,137,0,363957,124,3849,3836,X ,0,4,0,363957,0,0,4,13,-4
2025-07-02,2855,67,0,363957,201,3715,3849,X ,0,0,0,363957,0,0,0,-134,0
2025-07-03,2855,60,0,363957,72,3703,3715,X ,0,0,0,363957,0,0,0,-12,0
2025-07-04,2855,290,1,363957,23,3969,3703,X ,0,0,0,363957,0,0,0,266,0
2025-07-07,2855,212,0,363957,114,4067,3969, ,0,0,0,363957,0,0,0,98,0
2025-07-08,2855,79,0,363957,68,4078,4067, ,26,0,0,363957,121,121,0,11,121
2025-07-09,2855,126,0,363957,100,4104,4078, ,48,71,0,363957,28,78,121,26,-43
2025-07-10,2855,7,0,363957,90,4021,4104, ,0,54,0,363957,2,26,78,-83,-52
2025-07-11,2855,23,1,363957,65,3978,4021, ,2,3,0,363957,1,24,26,-43,-2
2025-07-14,2855,31,0,363957,0,4009,3978, ,0,4,0,363957,5,25,24,31,1
2025-07-15,2855,11,0,363957,30,3990,4009, ,0,9,0,363957,17,33,25,-19,8
2025-07-16,2855,2,0,363957,38,3954,3990, ,0,14,0,363957,1,20,33,-36,-13
2025-07-17,2855,368,1,363957,12,4309,3954, ,0,2,0,363957,6,24,20,355,4
2025-07-18,2855,0,2,363957,24,4283,4309, ,0,0,0,363957,0,24,24,-26,0
2025-07-21,2855,1,0,363957,10,4274,4283, ,0,1,0,363957,0,23,24,-9,-1
2025-07-22,2855,9,0,363957,13,4270,4274, ,0,1,0,363957,0,22,23,-4,-1
2025-07-23,2855,0,0,363957,1,4269,4270, ,0,0,0,363957,1,23,22,-1,1
2025-07-24,2855,2,0,363957,6,4265,4269, ,0,0,0,363957,0,23,23,-4,0
2025-07-25,2855,45,0,363957,2,4308,4265, ,0,0,0,363957,0,23,23,43,0
2025-07-28,2855,5,1,363957,53,4259,4308, ,0,0,0,363957,0,23,23,-49,0
2025-07-29,2855,6,0,363957,42,4223,4259, ,0,1,0,363957,0,22,23,-36,-1
2025-07-30,2855,62,0,363957,42,4243,4223, ,0,0,0,363957,2,24,22,20,2
2025-07-31,2855,15,1,363957,0,4257,4243, ,0,0,0,363957,0,24,24,14,0
2025-08-01,2855,6,0,363957,21,4242,4257, ,0,0,0,363957,11,35,24,-15,11
2025-08-04,2855,174,0,363957,23,4393,4242, ,0,7,0,363957,60,88,35,151,53
2025-08-05,2855,36,0,363957,395,4034,4393, ,0,0,0,363957,10,98,88,-359,10
2025-08-06,2855,34,0,363957,157,3911,4034, ,0,0,0,363957,20,118,98,-123,20
2025-08-07,2855,458,4,363957,136,4229,3911, ,0,1,0,363957,0,117,118,318,-1
2025-08-08,2855,64,0,363957,342,3951,4229, ,0,0,0,363957,115,232,117,-278,115
2025-08-11,2855,21,0,400353,23,3949,3951, ,0,0,0,400353,0,232,232,-2,0
2025-08-12,2855,35,0,400353,95,3889,3949, ,0,103,0,400353,20,149,232,-60,-83
2025-08-13,2855,46,5,400353,105,3825,3889, ,0,0,0,400353,0,149,149,-64,0
2025-08-14,2855,147,0,400353,32,3940,3825, ,0,1,0,400353,7,155,149,115,6
2025-08-15,2855,34,0,400353,50,3924,3940, ,0,0,3,400353,5,157,155,-16,2
2025-08-18,2855,123,0,400353,32,4015,3924, ,0,22,0,400353,0,135,157,91,-22
2025-08-19,2855,0,0,400353,112,3903,4015, ,0,0,0,400353,0,135,135,-112,0
2025-08-20,2855,198,0,400353,16,4085,3903, ,0,7,0,400353,0,128,135,182,-7
2025-08-21,2855,7,0,400353,78,4014,4085, ,0,0,0,400353,0,128,128,-71,0
2025-08-22,2855,9,0,400353,19,4004,4014, ,0,5,0,400353,0,123,128,-10,-5
2025-08-25,2855,66,0,400353,49,4021,4004, ,0,8,0,400353,0,115,123,17,-8
2025-08-26,2855,19,0,400353,1,4039,4021, ,0,0,0,400353,0,115,115,18,0
2025-08-27,2855,81,0,400353,8,4112,4039, ,0,0,0,400353,0,115,115,73,0
2025-08-28,2855,10,0,400353,5,4117,4112, ,0,0,0,400353,0,115,115,5,0
2025-08-29,2855,1,41,400353,101,3976,4117, ,0,0,0,400353,0,115,115,-141,0
2025-09-01,2855,7,3,400353,6,3974,3976, ,0,0,0,400353,0,115,115,-2,0
2025-09-02,2855,5,0,400353,27,3952,3974, ,0,0,0,400353,0,115,115,-22,0
2025-09-03,2855,8,0,400353,77,3883,3952, ,0,0,0,400353,0,115,115,-69,0
2025-09-04,2855,203,0,400353,10,4076,3883, ,0,0,0,400353,0,115,115,193,0
2025-09-05,2855,22,8,400353,401,3689,4076, ,0,0,0,400353,6,121,115,-387,6
2025-09-08,2855,137,0,400353,34,3792,3689, ,0,0,0,400353,0,121,121,103,0
2025-09-09,2855,64,0,400353,157,3699,3792, ,0,0,0,400353,0,121,121,-93,0
2025-09-10,2855,103,2,400353,115,3685,3699, ,0,0,0,400353,3,124,121,-14,3
2025-09-11,2855,62,0,400353,92,3655,3685, ,0,0,0,400353,1,125,124,-30,1
2025-09-12,2855,102,5,400353,239,3513,3655, ,0,0,0,400353,0,125,125,-142,0
2025-09-15,2855,25,0,400353,278,3260,3513, ,0,0,0,400353,0,125,125,-253,0
2025-09-16,2855,121,1,400353,146,3234,3260, ,0,0,0,400353,0,125,125,-26,0
2025-09-17,2855,56,0,400353,104,3186,3234, ,0,0,0,400353,0,125,125,-48,0
2025-09-18,2855,80,0,400353,70,3196,3186, ,0,0,0,400353,5,130,125,10,5
2025-09-19,2855,21,0,400353,12,3205,3196, ,0,0,0,400353,2,132,130,9,2
2025-09-22,2855,106,0,400353,27,3284,3205, ,0,0,0,400353,0,132,132,79,0
2025-09-23,2855,74,0,400353,181,3177,3284, ,0,0,0,400353,0,132,132,-107,0
2025-06-25,2885,52,0,3235716,28,1449,1425,X ,0,26,0,3235716,0,14,40,24,-26
2025-06-26,2885,175,0,3235716,5,1619,1449,X ,0,0,14,3235716,0,0,14,170,-14
2025-06-27,2885,97,0,3235716,149,1567,1619,X ,0,0,0,3235716,0,0,0,-52,0
2025-06-30,2885,1016,0,3235716,218,2365,1567, ,0,0,0,3235716,0,0,0,798,0
2025-07-01,2885,112,0,3235716,135,2342,2365, ,26,0,0,3235716,42,42,0,-23,42
2025-07-02,2885,607,0,3235716,14,2935,2342, ,2,2,0,3235716,1,41,42,593,-1
2025-07-03,2885,14,0,3235716,382,2567,2935, ,1,0,0,3235716,0,41,41,-368,0
2025-07-04,2885,597,0,3235716,3,3161,2567, ,0,0,0,3235716,4,45,41,594,4
2025-07-07,2885,297,3,3235716,56,3399,3161, ,0,3,0,3235716,0,42,45,238,-3
2025-07-08,2885,30,1,3235716,170,3258,3399, ,3,1,0,3235716,0,41,42,-141,-1
2025-07-09,2885,935,5,3235716,254,3934,3258, ,0,1,0,3235716,0,40,41,676,-1
2025-07-10,2885,22,0,3235716,89,3867,3934, ,0,0,0,3235716,0,40,40,-67,0
2025-07-11,2885,107,0,3235716,726,3248,3867, ,1,0,0,3235716,3,43,40,-619,3
2025-07-14,2885,68,0,3235716,43,3273,3248, ,0,2,0,3235716,2,43,43,25,0
2025-07-15,2885,58,0,3235716,30,3301,3273, ,0,0,0,3235716,0,43,43,28,0
2025-07-16,2885,16,21,3235716,127,3169,3301, ,0,0,0,3235716,1,44,43,-132,1
2025-07-17,2885,137,1,3235716,16,3289,3169, ,3,4,0,3235716,0,40,44,120,-4
2025-07-18,2885,70,0,3235716,52,3307,3289, ,0,0,0,3235716,0,40,40,18,0
2025-07-21,2885,187,0,3235716,13,3481,3307, ,0,0,0,3235716,0,40,40,174,0
2025-07-22,2885,160,0,3235716,35,3610,3485, ,0,0,0,3235716,20,60,40,125,20
2025-07-23,2885,13,0,3235716,99,3524,3610, ,0,0,0,3235716,0,60,60,-86,0
2025-07-24,2885,85,0,3235716,85,3524,3524, ,5,0,0,3235716,0,60,60,0,0
2025-07-25,2885,84,10,3235716,42,3556,3524, ,0,0,0,3235716,2,62,60,32,2
2025-07-28,2885,47,2,3235716,33,3568,3556, ,3,0,0,3235716,0,62,62,12,0
2025-07-29,2885,246,0,3235716,43,3771,3568, ,0,0,0,3235716,0,62,62,203,0
2025-07-30,2885,29,3,3235716,56,3741,3771, ,0,0,0,3235716,0,62,62,-30,0
2025-07-31,2885,257,36,3235716,11,3951,3741, ,0,0,0,3235716,2,64,62,210,2
2025-08-01,2885,27,3,3235716,588,3387,3951, ,0,1,0,3235716,0,63,64,-564,-1
2025-08-04,2885,15,3,3235716,202,3197,3387, ,0,0,0,3235716,0,63,63,-190,0
2025-08-05,2885,19,11,3235716,258,2947,3197,X ,0,3,0,3235716,0,60,63,-250,-3
2025-08-06,2885,3,4,3235716,337,2609,2947,X ,0,60,0,3235716,0,0,60,-338,-60
2025-08-07,2885,36,0,3235716,88,2557,2609,X ,0,0,0,3235716,0,0,0,-52,0
2025-08-08,2885,111,0,3235716,49,2619,2557,X ,0,0,0,3235716,0,0,0,62,0
2025-08-11,2885,63,0,3235716,304,2378,2619, ,0,0,0,3235716,0,0,0,-241,0
2025-08-12,2885,176,0,3235716,109,2445,2378, ,0,0,0,3235716,0,0,0,67,0
2025-08-13,2885,160,0,3235716,17,2588,2445, ,15,0,0,3235716,0,0,0,143,0
2025-08-14,2885,111,0,3235716,26,2673,2588, ,5,0,0,3235716,0,0,0,85,0
2025-08-15,2885,2,2,3235716,25,2648,2673, ,0,0,0,3235716,0,0,0,-25,0
2025-08-18,2885,22,5,3235716,87,2578,2648, ,0,0,0,3235716,0,0,0,-70,0
2025-08-19,2885,162,14,3235716,45,2681,2578, ,0,0,0,3235716,0,0,0,103,0
2025-08-20,2885,40,1,3235716,27,2693,2681, ,0,0,0,3235716,0,0,0,12,0
2025-08-21,2885,5,0,3235716,141,2557,2693, ,0,0,0,3235716,0,0,0,-136,0
2025-08-22,2885,1,1,3235716,21,2536,2557, ,5,0,0,3235716,0,0,0,-21,0
2025-08-25,2885,37,0,3235716,264,2309,2536, ,0,0,0,3235716,0,0,0,-227,0
2025-08-26,2885,167,0,3235716,10,2466,2309, ,0,0,0,3235716,0,0,0,157,0
2025-08-27,2885,12,1,3235716,66,2411,2466, ,0,0,0,3235716,1,1,0,-55,1
2025-08-28,2885,1,0,3235716,135,2277,2411, ,0,0,0,3235716,0,1,1,-134,0
2025-08-29,2885,24,2,3235716,23,2276,2277, ,0,0,0,3235716,1,2,1,-1,1
2025-09-01,2885,64,0,3235716,101,2239,2276, ,0,1,0,3235716,0,1,2,-37,-1
2025-09-02,2885,34,50,3235716,113,2110,2239, ,0,0,0,3235716,1,2,1,-129,1
2025-09-03,2885,13,0,3235716,33,2090,2110, ,6,2,0,3235716,0,0,2,-20,-2
2025-09-04,2885,307,0,3235716,15,2382,2090, ,0,0,0,3235716,0,0,0,292,0
2025-09-05,2885,350,2,3235716,79,2651,2382, ,0,0,0,3235716,1,1,0,269,1
2025-09-08,2885,78,0,3235716,30,2699,2651, ,0,0,0,3235716,0,1,1,48,0
2025-09-09,2885,5,0,3235716,21,2683,2699, ,0,0,0,3235716,0,1,1,-16,0
2025-09-10,2885,21,0,3235716,18,2686,2683, ,0,0,0,3235716,0,1,1,3,0
2025-09-11,2885,18,0,3332787,40,2664,2686, ,0,0,0,3332787,0,1,1,-22,0
2025-09-12,2885,74,0,3332787,207,2531,2664, ,0,0,0,3332787,0,1,1,-133,0
2025-09-15,2885,245,0,3332787,108,2668,2531, ,0,0,0,3332787,0,1,1,137,0
2025-09-16,2885,20,0,3332787,250,2438,2668, ,0,0,0,3332787,0,1,1,-230,0
2025-09-17,2885,5,0,3332787,29,2414,2438, ,0,1,0,3332787,0,0,1,-24,-1
2025-09-18,2885,8,1,3332787,65,2356,2414, ,0,0,0,3332787,0,0,0,-58,0
2025-09-19,2885,50,1,3332787,205,2200,2356, ,0,0,0,3332787,0,0,0,-156,0
2025-09-22,2885,73,0,3332787,108,2165,2200, ,0,0,0,3332787,0,0,0,-35,0
2025-09-23,2885,37,0,3332787,173,2029,2165, ,0,0,0,3332787,0,0,0,-136,0
2025-06-25,3006,163,10,71543,90,10810,10747, ,2,33,0,71543,0,134,167,63,-33
2025-06-26,3006,101,17,71543,146,10748,10810, ,1,1,0,71543,5,138,134,-62,4
2025-06-27,3006,220,19,71543,140,10809,10748, ,0,32,0,71543,6,112,138,61,-26
2025-06-30,3006,144,8,71543,110,10835,10809, ,0,20,0,71543,3,95,112,26,-17
2025-07-01,3006,109,30,71543,199,10715,10835, ,0,10,0,71543,0,85,95,-120,-10
2025-07-02,3006,84,10,71543,292,10497,10715,X ,2,45,0,71543,1,41,85,-218,-44
2025-07-03,3006,86,5,71543,293,10285,10497,X ,0,39,0,71543,0,2,41,-212,-39
2025-07-04,3006,305,10,71543,131,10449,10285,X ,0,0,2,71543,0,0,2,164,-2
2025-07-07,3006,193,0,71543,216,10426,10449,X ,0,0,0,71543,0,0,0,-23,0
2025-07-08,3006,188,2,71543,341,10271,10426, ,0,0,0,71543,0,0,0,-155,0
2025-07-09,3006,65,3,71543,94,10239,10271, ,6,0,0,71543,7,7,0,-32,7
2025-07-10,3006,82,23,71543,53,10245,10239, ,0,2,0,71543,3,8,7,6,1
2025-07-11,3006,62,155,71543,54,10098,10245, ,0,1,0,71543,12,19,8,-147,11
2025-07-14,3006,50,0,71543,45,10103,10098, ,0,1,0,71543,2,20,19,5,1
2025-07-15,3006,81,1,71543,40,10143,10103, ,0,2,0,71543,7,25,20,40,5
2025-07-16,3006,129,5,71543,57,10210,10143, ,0,4,0,71543,1,22,25,67,-3
2025-07-17,3006,279,2,71543,316,10171,10210, ,14,0,0,71543,28,50,22,-39,28
2025-07-18,3006,139,2,71543,129,10179,10171, ,1,16,0,71543,7,41,50,8,-9
2025-07-21,3006,97,0,71543,112,10164,10179, ,0,9,0,71543,1,33,41,-15,-8
2025-07-22,3006,327,1,71543,323,10167,10164, ,0,11,0,71543,12,34,33,3,1
2025-07-23,3006,49,6,71543,171,10039,10167, ,0,1,0,71543,18,51,34,-128,17
2025-07-24,3006,51,1,71543,141,9948,10039, ,0,7,0,71543,34,78,51,-91,27
2025-07-25,3006,25,20,71543,139,9814,9948, ,0,14,0,71543,2,66,78,-134,-12
2025-07-28,3006,10,0,71543,100,9724,9814, ,0,0,0,71543,40,106,66,-90,40
2025-07-29,3006,108,1,71543,151,9680,9724, ,0,3,0,71543,0,103,106,-44,-3
2025-07-30,3006,34,16,71543,119,9579,9680, ,0,5,0,71543,97,195,103,-101,92
2025-07-31,3006,211,8,71543,259,9523,9579, ,1,23,0,71543,612,784,195,-56,589
2025-08-01,3006,123,6,71543,92,9548,9523, ,3,589,1,71543,13,207,784,25,-577
2025-08-04,3006,46,12,71543,15,9567,9548, ,2,4,0,71543,10,213,207,19,6
2025-08-05,3006,129,2,71543,127,9567,9567, ,0,3,0,71543,17,227,213,0,14
2025-08-06,3006,44,2,71543,80,9529,9567, ,0,7,0,71543,35,255,227,-38,28
2025-08-07,3006,32,4,71543,61,9496,9529, ,0,39,0,71543,10,226,255,-33,-29
2025-08-08,3006,401,2,71543,349,9546,9496, ,9,8,0,71543,22,240,226,50,14
2025-08-11,3006,80,3,71543,133,9490,9546, ,0,3,0,71543,4,241,240,-56,1
2025-08-12,3006,94,22,71543,198,9364,9490, ,5,0,0,71543,8,249,241,-126,8
2025-08-13,3006,279,0,71543,214,9429,9364, ,1,2,0,71543,9,256,249,65,7
2025-08-14,3006,83,4,71543,205,9303,9429, ,1,4,0,71543,11,263,256,-126,7
2025-08-15,3006,115,75,71543,52,9291,9303, ,1,11,0,71543,0,252,263,-12,-11
2025-08-18,3006,71,2,71543,63,9297,9291, ,0,3,0,71543,4,253,252,6,1
2025-08-19,3006,63,0,71543,62,9298,9297, ,0,0,0,71543,7,260,253,1,7
2025-08-20,3006,151,12,71543,75,9362,9298, ,0,20,0,71543,2,242,260,64,-18
2025-08-21,3006,203,5,71543,341,9219,9362, ,0,10,0,71543,42,274,242,-143,32
2025-08-22,3006,114,7,71543,72,9254,9219, ,1,16,0,71543,5,263,274,35,-11
2025-08-25,3006,654,11,71543,215,9682,9254, ,2,6,0,71543,19,276,263,428,13
2025-08-26,3006,387,3,71543,224,9842,9682, ,0,3,0,71543,23,296,276,160,20
2025-08-27,3006,114,36,71543,405,9515,9842, ,2,6,0,71543,5,295,296,-327,-1
2025-08-28,3006,147,1,71543,177,9484,9515, ,0,4,0,71543,2,293,295,-31,-2
2025-08-29,3006,172,6,71543,143,9507,9484, ,4,9,0,71543,4,288,293,23,-5
2025-09-01,3006,142,8,71543,282,9359,9507, ,2,5,0,71543,7,290,288,-148,2
2025-09-02,3006,109,6,71543,135,9327,9359, ,5,3,0,71543,3,290,290,-32,0
2025-09-03,3006,116,11,71543,186,9246,9327, ,5,4,0,71543,51,337,290,-81,47
2025-09-04,3006,208,2,71543,170,9282,9246, ,0,4,0,71543,2,335,337,36,-2
2025-09-05,3006,1913,5,71543,1034,10156,9282, ,20,4,2,71543,161,490,335,874,155
2025-09-08,3006,1849,24,71543,1011,10970,10156, ,42,54,0,71543,44,480,490,814,-10
2025-09-09,3006,607,1,71543,776,10800,10970, ,0,55,0,71543,26,451,480,-170,-29
2025-09-10,3006,290,1,71543,327,10762,10800, ,11,13,0,71543,21,459,451,-38,8
2025-09-11,3006,309,1,71543,444,10626,10762, ,23,26,0,71543,15,448,459,-136,-11
2025-09-12,3006,913,0,71543,926,10613,10626, ,26,16,0,71543,13,445,448,-13,-3
2025-09-15,3006,1398,34,71543,778,11199,10613, ,72,17,0,71543,143,571,445,586,126
2025-09-16,3006,2076,10,71543,1445,11820,11199, ,55,32,0,71543,161,700,571,621,129
2025-09-17,3006,885,7,71543,1491,11207,11820, ,18,134,1,71543,33,598,700,-613,-102
2025-09-18,3006,3776,12,71543,2152,12819,11207, ,222,34,0,71543,203,767,598,1612,169
2025-09-19,3006,1881,0,71543,4248,10452,12819, ,131,69,2,71543,107,803,767,-2367,36
2025-09-22,3006,2700,1,71543,1435,11716,10452, ,11,12,0,71543,497,1288,803,1264,485
2025-09-23,3006,2450,0,71543,2449,11717,11716, ,65,269,14,71543,249,1254,1288,1,-34
2025-06-25,3026,1,0,41472,13,337,349, ,0,0,0,41472,0,2,2,-12,0
2025-06-26,3026,1,0,41472,2,336,337, ,0,0,0,41472,0,2,2,-1,0
2025-06-27,3026,0,0,41472,14,322,336, ,0,0,0,41472,0,2,2,-14,0
2025-06-30,3026,2,0,41472,1,323,322, ,0,0,0,41472,0,2,2,1,0
2025-07-01,3026,11,1,41472,6,327,323, ,0,1,0,41472,0,1,2,4,-1
2025-07-02,3026,2,0,41472,0,329,327, ,0,0,0,41472,0,1,1,2,0
2025-07-03,3026,1,0,41472,3,327,329, ,0,0,0,41472,0,1,1,-2,0
2025-07-04,3026,7,0,41472,0,334,327, ,0,0,0,41472,0,1,1,7,0
2025-07-07,3026,9,0,41472,0,343,334, ,0,0,0,41472,0,1,1,9,0
2025-07-08,3026,1,0,41472,9,335,343, ,0,0,0,41472,0,1,1,-8,0
2025-07-09,3026,0,3,41472,10,322,335, ,0,0,0,41472,0,1,1,-13,0
2025-07-10,3026,0,0,41472,1,321,322, ,0,0,0,41472,0,1,1,-1,0
2025-07-11,3026,0,0,41472,0,321,321, ,0,0,0,41472,0,1,1,0,0
2025-07-14,3026,0,0,41472,0,321,321, ,0,0,0,41472,0,1,1,0,0
2025-07-15,3026,2,0,41472,0,323,321, ,0,0,0,41472,0,1,1,2,0
2025-07-16,3026,1,0,41472,4,320,323, ,0,0,0,41472,0,1,1,-3,0
2025-07-17,3026,0,0,41472,1,319,320, ,0,0,0,41472,0,1,1,-1,0
2025-07-18,3026,3,0,41472,3,319,319, ,0,0,0,41472,0,1,1,0,0
2025-07-21,3026,1,0,41472,2,318,319, ,0,0,0,41472,0,1,1,-1,0
2025-07-22,3026,3,0,41472,1,320,318, ,0,0,0,41472,0,1,1,2,0
2025-07-23,3026,9,0,41472,2,327,320, ,0,0,0,41472,0,1,1,7,0
2025-07-24,3026,2,2,41472,1,326,327, ,0,0,0,41472,0,1,1,-1,0
2025-07-25,3026,2,0,41472,5,323,326, ,0,0,0,41472,0,1,1,-3,0
2025-07-28,3026,0,1,41472,8,314,323, ,0,0,0,41472,0,1,1,-9,0
2025-07-29,3026,0,0,41472,0,314,314, ,0,0,0,41472,0,1,1,0,0
2025-07-30,3026,1,0,41472,2,313,314, ,0,0,0,41472,0,1,1,-1,0
2025-07-31,3026,2,0,41472,0,315,313, ,0,0,0,41472,0,1,1,2,0
2025-08-01,3026,0,0,41472,0,315,315, ,0,0,0,41472,0,1,1,0,0
2025-08-04,3026,8,0,41472,0,323,315, ,0,0,0,41472,0,1,1,8,0
2025-08-05,3026,22,0,41472,1,344,323, ,0,0,0,41472,0,1,1,21,0
2025-08-06,3026,1,1,41472,4,340,344, ,0,0,0,41472,0,1,1,-4,0
2025-08-07,3026,2,0,41472,3,339,340, ,0,0,0,41472,0,1,1,-1,0
2025-08-08,3026,5,0,41472,12,332,339, ,0,0,0,41472,0,1,1,-7,0
2025-08-11,3026,5,0,41472,2,335,332, ,0,0,0,41472,0,1,1,3,0
2025-08-12,3026,1,0,41472,0,336,335, ,0,0,0,41472,0,1,1,1,0
2025-08-13,3026,9,1,41472,0,344,336, ,0,0,0,41472,0,1,1,8,0
2025-08-14,3026,2,0,41472,9,337,344, ,0,0,0,41472,0,1,1,-7,0
2025-08-15,3026,0,0,41472,1,336,337, ,0,0,0,41472,0,1,1,-1,0
2025-08-18,3026,9,0,41472,6,339,336, ,0,0,0,41472,0,1,1,3,0
2025-08-19,3026,1,0,41472,1,339,339, ,0,0,0,41472,0,1,1,0,0
2025-08-20,3026,16,0,41472,19,336,339, ,0,0,0,41472,0,1,1,-3,0
2025-08-21,3026,2,0,41472,15,323,336, ,0,0,0,41472,0,1,1,-13,0
2025-08-22,3026,17,0,41472,49,291,323, ,0,0,0,41472,0,1,1,-32,0
2025-08-25,3026,7,0,41472,5,293,291, ,0,0,0,41472,0,1,1,2,0
2025-08-26,3026,6,0,41472,3,296,293, ,0,0,0,41472,0,1,1,3,0
2025-08-27,3026,5,0,41472,2,299,296, ,0,0,0,41472,0,1,1,3,0
2025-08-28,3026,2,0,41472,2,299,299, ,0,0,0,41472,0,1,1,0,0
2025-08-29,3026,4,0,41472,13,290,299, ,0,0,0,41472,0,1,1,-9,0
2025-09-01,3026,5,0,41472,11,284,290, ,0,0,0,41472,1,2,1,-6,1
2025-09-02,3026,4,0,41472,17,271,284, ,0,0,0,41472,0,2,2,-13,0
2025-09-03,3026,3,0,41472,1,273,271, ,0,0,0,41472,0,2,2,2,0
2025-09-04,3026,4,0,41472,2,275,273, ,0,0,0,41472,0,2,2,2,0
2025-09-05,3026,0,0,41472,1,274,275, ,0,0,0,41472,0,2,2,-1,0
2025-09-08,3026,12,0,41472,1,285,274, ,0,0,0,41472,0,2,2,11,0
2025-09-09,3026,0,1,41472,11,273,285, ,0,1,0,41472,0,1,2,-12,-1
2025-09-10,3026,5,0,41472,0,278,273, ,0,0,0,41472,0,1,1,5,0
2025-09-11,3026,50,0,41472,1,327,278, ,0,0,0,41472,0,1,1,49,0
2025-09-12,3026,74,0,41472,5,396,327, ,0,0,0,41472,0,1,1,69,0
2025-09-15,3026,7,0,41472,42,361,396, ,0,0,0,41472,0,1,1,-35,0
2025-09-16,3026,9,0,41472,12,358,361, ,0,0,0,41472,0,1,1,-3,0
2025-09-17,3026,94,0,41472,27,425,358, ,1,0,0,41472,0,1,1,67,0
2025-09-18,3026,27,1,41472,17,434,425, ,0,0,0,41472,0,1,1,9,0
2025-09-19,3026,635,0,41472,33,1036,434, ,0,0,0,41472,1,2,1,602,1
2025-09-22,3026,1482,0,41472,305,2213,1036, ,27,0,0,41472,13,15,2,1177,13
2025-09-23,3026,566,0,41472,529,2250,2213, ,10,3,0,41472,12,24,15,37,9
2025-06-25,3036,48,1,280324,133,2843,2929,X ,0,0,3,280324,0,0,3,-86,-3
2025-06-26,3036,1261,1,280324,760,3343,2843,X ,0,0,0,280324,0,0,0,500,0
2025-06-27,3036,890,0,280324,1850,2383,3343, ,0,0,0,280324,0,0,0,-960,0
2025-06-30,3036,377,0,280324,149,2611,2383, ,203,0,0,280324,77,77,0,228,77
2025-07-01,3036,104,1,280324,342,2372,2611, ,64,25,0,280324,32,84,77,-239,7
2025-07-02,3036,48,1,280324,60,2359,2372, ,1,2,0,280324,29,111,84,-13,27
2025-07-03,3036,70,1,280324,78,2350,2359, ,0,7,0,280324,8,112,111,-9,1
2025-07-04,3036,64,25,280324,99,2290,2350, ,0,24,0,280324,6,94,112,-60,-18
2025-07-07,3036,19,0,280324,64,2245,2290, ,2,2,0,280324,26,118,94,-45,24
2025-07-08,3036,21,0,280324,73,2193,2245, ,1,7,0,280324,41,152,118,-52,34
2025-07-09,3036,132,0,280324,107,2218,2193, ,0,19,0,280324,14,147,152,25,-5
2025-07-10,3036,28,0,280324,79,2167,2218, ,0,32,0,280324,28,143,147,-51,-4
2025-07-11,3036,37,1,280324,111,2092,2167, ,0,2,0,280324,21,162,143,-75,19
2025-07-14,3036,301,2,280407,51,2340,2092, ,0,2,20,280407,0,140,162,248,-22
2025-07-15,3036,0,5,280407,0,2335,2340, ,0,0,0,280407,0,140,140,-5,0
2025-07-16,3036,60,6,280407,339,2050,2335, ,1,2,0,280407,19,157,140,-285,17
2025-07-17,3036,219,0,280407,50,2219,2050, ,1,5,0,280407,1,153,157,169,-4
2025-07-18,3036,20,0,280407,48,2191,2219, ,0,4,0,280407,12,161,153,-28,8
2025-07-21,3036,20,0,280407,25,2186,2191, ,0,1,0,280407,0,160,161,-5,-1
2025-07-22,3036,13,2,280407,78,2119,2186, ,0,1,0,280407,1,160,160,-67,0
2025-07-23,3036,10,7,280407,114,2008,2119, ,0,0,0,280407,6,166,160,-111,6
2025-07-24,3036,13,41,280407,16,1964,2008, ,0,6,0,280407,0,160,166,-44,-6
2025-07-25,3036,19,0,280407,16,1967,1964, ,0,0,0,280407,0,160,160,3,0
2025-07-28,3036,26,23,280407,49,1921,1967, ,0,0,0,280407,1,161,160,-46,1
2025-07-29,3036,16,4,280407,76,1857,1921, ,0,4,0,280407,3,160,161,-64,-1
2025-07-30,3036,77,5,280407,110,1819,1857, ,0,1,0,280407,3,162,160,-38,2
2025-07-31,3036,83,5,280407,37,1860,1819, ,0,0,0,280407,0,162,162,41,0
2025-08-01,3036,27,5,280407,23,1859,1860, ,0,4,0,280407,2,160,162,-1,-2
2025-08-04,3036,12,16,280407,25,1830,1859, ,0,2,0,280407,1,159,160,-29,-1
2025-08-05,3036,42,19,280407,70,1783,1830, ,0,0,0,280407,0,159,159,-47,0
2025-08-06,3036,59,17,280407,27,1798,1783, ,0,1,0,280407,0,158,159,15,-1
2025-08-07,3036,368,3,280407,130,2033,1798, ,1,31,0,280407,0,127,158,235,-31
2025-08-08,3036,242,1,280407,139,2135,2033, ,3,50,0,280407,12,89,127,102,-38
2025-08-11,3036,47,10,280407,52,2120,2135, ,0,6,0,280407,8,91,89,-15,2
2025-08-12,3036,71,0,280407,15,2176,2120, ,0,2,0,280407,1,90,91,56,-1
2025-08-13,3036,19,3,280407,59,2133,2176, ,0,4,0,280407,1,87,90,-43,-3
2025-08-14,3036,22,0,280475,11,2144,2133, ,0,0,0,280475,3,90,87,11,3
2025-08-15,3036,8,1,280475,23,2128,2144, ,0,4,0,280475,0,86,90,-16,-4
2025-08-18,3036,26,0,280475,48,2106,2128, ,0,1,0,280475,0,85,86,-22,-1
2025-08-19,3036,34,5,280475,50,2085,2106, ,0,3,0,280475,1,83,85,-21,-2
2025-08-20,3036,111,9,280475,50,2137,2085, ,0,5,0,280475,5,83,83,52,0
2025-08-21,3036,19,0,280475,18,2138,2137, ,0,1,0,280475,6,88,83,1,5
2025-08-22,3036,17,7,280475,25,2123,2138, ,0,2,0,280475,3,89,88,-15,1
2025-08-25,3036,74,0,280475,16,2181,2123, ,0,3,0,280475,1,87,89,58,-2
2025-08-26,3036,55,1,280475,63,2172,2181, ,0,7,0,280475,3,83,87,-9,-4
2025-08-27,3036,48,11,280475,29,2180,2172, ,1,6,0,280475,2,79,83,8,-4
2025-08-28,3036,32,0,280475,32,2180,2180, ,0,2,0,280475,10,87,79,0,8
2025-08-29,3036,42,4,280475,40,2178,2180, ,0,10,0,280475,1,78,87,-2,-9
2025-09-01,3036,10,2,280475,93,2093,2178, ,2,0,1,280475,0,77,78,-85,-1
2025-09-02,3036,48,3,280475,47,2091,2093, ,2,2,0,280475,0,75,77,-2,-2
2025-09-03,3036,18,0,280475,24,2085,2091, ,0,0,0,280475,1,76,75,-6,1
2025-09-04,3036,58,11,280475,121,2011,2085, ,3,1,0,280475,12,87,76,-74,11
2025-09-05,3036,119,18,280475,45,2067,2011, ,2,6,0,280475,14,95,87,56,8
2025-09-08,3036,86,1,280644,134,2018,2067, ,0,11,0,280644,7,91,95,-49,-4
2025-09-09,3036,157,0,280644,38,2137,2018, ,0,1,0,280644,0,90,91,119,-1
2025-09-10,3036,103,5,280644,152,2083,2137, ,2,2,0,280644,1,89,90,-54,-1
2025-09-11,3036,68,0,280644,122,2029,2083, ,2,0,5,280644,1,85,89,-54,-4
2025-09-12,3036,21,0,280646,84,1966,2029, ,0,1,0,280646,0,84,85,-63,-1
2025-09-15,3036,36,8,280646,23,1971,1966, ,1,3,0,280646,5,86,84,5,2
2025-09-16,3036,47,4,280646,22,1992,1971, ,0,8,0,280646,1,79,86,21,-7
2025-09-17,3036,52,1,280646,22,2021,1992, ,1,2,0,280646,0,77,79,29,-2
2025-09-18,3036,446,2,280646,251,2214,2021, ,2,2,0,280646,8,83,77,193,6
2025-09-19,3036,111,13,280646,261,2051,2214, ,1,7,0,280646,283,359,83,-163,276
2025-09-22,3036,188,3,280646,100,2136,2051, ,0,271,0,280646,1,89,359,85,-270
2025-09-23,3036,129,0,280646,196,2069,2136, ,0,0,12,280646,2,79,89,-67,-10
2025-06-25,3037,1294,17,382419,2303,30403,31429, ,63,72,2,382419,219,1118,973,-1026,145
2025-06-26,3037,950,22,382419,1551,29780,30403, ,1,106,2,382419,49,1059,1118,-623,-59
2025-06-27,3037,1270,0,382419,1190,29860,29780, ,10,242,0,382419,27,844,1059,80,-215
2025-06-30,3037,339,19,382419,767,29413,29860, ,1,53,3,382419,36,824,844,-447,-20
2025-07-01,3037,1663,11,382419,1049,30016,29413, ,7,176,0,382419,22,670,824,603,-154
2025-07-02,3037,299,4,382419,600,29711,30016, ,1,114,0,382419,8,564,670,-305,-106
2025-07-03,3037,2998,27,382419,3006,29676,29711,X ,23,160,4,382419,152,552,564,-35,-12
2025-07-04,3037,1934,19,382419,5315,26276,29676,X ,0,535,7,382419,0,10,552,-3400,-542
2025-07-07,3037,1476,10,382419,1164,26578,26276,X ,0,6,4,382419,0,0,10,302,-10
2025-07-08,3037,781,8,382419,872,26479,26578,X ,0,0,0,382419,0,0,0,-99,0
2025-07-09,3037,2558,8,382419,4325,24704,26479, ,0,0,0,382419,0,0,0,-1775,0
2025-07-10,3037,2649,1,382419,2876,24476,24704, ,1225,0,0,382419,428,428,0,-228,428
2025-07-11,3037,1103,10,382419,1462,24107,24476, ,302,94,0,382419,31,365,428,-369,-63
2025-07-14,3037,1552,28,382419,933,24698,24107, ,10,272,0,382419,71,164,365,591,-201
2025-07-15,3037,4715,11,382419,3613,25789,24698, ,85,15,0,382419,1088,1237,164,1091,1073
2025-07-16,3037,8293,1,382419,4783,29298,25789, ,381,218,0,382419,1111,2130,1237,3509,893
2025-07-17,3037,3780,5,382419,3426,29647,29298, ,72,914,0,382419,88,1304,2130,349,-826
2025-07-18,3037,1800,16,382419,1681,29750,29647, ,53,163,1,382419,83,1223,1304,103,-81
2025-07-21,3037,1963,1,382419,1123,30589,29750, ,6,171,0,382419,82,1134,1223,839,-89
2025-07-22,3037,2375,24,382419,3651,29289,30589, ,18,484,0,382419,394,1044,1134,-1300,-90
2025-07-23,3037,2610,4,382419,2196,29699,29289, ,20,204,0,382419,247,1087,1044,410,43
2025-07-24,3037,1721,6,382419,826,30588,29699, ,5,76,0,382419,139,1150,1087,889,63
2025-07-25,3037,1819,3,382419,1898,30506,30588, ,12,195,0,382419,44,999,1150,-82,-151
2025-07-28,3037,956,5,382419,1565,29892,30506, ,5,77,2,382419,67,987,999,-614,-12
2025-07-29,3037,7617,6,382419,6180,31323,29892, ,67,125,1,382419,589,1450,987,1431,463
2025-07-30,3037,2546,11,382419,4414,29444,31323, ,26,393,0,382419,213,1270,1450,-1879,-180
2025-07-31,3037,3234,6,382419,3688,28984,29444, ,16,241,5,382419,47,1071,1270,-460,-199
2025-08-01,3037,987,4,382419,2733,27234,28984, ,10,56,2,382419,259,1272,1071,-1750,201
2025-08-04,3037,1314,0,382419,1010,27538,27234, ,4,248,0,382419,64,1088,1272,304,-184
2025-08-05,3037,894,37,382419,1491,26904,27538, ,1,33,0,382419,119,1174,1088,-634,86
2025-08-06,3037,573,10,382419,1587,25880,26904, ,3,75,3,382419,63,1159,1174,-1024,-15
2025-08-07,3037,1316,4,382419,1261,25931,25880, ,16,123,1,382419,132,1167,1159,51,8
2025-08-08,3037,3805,17,382419,1108,28611,25931, ,9,21,0,382419,40,1186,1167,2680,19
2025-08-11,3037,2847,6,382419,2639,28813,28611, ,28,139,0,382419,204,1251,1186,202,65
2025-08-12,3037,1336,2,382419,1556,28591,28813, ,5,123,0,382419,21,1149,1251,-222,-102
2025-08-13,3037,993,103,382419,1646,27835,28591, ,12,143,0,382419,59,1065,1149,-756,-84
2025-08-14,3037,2264,11,382419,1470,28618,27835, ,5,26,1,382419,86,1124,1065,783,59
2025-08-15,3037,1708,8,382419,1260,29058,28618, ,3,83,0,382419,18,1059,1124,440,-65
2025-08-18,3037,3213,6,382419,2804,29461,29058, ,20,92,0,382419,378,1345,1059,403,286
2025-08-19,3037,2172,5,382419,3048,28580,29461, ,7,116,0,382419,34,1263,1345,-881,-82
2025-08-20,3037,1662,1,382419,1010,29231,28580, ,11,256,0,382419,88,1095,1263,651,-168
2025-08-21,3037,792,3,382419,628,29392,29231, ,19,119,1,382419,92,1067,1095,161,-28
2025-08-22,3037,488,4,382419,506,29370,29392, ,17,18,0,382419,86,1135,1067,-22,68
2025-08-25,3037,1757,6,382419,2024,29097,29370, ,8,70,1,382419,107,1171,1135,-273,36
2025-08-26,3037,3908,2,382419,2716,30287,29097, ,25,58,0,382419,116,1229,1171,1190,58
2025-08-27,3037,6059,15,382419,6992,29339,30287, ,38,105,0,382419,473,1597,1229,-948,368
2025-08-28,3037,2682,12,382419,3454,28555,29339, ,68,138,0,382419,71,1530,1597,-784,-67
2025-08-29,3037,3240,12,382419,4336,27447,28555, ,11,361,0,382419,19,1188,1530,-1108,-342
2025-09-01,3037,2538,13,382419,4580,25392,27447, ,9,291,0,382419,211,1108,1188,-2055,-80
2025-09-02,3037,1462,13,382419,1128,25713,25392, ,11,154,0,382419,153,1107,1108,321,-1
2025-09-03,3037,590,11,382419,618,25674,25713, ,3,54,0,382419,83,1136,1107,-39,29
2025-09-04,3037,2078,6,382419,654,27092,25674, ,3,94,0,382419,87,1129,1136,1418,-7
2025-09-05,3037,1251,8,382419,579,27756,27092, ,12,228,0,382419,26,927,1129,664,-202
2025-09-08,3037,1680,137,382419,551,28748,27756, ,1,55,0,382419,79,951,927,992,24
2025-09-09,3037,393,21,382419,681,28439,28748, ,0,58,1,382419,32,924,951,-309,-27
2025-09-10,3037,1627,4,382419,2187,27875,28439, ,4,105,30,382419,314,1103,924,-564,179
2025-09-11,3037,2966,1,382416,2095,28745,27875, ,40,62,0,382416,117,1158,1103,870,55
2025-09-12,3037,1946,1,382416,3971,26719,28745, ,15,30,0,382416,133,1261,1158,-2026,103
2025-09-15,3037,329,0,382416,514,26534,26719, ,8,97,0,382416,55,1219,1261,-185,-42
2025-09-16,3037,3715,21,382416,2851,27377,26534, ,27,158,0,382416,446,1507,1219,843,288
2025-09-17,3037,1273,4,382416,2770,25876,27377, ,4,206,0,382416,20,1321,1507,-1501,-186
2025-09-18,3037,2652,3,382416,1281,27244,25876, ,6,60,1,382416,34,1294,1321,1368,-27
2025-09-19,3037,5400,33,382416,3698,28913,27244, ,60,78,3,382416,432,1645,1294,1669,351
2025-09-22,3037,1696,2,382416,1557,29050,28913, ,17,74,1,382416,247,1817,1645,137,172
2025-09-23,3037,1747,1,382416,4939,25857,29050, ,16,62,0,382416,215,1970,1817,-3193,153
2025-06-25,3138,4,0,12577,32,923,951, ,0,0,0,12577,0,0,0,-28,0
2025-06-26,3138,7,4,12577,5,921,923, ,0,0,0,12577,0,0,0,-2,0
2025-06-27,3138,12,0,12577,1,932,921, ,0,0,0,12577,0,0,0,11,0
2025-06-30,3138,11,0,12577,0,943,932, ,0,0,0,12577,0,0,0,11,0
2025-07-01,3138,2,0,12577,2,943,943, ,0,0,0,12577,0,0,0,0,0
2025-07-02,3138,0,0,12577,1,942,943, ,0,0,0,12577,0,0,0,-1,0
2025-07-03,3138,3,0,12577,1,944,942, ,0,0,0,12577,0,0,0,2,0
2025-07-04,3138,1,0,12577,2,943,944, ,0,0,0,12577,2,2,0,-1,2
2025-07-07,3138,0,2,12577,1,940,943, ,0,0,0,12577,0,2,2,-3,0
2025-07-08,3138,5,0,12577,3,942,940, ,0,0,0,12577,0,2,2,2,0
2025-07-09,3138,1,1,12577,5,937,942, ,0,0,0,12577,0,2,2,-5,0
2025-07-10,3138,11,1,12577,30,917,937, ,0,0,0,12577,0,2,2,-20,0
2025-07-11,3138,3,1,12577,10,909,917, ,0,0,0,12577,0,2,2,-8,0
2025-07-14,3138,2,1,12577,1,909,909, ,0,0,0,12577,0,2,2,0,0
2025-07-15,3138,4,10,12577,1,902,909, ,0,0,0,12577,0,2,2,-7,0
2025-07-16,3138,0,1,12577,9,892,902, ,0,0,0,12577,0,2,2,-10,0
2025-07-17,3138,1,2,12577,11,880,892, ,0,0,0,12577,0,2,2,-12,0
2025-07-18,3138,3,0,12577,1,882,880, ,0,0,0,12577,0,2,2,2,0
2025-07-21,3138,3,0,12577,3,882,882, ,0,0,0,12577,0,2,2,0,0
2025-07-22,3138,3,1,12577,2,882,882, ,0,0,0,12577,0,2,2,0,0
2025-07-23,3138,8,0,12577,1,889,882, ,0,0,0,12577,0,2,2,7,0
2025-07-24,3138,29,0,12577,10,908,889, ,0,0,0,12577,0,2,2,19,0
2025-07-25,3138,9,1,12577,18,898,908, ,0,0,0,12577,0,2,2,-10,0
2025-07-28,3138,21,1,12577,11,907,898, ,0,0,0,12577,0,2,2,9,0
2025-07-29,3138,7,1,12577,2,911,907, ,0,0,0,12577,0,2,2,4,0
2025-07-30,3138,5,0,12577,10,906,911, ,0,0,0,12577,0,2,2,-5,0
2025-07-31,3138,3,2,12577,8,899,906, ,0,0,0,12577,0,2,2,-7,0
2025-08-01,3138,26,0,12577,13,912,899, ,0,0,0,12577,0,2,2,13,0
2025-08-04,3138,20,0,12577,11,921,912, ,0,0,0,12577,0,2,2,9,0
2025-08-05,3138,4,0,12577,2,923,921, ,0,0,0,12577,0,2,2,2,0
2025-08-06,3138,12,0,12577,5,930,923, ,0,0,0,12577,18,20,2,7,18
2025-08-07,3138,6,0,12577,1,935,930, ,0,12,0,12577,0,8,20,5,-12
2025-08-08,3138,1,0,12577,5,931,935, ,0,0,0,12577,0,8,8,-4,0
2025-08-11,3138,24,19,12577,3,933,931, ,1,0,0,12577,0,8,8,2,0
2025-08-12,3138,30,2,12577,26,935,933, ,0,0,0,12577,0,8,8,2,0
2025-08-13,3138,26,0,12577,11,950,935, ,0,0,0,12577,0,8,8,15,0
2025-08-14,3138,6,0,12577,12,944,950, ,0,0,0,12577,0,8,8,-6,0
2025-08-15,3138,3,0,12577,25,922,944, ,0,0,0,12577,0,8,8,-22,0
2025-08-18,3138,32,0,12577,8,946,922, ,0,0,0,12577,0,8,8,24,0
2025-08-19,3138,19,1,12577,27,937,946, ,0,0,0,12577,0,8,8,-9,0
2025-08-20,3138,7,0,12577,45,899,937, ,0,0,0,12577,0,8,8,-38,0
2025-08-21,3138,9,4,12577,3,901,899, ,0,0,0,12577,0,8,8,2,0
2025-08-22,3138,2,0,12577,6,897,901, ,0,0,0,12577,0,8,8,-4,0
2025-08-25,3138,8,0,12577,14,891,897, ,0,0,0,12577,0,8,8,-6,0
2025-08-26,3138,12,0,12577,3,900,891, ,0,0,0,12577,0,8,8,9,0
2025-08-27,3138,3,1,12577,8,894,900, ,0,0,0,12577,0,8,8,-6,0
2025-08-28,3138,4,0,12577,26,872,894, ,0,0,0,12577,0,8,8,-22,0
2025-08-29,3138,10,0,12577,7,875,872, ,0,0,0,12577,0,8,8,3,0
2025-09-01,3138,6,6,12577,2,873,875, ,0,0,0,12577,0,8,8,-2,0
2025-09-02,3138,6,2,12577,2,875,873, ,0,0,0,12577,0,8,8,2,0
2025-09-03,3138,2,1,12577,13,863,875, ,0,0,0,12577,0,8,8,-12,0
2025-09-04,3138,4,2,12577,16,849,863, ,0,0,0,12577,0,8,8,-14,0
2025-09-05,3138,3,1,12577,3,848,849, ,0,0,0,12577,0,8,8,-1,0
2025-09-08,3138,2,1,12577,0,849,848, ,0,0,0,12577,0,8,8,1,0
2025-09-09,3138,2,4,12577,10,837,849, ,0,0,0,12577,0,8,8,-12,0
2025-09-10,3138,6,0,12577,2,841,837, ,0,0,0,12577,0,8,8,4,0
2025-09-11,3138,17,0,12577,13,845,841, ,0,0,0,12577,0,8,8,4,0
2025-09-12,3138,3,0,12577,2,846,845, ,0,0,0,12577,0,8,8,1,0
2025-09-15,3138,14,0,12577,22,838,846, ,0,0,0,12577,0,8,8,-8,0
2025-09-16,3138,4,0,12577,14,828,838, ,0,0,0,12577,0,8,8,-10,0
2025-09-17,3138,3,0,12577,11,820,828, ,0,0,0,12577,0,8,8,-8,0
2025-09-18,3138,3,0,12577,4,819,820, ,0,0,0,12577,0,8,8,-1,0
2025-09-19,3138,19,0,12577,6,832,819, ,0,0,0,12577,0,8,8,13,0
2025-09-22,3138,36,0,12577,15,853,832, ,4,2,0,12577,0,6,8,21,-2
2025-09-23,3138,254,2,12577,38,1067,853, ,2,0,0,12577,3,9,6,214,3
2025-06-25,3149,0,0,0,2,9602,9604,OX ,0,0,0,0,0,24,24,-2,0
2025-06-26,3149,0,0,0,18,9584,9602,OX ,0,0,0,0,0,24,24,-18,0
2025-06-27,3149,0,0,0,40,9544,9584,OX ,0,0,0,0,0,24,24,-40,0
2025-06-30,3149,0,0,0,7,9537,9544,OX ,0,0,0,0,0,24,24,-7,0
2025-07-01,3149,0,0,0,2,9535,9537,OX ,0,0,0,0,0,24,24,-2,0
2025-07-02,3149,0,0,0,37,9498,9535,OX ,0,0,0,0,0,24,24,-37,0
2025-07-03,3149,0,0,0,5,9493,9498,OX ,0,0,0,0,0,24,24,-5,0
2025-07-04,3149,0,0,0,42,9451,9493,OX ,0,1,0,0,0,23,24,-42,-1
2025-07-07,3149,0,0,0,4,9447,9451,OX ,0,0,0,0,0,23,23,-4,0
2025-07-08,3149,0,0,0,5,9442,9447,OX ,0,0,0,0,0,23,23,-5,0
2025-07-09,3149,0,0,0,11,9431,9442,OX ,0,1,0,0,0,22,23,-11,-1
2025-07-10,3149,0,0,0,44,9387,9431,OX ,0,0,0,0,0,22,22,-44,0
2025-07-11,3149,0,12,0,70,9305,9387,OX ,0,0,0,0,0,22,22,-82,0
2025-07-14,3149,0,1,0,14,9290,9305,OX ,0,0,0,0,0,22,22,-15,0
2025-07-15,3149,0,0,0,25,9265,9290,OX ,0,0,0,0,0,22,22,-25,0
2025-07-16,3149,0,2,0,31,9232,9265,OX ,0,0,0,0,0,22,22,-33,0
2025-07-17,3149,0,0,0,78,9154,9232,OX ,0,0,0,0,0,22,22,-78,0
2025-07-18,3149,0,0,0,9,9145,9154,OX ,0,0,0,0,0,22,22,-9,0
2025-07-21,3149,0,0,0,53,9092,9145,OX ,0,1,0,0,0,21,22,-53,-1
2025-07-22,3149,0,0,0,21,9071,9092,OX ,0,0,0,0,0,21,21,-21,0
2025-07-23,3149,0,0,0,28,9043,9071,OX ,0,0,0,0,0,21,21,-28,0
2025-07-24,3149,0,3,0,1,9039,9043,OX ,0,0,0,0,0,21,21,-4,0
2025-07-25,3149,0,0,0,3,9036,9039,OX ,0,0,0,0,0,21,21,-3,0
2025-07-28,3149,0,0,0,30,9006,9036,OX ,0,0,0,0,0,21,21,-30,0
2025-07-29,3149,0,0,0,20,8986,9006,OX ,0,0,0,0,0,21,21,-20,0
2025-07-30,3149,0,0,0,12,8974,8986,OX ,0,0,0,0,0,21,21,-12,0
2025-07-31,3149,0,0,0,28,8946,8974,OX ,0,0,0,0,0,21,21,-28,0
2025-08-01,3149,0,0,0,0,8946,8946,OX ,0,0,0,0,0,21,21,0,0
2025-08-04,3149,0,0,0,0,8946,8946,OX ,0,0,0,0,0,21,21,0,0
2025-08-05,3149,0,1,0,37,8908,8946,OX ,0,0,0,0,0,21,21,-38,0
2025-08-06,3149,0,0,0,7,8901,8908,OX ,0,0,0,0,0,21,21,-7,0
2025-08-07,3149,0,0,0,8,8893,8901,OX ,0,0,0,0,0,21,21,-8,0
2025-08-08,3149,0,0,0,22,8871,8893,OX ,0,0,0,0,0,21,21,-22,0
2025-08-11,3149,0,0,0,0,8871,8871,OX ,0,0,0,0,0,21,21,0,0
2025-08-12,3149,0,2,0,2,8867,8871,OX ,0,0,0,0,0,21,21,-4,0
2025-08-13,3149,0,10,0,18,8839,8867,OX ,0,0,0,0,0,21,21,-28,0
2025-08-14,3149,0,0,0,0,8839,8839,OX ,0,0,0,0,0,21,21,0,0
2025-08-15,3149,0,0,0,3,8836,8839,OX ,0,0,0,0,0,21,21,-3,0
2025-08-18,3149,0,9,0,31,8796,8836,OX ,0,0,0,0,0,21,21,-40,0
2025-08-19,3149,0,0,0,6,8790,8796,OX ,0,0,0,0,0,21,21,-6,0
2025-08-20,3149,0,0,0,12,8778,8790,OX ,0,0,0,0,0,21,21,-12,0
2025-08-21,3149,0,0,53533,26,8752,8778, ,0,0,0,53533,0,21,21,-26,0
2025-08-22,3149,1173,7,53533,181,9737,8752, ,61,0,0,53533,4,25,21,985,4
2025-08-25,3149,1344,0,53533,286,10795,9737, ,0,1,0,53533,2,26,25,1058,1
2025-08-26,3149,620,0,53533,170,11245,10795, ,0,1,0,53533,0,25,26,450,-1
2025-08-27,3149,2254,16,53533,1656,11827,11245, ,22,0,0,53533,125,150,25,582,125
2025-08-28,3149,2596,0,53533,1398,13025,11827, ,4,83,0,53533,22,89,150,1198,-61
2025-08-29,3149,1124,48,53533,734,13367,13025, ,0,20,0,53533,14,83,89,342,-6
2025-09-01,3149,571,1,53533,722,13215,13367, ,1,6,1,53533,19,95,83,-152,12
2025-09-02,3149,749,0,53533,694,13270,13215, ,10,9,0,53533,54,140,95,55,45
2025-09-03,3149,640,0,53533,433,13477,13270, ,1,7,0,53533,2,135,140,207,-5
2025-09-04,3149,891,6,53533,418,13944,13477, ,11,5,0,53533,6,136,135,467,1
2025-09-05,3149,388,0,53533,178,14154,13944, ,0,6,0,53533,28,158,136,210,22
2025-09-08,3149,492,1,53533,335,14310,14154, ,1,5,0,53533,2,155,158,156,-3
2025-09-09,3149,973,0,53533,864,14419,14310, ,5,37,0,53533,38,156,155,109,1
2025-09-10,3149,281,0,53533,233,14467,14419, ,3,12,0,53533,6,150,156,48,-6
2025-09-11,3149,478,2,53533,104,14839,14467, ,5,2,0,53533,8,156,150,372,6
2025-09-12,3149,979,0,53533,484,15334,14839, ,13,34,0,53533,10,132,156,495,-24
2025-09-15,3149,202,0,53533,204,15332,15334, ,0,9,0,53533,5,128,132,-2,-4
2025-09-16,3149,1366,0,53533,667,16031,15332, ,3,42,0,53533,81,167,128,699,39
2025-09-17,3149,1350,0,53533,878,16503,16031, ,15,4,0,53533,24,187,167,472,20
2025-09-18,3149,2990,0,53533,1480,18013,16503, ,15,0,0,53533,103,290,187,1510,103
2025-09-19,3149,2301,374,53533,1113,18827,18013, ,12,6,0,53533,49,333,290,814,43
2025-09-22,3149,2651,0,53533,1860,19618,18827, ,7,22,0,53533,88,399,333,791,66
2025-09-23,3149,2013,64,53533,2237,19330,19618, ,13,23,0,53533,29,405,399,-288,6
2025-06-25,3231,7996,3,786108,6854,47113,45974, ,47,74,2,786108,492,2010,1594,1139,416
2025-06-26,3231,3361,5,786108,5317,45152,47113, ,11,62,0,786108,314,2262,2010,-1961,252
2025-06-27,3231,4450,8,786108,5212,44382,45152, ,7,422,0,786108,951,2791,2262,-770,529
2025-06-30,3231,2903,8,786108,2136,45141,44382, ,9,412,5,786108,132,2506,2791,759,-285
2025-07-01,3231,3980,0,786108,4303,44818,45141, ,11,281,0,786108,134,2359,2506,-323,-147
2025-07-02,3231,670,4,786108,894,44590,44818, ,5,161,2,786108,109,2305,2359,-228,-54
2025-07-03,3231,941,1,786108,1022,44508,44590, ,0,88,12,786108,53,2258,2305,-82,-47
2025-07-04,3231,1731,22,786108,781,45436,44508, ,0,121,0,786108,62,2199,2258,928,-59
2025-07-07,3231,823,3,786108,2602,43654,45436, ,9,635,0,786108,77,1641,2199,-1782,-558
2025-07-08,3231,881,9,786108,1196,43330,43654, ,5,102,0,786108,302,1841,1641,-324,200
2025-07-09,3231,2430,3,786108,849,44908,43330, ,14,200,10,786108,163,1794,1841,1578,-47
2025-07-10,3231,1420,5,786108,1067,45256,44908, ,2,66,3,786108,115,1840,1794,348,46
2025-07-11,3231,751,31,786108,2023,43953,45256, ,0,146,0,786108,20,1714,1840,-1303,-126
2025-07-14,3231,1444,14,786108,1964,43419,43953, ,9,101,0,786108,206,1819,1714,-534,105
2025-07-15,3231,852,6,786108,1124,43141,43419, ,5,196,8,786108,305,1920,1819,-278,101
2025-07-16,3231,1761,102,786108,1529,43271,43141, ,11,116,2,786108,112,1914,1920,130,-6
2025-07-17,3231,654,11,786108,749,43165,43271, ,10,270,4,786108,53,1693,1914,-106,-221
2025-07-18,3231,1283,13,786108,726,43709,43165, ,5,137,0,786108,156,1712,1693,544,19
2025-07-21,3231,519,39,786108,522,43667,43709, ,1,116,1,786108,15,1610,1712,-42,-102
2025-07-22,3231,2414,1,786108,2155,43924,43666, ,7,278,0,786108,302,1634,1610,258,24
2025-07-23,3231,673,3,786108,662,43932,43924, ,1,107,0,786108,149,1676,1634,8,42
2025-07-24,3231,507,13,786108,628,43798,43932, ,1,66,0,786108,139,1749,1676,-134,73
2025-07-25,3231,513,16,786108,372,43923,43798, ,0,36,0,786108,115,1828,1749,125,79
2025-07-28,3231,2363,15,786108,1413,44858,43923, ,1,173,1,786108,201,1855,1828,935,27
2025-07-29,3231,963,4,786108,2942,42875,44858, ,17,156,0,786108,56,1755,1855,-1983,-100
2025-07-30,3231,597,1,786108,877,42594,42875, ,3,43,0,786108,165,1877,1755,-281,122
2025-07-31,3231,2556,2,786108,4674,40474,42594, ,11,29,0,786108,105,1953,1877,-2120,76
2025-08-01,3231,1197,5,786108,1451,40215,40474, ,3,261,4,786108,68,1756,1953,-259,-197
2025-08-04,3231,1667,13,786103,941,40928,40215, ,2,227,5,786103,13,1537,1756,713,-219
2025-08-05,3231,1022,52,786103,2516,39382,40928, ,11,14,0,786103,254,1777,1537,-1546,240
2025-08-06,3231,978,163,786103,2311,37886,39382, ,1,94,0,786103,19,1702,1777,-1496,-75
2025-08-07,3231,1194,18,786103,1737,37325,37886, ,5,106,0,786103,44,1640,1702,-561,-62
2025-08-08,3231,2056,6,786103,1210,38165,37325, ,0,13,4,786103,95,1718,1640,840,78
2025-08-11,3231,7030,22,786103,2693,42480,38165, ,32,105,1,786103,184,1796,1718,4315,78
2025-08-12,3231,2261,10,786103,2414,42317,42480, ,13,66,0,786103,80,1810,1796,-163,14
2025-08-13,3231,10562,16,786103,5447,47416,42317, ,16,420,0,786103,109,1499,1810,5099,-311
2025-08-14,3231,4900,19,786103,2454,49843,47416, ,18,185,0,786103,163,1477,1499,2427,-22
2025-08-15,3231,3774,53,786103,893,52671,49843, ,4,179,2,786103,39,1335,1477,2828,-142
2025-08-18,3231,1539,62,786103,2218,51930,52671, ,2,78,0,786103,53,1310,1335,-741,-25
2025-08-19,3231,883,28,786103,1175,51610,51930, ,1,62,0,786103,41,1289,1310,-320,-21
2025-08-20,3231,1343,26,786103,3540,49387,51610, ,4,206,0,786103,241,1324,1289,-2223,35
2025-08-21,3231,3089,9,786103,1363,51104,49387, ,8,351,0,786103,312,1285,1324,1717,-39
2025-08-22,3231,1345,63,786103,1132,51254,51104, ,26,55,0,786103,146,1376,1285,150,91
2025-08-25,3231,1636,21,786103,833,52036,51254, ,0,113,0,786103,76,1339,1376,782,-37
2025-08-26,3231,673,9,786103,387,52313,52036, ,0,79,0,786103,41,1301,1339,277,-38
2025-08-27,3231,1792,40,786103,1562,52503,52313, ,9,105,0,786103,63,1259,1301,190,-42
2025-08-28,3231,651,12,786103,1999,51143,52503, ,2,33,0,786103,41,1267,1259,-1360,8
2025-08-29,3231,995,30,786103,852,51256,51143, ,1,152,0,786103,21,1136,1267,113,-131
2025-09-01,3231,1664,56,786103,1769,51095,51256, ,13,194,0,786103,206,1148,1136,-161,12
2025-09-02,3231,571,46,786103,921,50699,51095, ,8,67,0,786103,151,1232,1148,-396,84
2025-09-03,3231,379,12,786103,258,50808,50699, ,0,32,0,786103,57,1257,1232,109,25
2025-09-04,3231,1233,45,786103,3569,48427,50808, ,18,89,0,786103,234,1402,1257,-2381,145
2025-09-05,3231,646,11,786103,1076,47986,48427, ,3,53,0,786103,63,1412,1402,-441,10
2025-09-08,3231,725,10,786103,673,48028,47986, ,0,43,0,786103,43,1412,1412,42,0
2025-09-09,3231,768,17,786103,1867,46912,48028, ,4,67,0,786103,61,1406,1412,-1116,-6
2025-09-10,3231,1735,24,786103,3473,45150,46912, ,16,174,0,786103,190,1422,1406,-1762,16
2025-09-11,3231,1363,3,786103,4860,41650,45150, ,14,29,3,786103,83,1473,1422,-3500,51
2025-09-12,3231,1064,9,786103,2891,39814,41650, ,5,33,3,786103,50,1487,1473,-1836,14
2025-09-15,3231,348,16,786103,1009,39137,39814, ,1,58,0,786103,21,1450,1487,-677,-37
2025-09-16,3231,990,176,786103,871,39080,39137, ,4,59,2,786103,56,1445,1450,-57,-5
2025-09-17,3231,651,6,786103,968,38757,39080, ,7,59,1,786103,131,1516,1445,-323,71
2025-09-18,3231,741,10,795103,509,38979,38757, ,0,150,0,795103,31,1397,1516,222,-119
2025-09-19,3231,648,377,795103,1364,37886,38979, ,0,24,5,795103,20,1388,1397,-1093,-9
2025-09-22,3231,714,11,795103,871,37718,37886, ,2,24,0,795103,8,1372,1388,-168,-16
2025-09-23,3231,6761,29,795103,2304,42146,37718, ,30,78,0,795103,38,1332,1372,4428,-40
2025-06-25,3380,32,0,135429,85,4674,4727, ,0,0,0,135429,5,80,75,-53,5
2025-06-26,3380,31,0,135429,102,4603,4674, ,0,6,0,135429,0,74,80,-71,-6
2025-06-27,3380,20,159,135429,32,4432,4603, ,0,0,0,135429,0,74,74,-171,0
2025-06-30,3380,53,11,135429,39,4435,4432, ,0,25,0,135429,0,49,74,3,-25
2025-07-01,3380,17,10,135429,70,4372,4435, ,0,0,0,135429,7,56,49,-63,7
2025-07-02,3380,28,1,135429,63,4336,4372, ,0,0,0,135429,21,77,56,-36,21
2025-07-03,3380,51,1,135429,59,4327,4336, ,0,7,0,135429,3,73,77,-9,-4
2025-07-04,3380,48,4,135429,13,4358,4327, ,0,28,0,135429,3,48,73,31,-25
2025-07-07,3380,35,5,135429,21,4367,4358, ,0,28,0,135429,2,22,48,9,-26
2025-07-08,3380,57,5,135429,34,4385,4367, ,0,12,0,135429,2,12,22,18,-10
2025-07-09,3380,27,0,135429,17,4395,4385, ,0,3,0,135429,5,14,12,10,2
2025-07-10,3380,54,0,135429,22,4427,4395,X ,0,9,0,135429,0,5,14,32,-9
2025-07-11,3380,26,4,135429,50,4399,4427,X ,0,5,0,135429,0,0,5,-28,-5
2025-07-14,3380,47,0,135429,95,4351,4399,X ,0,0,0,135429,0,0,0,-48,0
2025-07-15,3380,22,1,135429,56,4316,4351,X ,0,0,0,135429,0,0,0,-35,0
2025-07-16,3380,18,0,135429,42,4292,4316, ,0,0,0,135429,0,0,0,-24,0
2025-07-17,3380,17,18,135429,29,4262,4292, ,0,0,0,135429,1,1,0,-30,1
2025-07-18,3380,51,14,135429,18,4281,4262, ,0,0,0,135429,1,2,1,19,1
2025-07-21,3380,62,12,135429,17,4314,4281, ,0,0,0,135429,0,2,2,33,0
2025-07-22,3380,53,1,135429,132,4234,4314, ,0,1,0,135429,1,2,2,-80,0
2025-07-23,3380,3,2,135429,37,4198,4234, ,0,0,0,135429,1,3,2,-36,1
2025-07-24,3380,144,7,135429,82,4253,4198, ,0,0,0,135429,16,19,3,55,16
2025-07-25,3380,16,2,135429,89,4178,4253, ,0,16,0,135429,0,3,19,-75,-16
2025-07-28,3380,37,1,135429,17,4197,4178, ,0,0,0,135429,1,4,3,19,1
2025-07-29,3380,15,4,135429,43,4165,4197, ,2,0,0,135429,2,6,4,-32,2
2025-07-30,3380,54,12,135429,31,4176,4165, ,0,0,0,135429,0,6,6,11,0
2025-07-31,3380,271,0,135429,112,4335,4176, ,0,0,0,135429,10,16,6,159,10
2025-08-01,3380,14,1,135429,139,4209,4335, ,2,0,0,135429,39,55,16,-126,39
2025-08-04,3380,43,4,135429,33,4215,4209, ,3,47,0,135429,6,14,55,6,-41
2025-08-05,3380,58,2,135429,80,4191,4215, ,0,1,0,135429,0,13,14,-24,-1
2025-08-06,3380,71,0,135429,26,4236,4191, ,0,6,0,135429,1,8,13,45,-5
2025-08-07,3380,82,0,135429,10,4308,4236, ,0,4,0,135429,0,4,8,72,-4
2025-08-08,3380,52,0,135429,21,4339,4308, ,0,0,0,135429,20,24,4,31,20
2025-08-11,3380,11,1,135429,31,4318,4339, ,0,2,0,135429,6,28,24,-21,4
2025-08-12,3380,36,7,135429,61,4286,4318, ,0,0,0,135429,5,33,28,-32,5
2025-08-13,3380,138,3,135429,170,4251,4286, ,0,1,0,135429,9,41,33,-35,8
2025-08-14,3380,27,5,135429,28,4245,4251, ,0,1,0,135429,0,40,41,-6,-1
2025-08-15,3380,47,5,135429,89,4198,4245, ,0,4,0,135429,3,39,40,-47,-1
2025-08-18,3380,76,2,135429,95,4177,4198, ,0,5,0,135429,1,35,39,-21,-4
2025-08-19,3380,70,3,135429,41,4203,4177, ,0,2,0,135429,3,36,35,26,1
2025-08-20,3380,60,5,135429,66,4192,4203, ,0,6,0,135429,0,30,36,-11,-6
2025-08-21,3380,44,61,135429,52,4123,4192, ,0,0,0,135429,5,35,30,-69,5
2025-08-22,3380,23,0,135429,16,4130,4123, ,0,0,0,135429,0,35,35,7,0
2025-08-25,3380,61,0,135429,245,3946,4130, ,0,0,0,135429,0,35,35,-184,0
2025-08-26,3380,566,11,135429,247,4254,3946, ,0,8,0,135429,3,30,35,308,-5
2025-08-27,3380,228,1,135429,123,4358,4254, ,3,2,0,135429,0,28,30,104,-2
2025-08-28,3380,72,0,135429,208,4222,4358, ,0,1,0,135429,0,27,28,-136,-1
2025-08-29,3380,65,2,135429,140,4145,4222, ,0,0,0,135429,20,47,27,-77,20
2025-09-01,3380,169,1,135429,186,4127,4145, ,0,20,0,135429,8,35,47,-18,-12
2025-09-02,3380,77,2,135429,50,4152,4127, ,0,2,0,135429,2,35,35,25,0
2025-09-03,3380,209,3,135429,104,4254,4152, ,2,2,0,135429,8,41,35,102,6
2025-09-04,3380,174,2,135429,249,4177,4254, ,1,7,0,135429,15,49,41,-77,8
2025-09-05,3380,211,8,135429,104,4276,4177, ,0,13,0,135429,2,38,49,99,-11
2025-09-08,3380,91,7,135429,52,4308,4276, ,0,3,0,135429,2,37,38,32,-1
2025-09-09,3380,510,0,135429,165,4653,4308, ,11,1,0,135429,6,42,37,345,5
2025-09-10,3380,186,0,135429,131,4708,4653, ,6,6,0,135429,8,44,42,55,2
2025-09-11,3380,270,1,135429,138,4839,4708, ,0,2,0,135429,1,43,44,131,-1
2025-09-12,3380,130,0,135429,107,4862,4839, ,2,6,0,135429,1,38,43,23,-5
2025-09-15,3380,49,50,135429,82,4779,4862, ,0,1,0,135429,3,40,38,-83,2
2025-09-16,3380,90,0,135429,49,4820,4779, ,0,0,0,135429,1,41,40,41,1
2025-09-17,3380,79,3,135429,163,4733,4820, ,0,2,0,135429,0,39,41,-87,-2
2025-09-18,3380,23,1,135429,103,4652,4733, ,0,0,0,135429,0,39,39,-81,0
2025-09-19,3380,45,0,135429,19,4678,4652, ,0,0,0,135429,0,39,39,26,0
2025-09-22,3380,522,0,135429,219,4981,4678, ,1,3,0,135429,1,37,39,303,-2
2025-09-23,3380,374,0,135429,643,4712,4981, ,0,0,0,135429,25,62,37,-269,25
2025-06-25,3419,0,0,0,2,4061,4063,OX ,0,0,0,0,0,0,0,-2,0
2025-06-26,3419,0,0,0,2,4059,4061,OX ,0,0,0,0,0,0,0,-2,0
2025-06-27,3419,0,0,0,7,4052,4059,OX ,0,0,0,0,0,0,0,-7,0
2025-06-30,3419,0,0,0,31,4021,4052,OX ,0,0,0,0,0,0,0,-31,0
2025-07-01,3419,0,0,0,3,4018,4021,OX ,0,0,0,0,0,0,0,-3,0
2025-07-02,3419,0,0,0,1,4017,4018,OX ,0,0,0,0,0,0,0,-1,0
2025-07-03,3419,0,1,0,11,4005,4017,OX ,0,0,0,0,0,0,0,-12,0
2025-07-04,3419,0,1,0,0,4004,4005,OX ,0,0,0,0,0,0,0,-1,0
2025-07-07,3419,0,0,0,1,4003,4004,OX ,0,0,0,0,0,0,0,-1,0
2025-07-08,3419,0,2,0,0,4001,4003,OX ,0,0,0,0,0,0,0,-2,0
2025-07-09,3419,0,0,0,0,4001,4001,OX ,0,0,0,0,0,0,0,0,0
2025-07-10,3419,0,0,0,0,4001,4001,OX ,0,0,0,0,0,0,0,0,0
2025-07-11,3419,0,4,0,15,3982,4001,OX ,0,0,0,0,0,0,0,-19,0
2025-07-14,3419,0,0,0,0,3982,3982,OX ,0,0,0,0,0,0,0,0,0
2025-07-15,3419,0,0,0,0,3982,3982,OX ,0,0,0,0,0,0,0,0,0
2025-07-16,3419,0,0,0,0,3982,3982,OX ,0,0,0,0,0,0,0,0,0
2025-07-17,3419,0,0,0,0,3982,3982,OX ,0,0,0,0,0,0,0,0,0
2025-07-18,3419,0,0,0,1,3981,3982,OX ,0,0,0,0,0,0,0,-1,0
2025-07-21,3419,0,0,0,0,3981,3981,OX ,0,0,0,0,0,0,0,0,0
2025-07-22,3419,0,7,0,11,3963,3981,OX ,0,0,0,0,0,0,0,-18,0
2025-07-23,3419,0,0,0,2,3961,3963,OX ,0,0,0,0,0,0,0,-2,0
2025-07-24,3419,0,0,0,1,3960,3961,OX ,0,0,0,0,0,0,0,-1,0
2025-07-25,3419,0,0,0,0,3960,3960,OX ,0,0,0,0,0,0,0,0,0
2025-07-28,3419,0,0,0,9,3951,3960,OX ,0,0,0,0,0,0,0,-9,0
2025-07-29,3419,0,0,0,12,3939,3951,OX ,0,0,0,0,0,0,0,-12,0
2025-07-30,3419,0,1,0,12,3926,3939,OX ,0,0,0,0,0,0,0,-13,0
2025-07-31,3419,0,0,0,0,3926,3926,OX ,0,0,0,0,0,0,0,0,0
2025-08-01,3419,0,0,0,0,3926,3926,OX ,0,0,0,0,0,0,0,0,0
2025-08-04,3419,0,1,0,0,3925,3926,OX ,0,0,0,0,0,0,0,-1,0
2025-08-05,3419,0,0,0,1,3924,3925,OX ,0,0,0,0,0,0,0,-1,0
2025-08-06,3419,0,5,0,0,3919,3924,OX ,0,0,0,0,0,0,0,-5,0
2025-08-07,3419,0,0,0,0,3919,3919,OX ,0,0,0,0,0,0,0,0,0
2025-08-08,3419,0,0,0,0,3919,3919,OX ,0,0,0,0,0,0,0,0,0
2025-08-11,3419,0,0,0,1,3918,3919,OX ,0,0,0,0,0,0,0,-1,0
2025-08-12,3419,0,0,0,1,3917,3918,OX ,0,0,0,0,0,0,0,-1,0
2025-08-13,3419,0,0,0,0,3917,3917,OX ,0,0,0,0,0,0,0,0,0
2025-08-14,3419,0,26,0,0,3891,3917,OX ,0,0,0,0,0,0,0,-26,0
2025-08-15,3419,0,14,0,1,3876,3891,OX ,0,0,0,0,0,0,0,-15,0
2025-08-18,3419,0,0,0,6,3870,3876,OX ,0,0,0,0,0,0,0,-6,0
2025-08-19,3419,0,1,0,0,3869,3870,OX ,0,0,0,0,0,0,0,-1,0
2025-08-20,3419,0,0,0,2,3867,3869,OX ,0,0,0,0,0,0,0,-2,0
2025-08-21,3419,0,0,0,20,3847,3867,OX ,0,0,0,0,0,0,0,-20,0
2025-08-22,3419,0,2,0,6,3839,3847,OX ,0,0,0,0,0,0,0,-8,0
2025-08-25,3419,0,0,0,0,3839,3839,OX ,0,0,0,0,0,0,0,0,0
2025-08-26,3419,0,0,0,0,3839,3839,OX ,0,0,0,0,0,0,0,0,0
2025-08-27,3419,0,4,0,1,3834,3839,OX ,0,0,0,0,0,0,0,-5,0
2025-08-28,3419,0,1,0,4,3829,3834,OX ,0,0,0,0,0,0,0,-5,0
2025-08-29,3419,0,0,0,5,3824,3829,OX ,0,0,0,0,0,0,0,-5,0
2025-09-01,3419,0,0,0,0,3824,3824,OX ,0,0,0,0,0,0,0,0,0
2025-09-02,3419,0,0,0,0,3824,3824,OX ,0,0,0,0,0,0,0,0,0
2025-09-03,3419,0,0,0,1,3823,3824,OX ,0,0,0,0,0,0,0,-1,0
2025-09-04,3419,0,0,0,0,3823,3823,OX ,0,0,0,0,0,0,0,0,0
2025-09-05,3419,0,0,0,1,3822,3823,OX ,0,0,0,0,0,0,0,-1,0
2025-09-08,3419,0,0,0,3,3819,3822,OX ,0,0,0,0,0,0,0,-3,0
2025-09-09,3419,0,0,0,2,3817,3819,OX ,0,0,0,0,0,0,0,-2,0
2025-09-10,3419,0,0,0,0,3817,3817,OX ,0,0,0,0,0,0,0,0,0
2025-09-11,3419,0,0,0,0,3817,3817,OX ,0,0,0,0,0,0,0,0,0
2025-09-12,3419,0,0,0,0,3817,3817,OX ,0,0,0,0,0,0,0,0,0
2025-09-15,3419,0,0,0,0,3817,3817,OX ,0,0,0,0,0,0,0,0,0
2025-09-16,3419,0,0,0,2,3815,3817,OX ,0,0,0,0,0,0,0,-2,0
2025-09-17,3419,0,0,0,2,3813,3815,OX ,0,0,0,0,0,0,0,-2,0
2025-09-18,3419,0,1,0,1,3811,3813,OX ,0,0,0,0,0,0,0,-2,0
2025-09-19,3419,0,0,0,0,3811,3811,OX ,0,0,0,0,0,0,0,0,0
2025-09-22,3419,0,0,0,80,3731,3811,OX ,0,0,0,0,0,0,0,-80,0
2025-09-23,3419,0,0,0,99,3632,3731,OX ,0,0,0,0,0,0,0,-99,0
2025-06-25,3450,938,2,36420,927,14494,14485, ,13,7,0,36420,138,218,87,9,131
2025-06-26,3450,1197,4,36420,1080,14607,14494, ,13,30,0,36420,79,267,218,113,49
2025-06-27,3450,1022,0,36420,826,14803,14607, ,4,106,0,36420,27,188,267,196,-79
2025-06-30,3450,669,1,36420,1269,14202,14803, ,11,42,0,36420,91,237,188,-601,49
2025-07-01,3450,875,0,36420,588,14489,14202, ,15,63,0,36420,60,234,237,287,-3
2025-07-02,3450,394,1,36420,653,14229,14489, ,6,34,0,36420,174,374,234,-260,140
2025-07-03,3450,377,8,36420,451,14147,14229, ,3,13,0,36420,26,387,374,-82,13
2025-07-04,3450,1704,3,36420,519,15329,14147, ,32,26,0,36420,588,949,387,1182,562
2025-07-07,3450,1107,2,36420,1271,15163,15329, ,14,137,0,36420,439,1251,949,-166,302
2025-07-08,3450,873,6,36420,539,15491,15163, ,22,547,0,36420,150,854,1251,328,-397
2025-07-09,3450,483,0,36420,511,15463,15491, ,14,129,0,36420,185,910,854,-28,56
2025-07-10,3450,438,1,36420,594,15306,15463, ,15,57,0,36420,68,921,910,-157,11
2025-07-11,3450,894,8,36420,414,15778,15306, ,7,67,0,36420,46,900,921,472,-21
2025-07-14,3450,195,1,36420,261,15711,15778, ,5,58,0,36420,110,952,900,-67,52
2025-07-15,3450,255,0,36420,455,15511,15711, ,0,110,0,36420,110,952,952,-200,0
2025-07-16,3450,1298,1,36420,850,15958,15511, ,12,67,0,36420,98,983,952,447,31
2025-07-17,3450,482,8,36420,353,16079,15958, ,4,65,0,36420,60,978,983,121,-5
2025-07-18,3450,795,3,36420,468,16403,16079, ,5,52,1,36420,82,1007,978,324,29
2025-07-21,3450,457,4,36420,518,16338,16403, ,6,33,0,36420,30,1004,1007,-65,-3
2025-07-22,3450,767,1,36420,1191,15915,16340, ,8,191,0,36420,112,925,1004,-425,-79
2025-07-23,3450,418,1,36420,505,15827,15915, ,3,144,0,36420,137,918,925,-88,-7
2025-07-24,3450,335,2,36420,643,15517,15827, ,14,225,0,36420,208,901,918,-310,-17
2025-07-25,3450,280,2,36420,377,15418,15517, ,17,49,0,36420,26,878,901,-99,-23
2025-07-28,3450,618,3,36420,170,15863,15418, ,4,143,0,36420,0,735,878,445,-143
2025-07-29,3450,507,6,36420,407,15957,15863, ,3,196,0,36420,74,613,735,94,-122
2025-07-30,3450,393,1,36420,298,16051,15957, ,7,251,0,36420,116,478,613,94,-135
2025-07-31,3450,470,6,36420,282,16233,16051, ,2,48,0,36420,81,511,478,182,33
2025-08-01,3450,259,0,36420,418,16074,16233, ,6,116,0,36420,261,656,511,-159,145
2025-08-04,3450,400,4,36420,102,16368,16074, ,5,148,0,36420,22,530,656,294,-126
2025-08-05,3450,441,1,36420,292,16516,16368, ,0,121,5,36420,7,411,530,148,-119
2025-08-06,3450,366,3,36420,571,16308,16516, ,8,131,0,36420,22,302,411,-208,-109
2025-08-07,3450,536,5,36420,321,16518,16308, ,6,71,0,36420,23,254,302,210,-48
2025-08-08,3450,466,5,36420,453,16526,16518, ,1,54,0,36420,118,318,254,8,64
2025-08-11,3450,110,2,36420,219,16415,16526, ,0,86,0,36420,62,294,318,-111,-24
2025-08-12,3450,789,1,36420,401,16802,16415, ,5,62,0,36420,168,400,294,387,106
2025-08-13,3450,1164,4,36420,1138,16824,16802, ,10,35,0,36420,42,407,400,22,7
2025-08-14,3450,3315,3,36420,2123,18013,16824, ,41,83,0,36420,176,500,407,1189,93
2025-08-15,3450,2200,1,36420,2770,17442,18013, ,20,86,0,36420,45,459,500,-571,-41
2025-08-18,3450,1966,4,36420,1495,17909,17442, ,3,30,1,36420,29,457,459,467,-2
2025-08-19,3450,2049,11,36420,957,18990,17909, ,5,74,0,36420,6,389,457,1081,-68
2025-08-20,3450,830,2,36420,1367,18451,18990, ,3,109,0,36420,35,315,389,-539,-74
2025-08-21,3450,543,2,36420,510,18482,18451, ,7,43,0,36420,9,281,315,31,-34
2025-08-22,3450,542,1,36420,627,18396,18482, ,5,15,0,36420,105,371,281,-86,90
2025-08-25,3450,1168,8,36420,2077,17479,18396, ,17,75,0,36420,322,618,371,-917,247
2025-08-26,3450,1511,0,36420,1613,17377,17479, ,9,92,0,36420,19,545,618,-102,-73
2025-08-27,3450,1211,1,36420,1186,17401,17377, ,5,22,0,36420,30,553,545,24,8
2025-08-28,3450,1238,11,36420,832,17796,17401, ,3,83,3,36420,29,496,553,395,-57
2025-08-29,3450,1055,5,36420,820,18026,17796, ,5,12,0,36420,81,565,496,230,69
2025-09-01,3450,693,1,36420,898,17820,18026, ,10,98,0,36420,47,514,565,-206,-51
2025-09-02,3450,683,2,36420,385,18116,17820, ,2,25,1,36420,46,534,514,296,20
2025-09-03,3450,659,2,36420,481,18292,18116, ,2,15,0,36420,101,620,534,176,86
2025-09-04,3450,365,1,36420,715,17941,18292, ,2,93,0,36420,34,561,620,-351,-59
2025-09-05,3450,1198,2,36420,665,18472,17941, ,3,75,0,36420,70,556,561,531,-5
2025-09-08,3450,735,3,36420,718,18486,18472, ,3,12,0,36420,35,579,556,14,23
2025-09-09,3450,1047,2,36420,1467,18064,18486, ,3,160,0,36420,21,440,579,-422,-139
2025-09-10,3450,895,15,36420,972,17972,18064, ,3,23,0,36420,35,452,440,-92,12
2025-09-11,3450,839,3,36420,756,18052,17972, ,67,9,0,36420,125,568,452,80,116
2025-09-12,3450,4976,3,36420,3857,19168,18052, ,79,28,0,36420,175,715,568,1116,147
2025-09-15,3450,894,0,36420,1535,18527,19168, ,10,186,3,36420,51,577,715,-641,-138
2025-09-16,3450,991,2,36420,907,18609,18527, ,2,58,0,36420,165,684,577,82,107
2025-09-17,3450,5472,0,36420,2924,21157,18609, ,55,30,0,36420,209,863,684,2548,179
2025-09-18,3450,3065,2,36420,1955,22265,21157, ,20,61,1,36420,152,953,863,1108,90
2025-09-19,3450,4491,14,36420,4113,22629,22265, ,10,12,3,36420,429,1367,953,364,414
2025-09-22,3450,5688,0,36420,5538,22779,22629, ,112,212,0,36420,279,1434,1367,150,67
2025-09-23,3450,4563,4,36420,4728,22610,22779, ,111,220,4,36420,686,1896,1434,-169,462
2025-06-25,3686,0,0,0,0,0,0,OX ,0,0,0,0,0,0,0,0,0
2025-06-26,3686,0,0,0,0,0,0,OX ,0,0,0,0,0,0,0,0,0
2025-06-27,3686,0,0,0,0,0,0,OX ,0,0,0,0,0,0,0,0,0
2025-06-30,3686,0,0,0,0,0,0,OX ,0,0,0,0,0,0,0,0,0
2025-07-01,3686,0,0,0,0,0,0,OX ,0,0,0,0,0,0,0,0,0
2025-07-02,3686,0,0,0,0,0,0,OX ,0,0,0,0,0,0,0,0,0
2025-07-03,3686,0,0,0,0,0,0,OX ,0,0,0,0,0,0,0,0,0
2025-07-04,3686,0,0,0,0,0,0,OX ,0,0,0,0,0,0,0,0,0
2025-07-07,3686,0,0,0,0,0,0,OX ,0,0,0,0,0,0,0,0,0
2025-07-08,3686,0,0,0,0,0,0,OX ,0,0,0,0,0,0,0,0,0
2025-07-09,3686,0,0,0,0,0,0,OX ,0,0,0,0,0,0,0,0,0
2025-07-10,3686,0,0,0,0,0,0,OX ,0,0,0,0,0,0,0,0,0
2025-07-11,3686,0,0,0,0,0,0,OX ,0,0,0,0,0,0,0,0,0
2025-07-14,3686,0,0,0,0,0,0,OX ,0,0,0,0,0,0,0,0,0
2025-07-15,3686,0,0,0,0,0,0,OX ,0,0,0,0,0,0,0,0,0
2025-07-16,3686,0,0,0,0,0,0,OX ,0,0,0,0,0,0,0,0,0
2025-07-17,3686,0,0,0,0,0,0,OX ,0,0,0,0,0,0,0,0,0
2025-07-18,3686,0,0,0,0,0,0,OX ,0,0,0,0,0,0,0,0,0
2025-07-21,3686,0,0,0,0,0,0,OX ,0,0,0,0,0,0,0,0,0
2025-07-22,3686,0,0,0,0,0,0,OX ,0,0,0,0,0,0,0,0,0
2025-07-23,3686,0,0,0,0,0,0,OX ,0,0,0,0,0,0,0,0,0
2025-07-24,3686,0,0,0,0,0,0,OX ,0,0,0,0,0,0,0,0,0
2025-07-25,3686,0,0,0,0,0,0,OX ,0,0,0,0,0,0,0,0,0
2025-07-28,3686,0,0,0,0,0,0,OX ,0,0,0,0,0,0,0,0,0
2025-07-29,3686,0,0,0,0,0,0,OX ,0,0,0,0,0,0,0,0,0
2025-07-30,3686,0,0,0,0,0,0,OX ,0,0,0,0,0,0,0,0,0
2025-07-31,3686,0,0,0,0,0,0,OX ,0,0,0,0,0,0,0,0,0
2025-08-01,3686,0,0,0,0,0,0,OX ,0,0,0,0,0,0,0,0,0
2025-08-04,3686,0,0,0,0,0,0,OX ,0,0,0,0,0,0,0,0,0
2025-08-05,3686,0,0,0,0,0,0,OX ,0,0,0,0,0,0,0,0,0
2025-08-06,3686,0,0,0,0,0,0,OX ,0,0,0,0,0,0,0,0,0
2025-08-07,3686,0,0,0,0,0,0,OX ,0,0,0,0,0,0,0,0,0
2025-08-08,3686,0,0,0,0,0,0,OX ,0,0,0,0,0,0,0,0,0
2025-08-11,3686,0,0,0,0,0,0,OX ,0,0,0,0,0,0,0,0,0
2025-08-12,3686,0,0,0,0,0,0,OX ,0,0,0,0,0,0,0,0,0
2025-08-13,3686,0,0,0,0,0,0,OX ,0,0,0,0,0,0,0,0,0
2025-08-14,3686,0,0,0,0,0,0,OX ,0,0,0,0,0,0,0,0,0
2025-08-15,3686,0,0,0,0,0,0,OX ,0,0,0,0,0,0,0,0,0
2025-08-18,3686,0,0,0,0,0,0,OX ,0,0,0,0,0,0,0,0,0
2025-08-19,3686,0,0,0,0,0,0,OX ,0,0,0,0,0,0,0,0,0
2025-08-20,3686,0,0,0,0,0,0,OX ,0,0,0,0,0,0,0,0,0
2025-08-21,3686,0,0,0,0,0,0,OX ,0,0,0,0,0,0,0,0,0
2025-08-22,3686,0,0,0,0,0,0,OX ,0,0,0,0,0,0,0,0,0
2025-08-25,3686,0,0,0,0,0,0,OX ,0,0,0,0,0,0,0,0,0
2025-08-26,3686,0,0,0,0,0,0,OX ,0,0,0,0,0,0,0,0,0
2025-08-27,3686,0,0,0,0,0,0,OX ,0,0,0,0,0,0,0,0,0
2025-08-28,3686,0,0,0,0,0,0,OX ,0,0,0,0,0,0,0,0,0
2025-08-29,3686,0,0,0,0,0,0,OX ,0,0,0,0,0,0,0,0,0
2025-09-01,3686,0,0,0,0,0,0,OX ,0,0,0,0,0,0,0,0,0
2025-09-02,3686,0,0,0,0,0,0,OX ,0,0,0,0,0,0,0,0,0
2025-09-03,3686,0,0,0,0,0,0,OX ,0,0,0,0,0,0,0,0,0
2025-09-04,3686,0,0,0,0,0,0,OX ,0,0,0,0,0,0,0,0,0
2025-09-05,3686,0,0,0,0,0,0,OX ,0,0,0,0,0,0,0,0,0
2025-09-08,3686,0,0,0,0,0,0,OX ,0,0,0,0,0,0,0,0,0
2025-09-09,3686,0,0,0,0,0,0,OX ,0,0,0,0,0,0,0,0,0
2025-09-10,3686,0,0,0,0,0,0,OX ,0,0,0,0,0,0,0,0,0
2025-09-11,3686,0,0,0,0,0,0,OX ,0,0,0,0,0,0,0,0,0
2025-09-12,3686,0,0,0,0,0,0,OX ,0,0,0,0,0,0,0,0,0
2025-09-15,3686,0,0,0,0,0,0,OX ,0,0,0,0,0,0,0,0,0
2025-09-16,3686,0,0,0,0,0,0,OX ,0,0,0,0,0,0,0,0,0
2025-09-17,3686,0,0,0,0,0,0,OX ,0,0,0,0,0,0,0,0,0
2025-09-18,3686,0,0,0,0,0,0,OX ,0,0,0,0,0,0,0,0,0
2025-09-19,3686,0,0,0,0,0,0,OX ,0,0,0,0,0,0,0,0,0
2025-09-22,3686,0,0,0,0,0,0,OX ,0,0,0,0,0,0,0,0,0
2025-09-23,3686,0,0,0,0,0,0,OX ,0,0,0,0,0,0,0,0,0
2025-06-25,3711,99,3,1105607,239,3331,3474,X ,0,8,5,1105607,20,60,53,-143,7
2025-06-26,3711,122,0,1105607,71,3382,3331,X ,0,55,0,1105607,0,5,60,51,-55
2025-06-27,3711,156,0,1105607,31,3507,3382,X ,0,0,5,1105607,0,0,5,125,-5
2025-06-30,3711,84,0,1105607,52,3539,3507,X ,0,0,0,1105607,0,0,0,32,0
2025-07-01,3711,276,1,1105607,154,3660,3539, ,0,0,0,1105607,0,0,0,121,0
2025-07-02,3711,296,1,1105607,123,3832,3660, ,411,0,0,1105607,27,27,0,172,27
2025-07-03,3711,265,0,1105607,274,3823,3832, ,176,6,0,1105607,12,33,27,-9,6
2025-07-04,3711,36,0,1105607,407,3452,3823, ,0,5,0,1105607,127,155,33,-371,122
2025-07-07,3711,461,0,1105607,47,3866,3452, ,0,113,0,1105607,4,46,155,414,-109
2025-07-08,3711,75,0,1105607,31,3910,3866, ,1,17,0,1105607,8,37,46,44,-9
2025-07-09,3711,41,0,1105607,237,3714,3910, ,0,3,0,1105607,33,67,37,-196,30
2025-07-10,3711,70,0,1105607,252,3532,3714, ,3,12,0,1105607,36,91,67,-182,24
2025-07-11,3711,83,1,1105607,36,3578,3532, ,0,6,0,1105607,6,91,91,46,0
2025-07-14,3711,30,0,1105607,55,3553,3578, ,1,11,0,1105607,22,102,91,-25,11
2025-07-15,3711,183,0,1105607,120,3616,3553, ,0,16,0,1105607,18,104,102,63,2
2025-07-16,3711,46,0,1105607,257,3405,3616, ,6,1,0,1105607,21,124,104,-211,20
2025-07-17,3711,65,1,1105607,54,3415,3405, ,1,1,0,1105607,11,134,124,10,10
2025-07-18,3711,45,0,1105607,93,3367,3415, ,3,3,0,1105607,23,154,134,-48,20
2025-07-21,3711,93,0,1105607,24,3436,3367, ,1,22,0,1105607,3,135,154,69,-19
2025-07-22,3711,75,2,1105607,115,3396,3438, ,7,15,1,1105607,33,152,135,-42,17
2025-07-23,3711,44,0,1105607,62,3378,3396, ,3,1,0,1105607,19,170,152,-18,18
2025-07-24,3711,21,0,1105543,85,3314,3378, ,1,4,0,1105543,20,186,170,-64,16
2025-07-25,3711,106,3,1105543,12,3405,3314, ,1,10,0,1105543,1,177,186,91,-9
2025-07-28,3711,40,0,1105543,110,3335,3405, ,0,1,0,1105543,22,198,177,-70,21
2025-07-29,3711,32,0,1105543,29,3338,3335, ,0,13,0,1105543,13,198,198,3,0
2025-07-30,3711,185,0,1105543,69,3454,3338, ,0,43,0,1105543,2,157,198,116,-41
2025-07-31,3711,118,0,1105543,87,3485,3454, ,2,7,0,1105543,215,365,157,31,208
2025-08-01,3711,442,1,1105543,65,3861,3485, ,32,182,0,1105543,60,243,365,376,-122
2025-08-04,3711,539,7,1105543,28,4365,3861, ,4,53,0,1105543,16,206,243,504,-37
2025-08-05,3711,394,0,1105543,46,4713,4365, ,1,34,0,1105543,0,172,206,348,-34
2025-08-06,3711,258,0,1105543,88,4883,4713, ,1,4,0,1105543,39,207,172,170,35
2025-08-07,3711,162,4,1105543,361,4680,4883, ,1,18,0,1105543,12,201,207,-203,-6
2025-08-08,3711,349,0,1105543,280,4749,4680, ,2,8,2,1105543,39,230,201,69,29
2025-08-11,3711,253,1,1105543,418,4583,4749, ,5,1,0,1105543,20,249,230,-166,19
2025-08-12,3711,304,0,1105543,55,4832,4583, ,2,9,0,1105543,12,252,249,249,3
2025-08-13,3711,190,1,1105543,148,4873,4832, ,1,15,0,1105543,3,240,252,41,-12
2025-08-14,3711,96,1,1105728,40,4928,4873, ,0,3,1,1105728,1,237,240,55,-3
2025-08-15,3711,67,4,1105728,77,4914,4928, ,1,5,0,1105728,1,233,237,-14,-4
2025-08-18,3711,168,0,1105728,184,4898,4914, ,0,0,28,1105728,9,214,233,-16,-19
2025-08-19,3711,156,0,1105728,32,5022,4898, ,0,11,0,1105728,2,205,214,124,-9
2025-08-20,3711,250,7,1105728,53,5212,5022, ,0,31,0,1105728,47,221,205,190,16
2025-08-21,3711,213,1,1105728,44,5380,5212, ,0,13,0,1105728,15,223,221,168,2
2025-08-22,3711,31,0,1105728,74,5337,5380, ,2,5,15,1105728,1,204,223,-43,-19
2025-08-25,3711,51,10,1105728,488,4890,5337, ,0,11,0,1105728,22,215,204,-447,11
2025-08-26,3711,22,1,1105728,126,4785,4890, ,0,12,0,1105728,4,207,215,-105,-8
2025-08-27,3711,59,0,1105728,184,4660,4785, ,0,8,0,1105728,3,202,207,-125,-5
2025-08-28,3711,215,1,1105728,26,4848,4660, ,2,10,0,1105728,3,195,202,188,-7
2025-08-29,3711,300,2,1105728,486,4660,4848, ,6,2,10,1105728,33,216,195,-188,21
2025-09-01,3711,348,1,1105728,679,4328,4660, ,6,3,0,1105728,34,247,216,-332,31
2025-09-02,3711,504,0,1105728,286,4546,4328, ,7,8,2,1105728,25,262,247,218,15
2025-09-03,3711,144,0,1105728,73,4617,4546, ,0,9,0,1105728,2,255,262,71,-7
2025-09-04,3711,227,0,1105728,297,4547,4617, ,0,8,0,1105728,1,248,255,-70,-7
2025-09-05,3711,103,0,1105728,141,4509,4547, ,1,0,25,1105728,5,228,248,-38,-20
2025-09-08,3711,5881,6,1105728,845,9539,4509, ,8,12,1,1105728,175,390,228,5030,162
2025-09-09,3711,2966,3,1105728,5005,7497,9539, ,2,72,0,1105728,24,342,390,-2042,-48
2025-09-10,3711,1586,1,1105728,953,8129,7497, ,8,3,0,1105728,29,368,342,632,26
2025-09-11,3711,679,6,1105728,1463,7339,8129, ,2,13,1,1105728,4,358,368,-790,-10
2025-09-12,3711,394,20,1107449,459,7254,7339, ,0,15,0,1107449,12,355,358,-85,-3
2025-09-15,3711,111,0,1107449,262,7103,7254, ,0,9,11,1107449,41,376,355,-151,21
2025-09-16,3711,956,0,1107449,728,7331,7103, ,1,39,0,1107449,28,365,376,228,-11
2025-09-17,3711,103,1,1107449,385,7048,7331, ,0,4,0,1107449,5,366,365,-283,1
2025-09-18,3711,269,122,1107449,801,6394,7048, ,0,6,0,1107449,11,371,366,-654,5
2025-09-19,3711,177,1,1107449,239,6331,6394, ,0,8,0,1107449,11,374,371,-63,3
2025-09-22,3711,1064,0,1107449,459,6936,6331, ,1,11,0,1107449,14,377,374,605,3
2025-09-23,3711,459,4,1107449,1288,6103,6936, ,2,8,0,1107449,12,381,377,-833,4
2025-06-25,4536,9,0,22705,25,608,624, ,0,0,0,22705,0,21,21,-16,0
2025-06-26,4536,9,28,22705,14,575,608, ,0,1,0,22705,0,20,21,-33,-1
2025-06-27,4536,5,0,22705,1,579,575, ,0,1,0,22705,0,19,20,4,-1
2025-06-30,4536,11,0,22705,18,572,579, ,0,0,0,22705,0,19,19,-7,0
2025-07-01,4536,4,0,22705,13,563,572, ,0,0,0,22705,0,19,19,-9,0
2025-07-02,4536,1,0,22705,10,554,563, ,0,0,0,22705,0,19,19,-9,0
2025-07-03,4536,10,0,22705,29,535,554, ,0,0,0,22705,0,19,19,-19,0
2025-07-04,4536,10,0,22705,12,533,535, ,0,0,0,22705,0,19,19,-2,0
2025-07-07,4536,9,0,22705,12,530,533, ,0,0,0,22705,0,19,19,-3,0
2025-07-08,4536,36,0,22705,14,552,530, ,0,15,0,22705,0,4,19,22,-15
2025-07-09,4536,3,0,22705,16,539,552,X ,0,4,0,22705,0,0,4,-13,-4
2025-07-10,4536,17,0,22705,8,548,539,X ,0,0,0,22705,0,0,0,9,0
2025-07-11,4536,22,0,22705,6,564,548,X ,0,0,0,22705,0,0,0,16,0
2025-07-14,4536,55,0,22705,3,616,564,X ,0,0,0,22705,0,0,0,52,0
2025-07-15,4536,20,0,22705,33,603,616, ,0,0,0,22705,0,0,0,-13,0
2025-07-16,4536,39,0,22705,28,614,603, ,10,0,0,22705,14,14,0,11,14
2025-07-17,4536,14,1,22705,60,567,614, ,0,0,0,22705,4,18,14,-47,4
2025-07-18,4536,30,0,22705,8,589,567, ,0,0,0,22705,0,18,18,22,0
2025-07-21,4536,10,0,22705,33,566,589, ,0,3,0,22705,0,15,18,-23,-3
2025-07-22,4536,37,0,22705,42,561,566, ,0,3,0,22705,0,12,15,-5,-3
2025-07-23,4536,16,0,22705,46,531,561, ,0,0,0,22705,0,12,12,-30,0
2025-07-24,4536,12,0,22705,14,529,531, ,0,0,0,22705,0,12,12,-2,0
2025-07-25,4536,9,0,22705,6,532,529, ,0,0,0,22705,0,12,12,3,0
2025-07-28,4536,10,0,22705,7,535,532, ,0,1,0,22705,0,11,12,3,-1
2025-07-29,4536,5,0,22705,22,518,535, ,0,0,0,22705,0,11,11,-17,0
2025-07-30,4536,4,0,22705,15,507,518, ,0,0,0,22705,0,11,11,-11,0
2025-07-31,4536,1,0,22705,0,508,507, ,0,10,0,22705,0,1,11,1,-10
2025-08-01,4536,1,0,22705,15,494,508, ,0,0,0,22705,0,1,1,-14,0
2025-08-04,4536,2,0,22705,2,494,494, ,0,1,0,22705,0,0,1,0,-1
2025-08-05,4536,1,2,22705,10,483,494, ,0,0,0,22705,0,0,0,-11,0
2025-08-06,4536,5,0,22705,0,488,483, ,0,0,0,22705,0,0,0,5,0
2025-08-07,4536,0,0,22705,35,453,488, ,0,0,0,22705,0,0,0,-35,0
2025-08-08,4536,6,0,22705,8,451,453, ,0,0,0,22705,0,0,0,-2,0
2025-08-11,4536,39,0,22705,21,469,451, ,0,0,0,22705,8,8,0,18,8
2025-08-12,4536,51,0,22705,40,480,469, ,0,8,0,22705,0,0,8,11,-8
2025-08-13,4536,23,0,22705,41,462,480, ,0,0,0,22705,0,0,0,-18,0
2025-08-14,4536,23,0,22705,41,444,462, ,0,0,0,22705,0,0,0,-18,0
2025-08-15,4536,8,1,22705,12,439,444, ,0,0,0,22705,0,0,0,-5,0
2025-08-18,4536,25,0,22705,28,436,439, ,0,0,0,22705,0,0,0,-3,0
2025-08-19,4536,29,0,22705,10,455,436, ,0,0,0,22705,0,0,0,19,0
2025-08-20,4536,7,0,22705,9,453,455, ,0,0,0,22705,0,0,0,-2,0
2025-08-21,4536,9,0,22705,4,458,453, ,0,0,0,22705,0,0,0,5,0
2025-08-22,4536,8,0,22705,19,447,458, ,0,0,0,22705,0,0,0,-11,0
2025-08-25,4536,26,0,22705,30,443,447, ,0,0,0,22705,0,0,0,-4,0
2025-08-26,4536,12,1,22705,35,419,443, ,0,0,0,22705,0,0,0,-24,0
2025-08-27,4536,10,0,22705,29,400,419, ,0,0,0,22705,0,0,0,-19,0
2025-08-28,4536,55,0,22705,15,440,400, ,0,0,0,22705,0,0,0,40,0
2025-08-29,4536,48,0,22705,6,482,440, ,0,0,0,22705,0,0,0,42,0
2025-09-01,4536,22,0,22705,25,479,482, ,0,0,0,22705,0,0,0,-3,0
2025-09-02,4536,22,0,22705,14,487,479, ,0,0,0,22705,0,0,0,8,0
2025-09-03,4536,8,0,22705,18,477,487, ,0,0,0,22705,0,0,0,-10,0
2025-09-04,4536,117,0,22705,56,538,477, ,0,0,0,22705,0,0,0,61,0
2025-09-05,4536,48,0,22705,35,551,538, ,0,0,0,22705,0,0,0,13,0
2025-09-08,4536,38,0,22705,54,535,551, ,0,0,0,22705,0,0,0,-16,0
2025-09-09,4536,16,0,22705,19,532,535, ,0,0,0,22705,0,0,0,-3,0
2025-09-10,4536,1,0,22705,48,485,532, ,0,0,0,22705,0,0,0,-47,0
2025-09-11,4536,41,0,22705,44,482,485, ,0,0,0,22705,0,0,0,-3,0
2025-09-12,4536,2,0,22705,9,475,482, ,0,0,0,22705,0,0,0,-7,0
2025-09-15,4536,1,0,22705,17,459,475, ,0,0,0,22705,0,0,0,-16,0
2025-09-16,4536,3,0,22705,3,459,459, ,0,0,0,22705,0,0,0,0,0
2025-09-17,4536,27,0,22705,15,471,459, ,0,0,0,22705,0,0,0,12,0
2025-09-18,4536,30,0,22705,20,481,471, ,0,0,0,22705,0,0,0,10,0
2025-09-19,4536,13,0,22705,8,486,481, ,0,0,0,22705,0,0,0,5,0
2025-09-22,4536,54,0,22705,41,499,486, ,0,0,0,22705,0,0,0,13,0
2025-09-23,4536,11,1,22705,35,474,499, ,0,0,0,22705,0,0,0,-25,0
2025-06-25,4722,252,0,25264,253,3580,3581, ,3,9,0,25264,11,196,194,-1,2
2025-06-26,4722,266,0,25264,451,3395,3580, ,3,46,0,25264,29,179,196,-185,-17
2025-06-27,4722,120,0,25264,463,3052,3395, ,0,21,0,25264,25,183,179,-343,4
2025-06-30,4722,119,0,25264,67,3104,3052, ,3,8,0,25264,40,215,183,52,32
2025-07-01,4722,95,0,25264,205,2994,3104, ,0,28,0,25264,18,205,215,-110,-10
2025-07-02,4722,43,0,25264,69,2968,2994, ,5,8,0,25264,6,203,205,-26,-2
2025-07-03,4722,122,0,25264,128,2962,2968, ,0,12,0,25264,4,195,203,-6,-8
2025-07-04,4722,73,0,25264,49,2986,2962, ,0,21,0,25264,4,178,195,24,-17
2025-07-07,4722,21,0,25264,133,2874,2986, ,0,13,0,25264,1,166,178,-112,-12
2025-07-08,4722,70,0,25264,98,2846,2874, ,0,14,0,25264,3,155,166,-28,-11
2025-07-09,4722,65,0,25264,47,2864,2846, ,1,7,0,25264,6,154,155,18,-1
2025-07-10,4722,103,0,25264,38,2929,2864, ,0,15,0,25264,8,147,154,65,-7
2025-07-11,4722,59,0,25264,77,2911,2929, ,0,53,0,25264,8,102,147,-18,-45
2025-07-14,4722,53,0,25264,53,2911,2911, ,0,11,0,25264,10,101,102,0,-1
2025-07-15,4722,321,1,25264,310,2921,2911, ,1,10,0,25264,32,123,101,10,22
2025-07-16,4722,284,0,25264,227,2978,2921, ,3,6,0,25264,17,134,123,57,11
2025-07-17,4722,162,0,25264,133,3007,2978, ,1,3,0,25264,12,143,134,29,9
2025-07-18,4722,80,0,25264,163,2924,3007, ,0,8,0,25264,11,146,143,-83,3
2025-07-21,4722,172,0,25264,106,2990,2924, ,0,20,0,25264,8,134,146,66,-12
2025-07-22,4722,68,0,25264,192,2855,2979, ,0,19,0,25264,8,123,134,-124,-11
2025-07-23,4722,108,21,25264,65,2877,2855, ,0,29,0,25264,21,115,123,22,-8
2025-07-24,4722,75,0,25264,28,2924,2877, ,0,4,0,25264,1,112,115,47,-3
2025-07-25,4722,15,0,25264,32,2907,2924, ,0,0,0,25264,1,113,112,-17,1
2025-07-28,4722,368,0,25264,178,3097,2907, ,5,6,0,25264,11,118,113,190,5
2025-07-29,4722,660,0,25264,504,3253,3097, ,14,9,0,25264,9,118,118,156,0
2025-07-30,4722,184,0,25264,163,3274,3253, ,2,2,0,25264,12,128,118,21,10
2025-07-31,4722,271,0,25264,220,3325,3274, ,10,11,0,25264,3,120,128,51,-8
2025-08-01,4722,424,0,25264,234,3515,3325, ,5,0,0,25264,5,125,120,190,5
2025-08-04,4722,256,0,25264,149,3622,3515, ,1,2,0,25264,23,146,125,107,21
2025-08-05,4722,680,5,25264,377,3920,3622, ,9,3,0,25264,20,163,146,298,17
2025-08-06,4722,135,4,25264,304,3747,3920, ,0,0,0,25264,15,178,163,-173,15
2025-08-07,4722,184,0,25264,195,3736,3747, ,2,24,0,25264,9,163,178,-11,-15
2025-08-08,4722,159,0,25264,311,3584,3736, ,4,22,0,25264,2,143,163,-152,-20
2025-08-11,4722,1321,0,25264,834,4071,3584, ,16,13,0,25264,86,216,143,487,73
2025-08-12,4722,847,0,25264,605,4313,4071, ,5,4,0,25264,281,493,216,242,277
2025-08-13,4722,1288,1,25264,2033,3567,4313, ,55,239,0,25264,27,281,493,-746,-212
2025-08-14,4722,738,0,25324,343,3962,3567, ,5,31,0,25324,8,258,281,395,-23
2025-08-15,4722,1531,0,25324,548,4945,3962, ,16,20,1,25324,22,259,258,983,1
2025-08-18,4722,2095,0,25324,857,6183,4945, ,10,33,0,25324,100,326,259,1238,67
2025-08-19,4722,2790,0,25324,1871,7102,6183, ,3,65,0,25324,106,367,326,919,41
2025-08-20,4722,5002,2,25324,2957,9145,7102, ,44,79,0,25324,707,995,367,2043,628
2025-08-21,4722,1822,5,25324,1214,9748,9145, ,847,503,6,25324,43,529,995,603,-466
2025-08-22,4722,1373,1,25324,718,10402,9748, ,286,74,0,25324,21,476,529,654,-53
2025-08-25,4722,1311,0,25324,439,11274,10402, ,599,16,62,25324,1090,1488,476,872,1012
2025-08-26,4722,134,0,25324,627,10781,11274, ,307,580,0,25324,294,1202,1488,-493,-286
2025-08-27,4722,65,0,25324,152,10694,10781, ,164,116,2,25324,16,1100,1202,-87,-102
2025-08-28,4722,35,0,25324,304,10425,10694, ,283,54,3,25324,138,1181,1100,-269,81
2025-08-29,4722,19,1,25324,370,10073,10425, ,101,56,0,25324,88,1213,1181,-352,32
2025-09-01,4722,222,20,25324,666,9609,10073, ,248,176,3,25324,12,1046,1213,-464,-167
2025-09-02,4722,350,0,25324,671,9288,9609, ,17,8,18,25324,0,1020,1046,-321,-26
2025-09-03,4722,159,0,25324,543,8904,9288, ,24,192,91,25324,10,747,1020,-384,-273
2025-09-04,4722,285,0,25324,369,8820,8904, ,9,205,37,25324,0,505,747,-84,-242
2025-09-05,4722,169,1,25324,241,8747,8820, ,24,0,0,25324,1,506,505,-73,1
2025-09-08,4722,126,0,25324,298,8575,8747, ,21,1,149,25324,1,357,506,-172,-149
2025-09-09,4722,2893,1,25324,1480,9987,8575, ,29,67,2,25324,65,353,357,1412,-4
2025-09-10,4722,992,0,25324,853,10126,9987, ,1,53,0,25324,76,376,353,139,23
2025-09-11,4722,2365,0,25324,1602,10889,10126, ,3,122,0,25324,19,273,376,763,-103
2025-09-12,4722,1243,0,25341,827,11305,10889, ,1,36,0,25341,5,242,273,416,-31
2025-09-15,4722,932,3,25341,702,11532,11305, ,3,31,0,25341,170,381,242,227,139
2025-09-16,4722,855,0,25341,1048,11339,11532, ,11,43,0,25341,122,460,381,-193,79
2025-09-17,4722,799,0,25341,768,11370,11339, ,3,121,1,25341,116,454,460,31,-6
2025-09-18,4722,1551,0,25341,794,12127,11370, ,23,163,0,25341,85,376,454,757,-78
2025-09-19,4722,2106,0,25341,977,13256,12127, ,6,31,1,25341,223,567,376,1129,191
2025-09-22,4722,778,0,25341,886,13148,13256, ,11,29,0,25341,480,1018,567,-108,451
2025-09-23,4722,4273,0,25341,1398,16023,13148, ,15,266,0,25341,51,803,1018,2875,-215
2025-06-25,4755,6,0,25176,5,345,344,X ,0,0,0,25176,0,0,0,1,0
2025-06-26,4755,15,0,25176,11,349,345, ,0,0,0,25176,0,0,0,4,0
2025-06-27,4755,5,0,25176,15,339,349, ,0,0,0,25176,0,0,0,-10,0
2025-06-30,4755,3,0,25176,4,338,339, ,0,0,0,25176,0,0,0,-1,0
2025-07-01,4755,4,0,25176,6,336,338, ,0,0,0,25176,0,0,0,-2,0
2025-07-02,4755,2,0,25176,2,336,336, ,0,0,0,25176,0,0,0,0,0
2025-07-03,4755,5,0,25176,1,340,336, ,0,0,0,25176,0,0,0,4,0
2025-07-04,4755,6,0,25176,4,342,340, ,0,0,0,25176,0,0,0,2,0
2025-07-07,4755,1,0,25176,2,341,342, ,0,0,0,25176,1,1,0,-1,1
2025-07-08,4755,0,0,25176,3,338,341, ,0,0,0,25176,0,1,1,-3,0
2025-07-09,4755,1,0,25176,2,337,338, ,0,0,0,25176,0,1,1,-1,0
2025-07-10,4755,0,0,25176,0,337,337, ,0,0,0,25176,0,1,1,0,0
2025-07-11,4755,3,0,25176,2,338,337, ,0,0,0,25176,0,1,1,1,0
2025-07-14,4755,1,0,25176,4,335,338, ,0,0,0,25176,0,1,1,-3,0
2025-07-15,4755,4,0,25176,14,325,335, ,0,0,0,25176,0,1,1,-10,0
2025-07-16,4755,9,0,25176,1,333,325, ,0,0,0,25176,0,1,1,8,0
2025-07-17,4755,10,0,25176,6,337,333, ,0,0,0,25176,2,3,1,4,2
2025-07-18,4755,12,0,25176,7,342,337, ,1,0,0,25176,0,3,3,5,0
2025-07-21,4755,0,0,25176,1,341,342, ,0,0,0,25176,0,3,3,-1,0
2025-07-22,4755,3,14,25176,7,323,341, ,0,1,0,25176,0,2,3,-18,-1
2025-07-23,4755,3,4,25176,11,311,323, ,0,0,0,25176,1,3,2,-12,1
2025-07-24,4755,12,0,25176,5,318,311, ,0,0,0,25176,0,3,3,7,0
2025-07-25,4755,1,0,25176,1,318,318, ,0,0,0,25176,1,4,3,0,1
2025-07-28,4755,4,5,25176,3,314,318, ,0,0,0,25176,1,5,4,-4,1
2025-07-29,4755,6,1,25176,13,306,314, ,0,1,0,25176,0,4,5,-8,-1
2025-07-30,4755,3,0,25176,1,308,306, ,0,0,0,25176,0,4,4,2,0
2025-07-31,4755,1,0,25176,3,306,308, ,0,0,0,25176,0,4,4,-2,0
2025-08-01,4755,0,0,25176,6,300,306, ,0,0,0,25176,0,4,4,-6,0
2025-08-04,4755,1,0,25176,1,300,300, ,0,0,0,25176,0,4,4,0,0
2025-08-05,4755,1,0,25176,1,300,300, ,0,0,0,25176,0,4,4,0,0
2025-08-06,4755,1,0,25176,4,297,300, ,0,0,0,25176,0,4,4,-3,0
2025-08-07,4755,16,0,25176,13,300,297, ,0,0,0,25176,0,4,4,3,0
2025-08-08,4755,14,0,25176,15,299,300, ,0,0,0,25176,1,5,4,-1,1
2025-08-11,4755,2,0,25176,4,297,299, ,0,0,0,25176,0,5,5,-2,0
2025-08-12,4755,4,1,25176,5,295,297, ,0,0,0,25176,0,5,5,-2,0
2025-08-13,4755,29,0,25176,12,312,295, ,0,0,0,25176,0,5,5,17,0
2025-08-14,4755,36,0,25176,9,339,312, ,0,0,0,25176,0,5,5,27,0
2025-08-15,4755,26,0,25176,4,361,339, ,0,0,0,25176,1,6,5,22,1
2025-08-18,4755,75,0,25176,24,412,361, ,1,0,0,25176,2,8,6,51,2
2025-08-19,4755,105,0,25176,32,485,412, ,0,0,0,25176,0,8,8,73,0
2025-08-20,4755,12,0,25176,18,479,485, ,0,0,0,25176,0,8,8,-6,0
2025-08-21,4755,19,0,25176,6,492,479, ,0,0,0,25176,1,9,8,13,1
2025-08-22,4755,2,0,25176,34,460,492, ,0,0,0,25176,0,9,9,-32,0
2025-08-25,4755,1,2,25176,3,456,460, ,0,0,0,25176,0,9,9,-4,0
2025-08-26,4755,9,0,25176,14,451,456, ,0,0,0,25176,0,9,9,-5,0
2025-08-27,4755,17,1,25176,47,420,451, ,0,0,0,25176,0,9,9,-31,0
2025-08-28,4755,36,0,25176,12,444,420, ,1,0,0,25176,0,9,9,24,0
2025-08-29,4755,6,0,25176,39,411,444, ,0,2,0,25176,0,7,9,-33,-2
2025-09-01,4755,60,10,25176,17,444,411, ,0,0,0,25176,3,10,7,33,3
2025-09-02,4755,7,0,25176,38,413,444, ,0,0,0,25176,0,10,10,-31,0
2025-09-03,4755,3,0,25176,15,401,413, ,0,0,0,25176,1,11,10,-12,1
2025-09-04,4755,4,0,25176,6,399,401, ,0,1,0,25176,0,10,11,-2,-1
2025-09-05,4755,0,0,25176,3,396,399, ,0,0,0,25176,0,10,10,-3,0
2025-09-08,4755,32,2,25176,21,405,396, ,0,0,0,25176,0,10,10,9,0
2025-09-09,4755,14,0,25176,7,412,405, ,0,0,0,25176,0,10,10,7,0
2025-09-10,4755,11,0,25176,8,415,412, ,0,0,0,25176,0,10,10,3,0
2025-09-11,4755,10,0,25176,15,410,415, ,0,0,0,25176,0,10,10,-5,0
2025-09-12,4755,5,0,25176,14,401,410, ,0,0,0,25176,0,10,10,-9,0
2025-09-15,4755,2,0,25176,9,394,401, ,0,0,0,25176,0,10,10,-7,0
2025-09-16,4755,0,28,25176,0,366,394, ,0,0,0,25176,0,10,10,-28,0
2025-09-17,4755,0,0,25176,18,348,366, ,0,0,0,25176,0,10,10,-18,0
2025-09-18,4755,16,0,25176,11,353,348, ,0,0,0,25176,0,10,10,5,0
2025-09-19,4755,10,0,25176,11,352,353, ,0,0,0,25176,0,10,10,-1,0
2025-09-22,4755,12,0,25176,8,356,352, ,0,0,0,25176,0,10,10,4,0
2025-09-23,4755,21,0,25176,3,374,356, ,0,0,0,25176,0,10,10,18,0
2025-06-25,5469,198,0,121541,388,9089,9279, ,0,19,0,121541,1,215,233,-190,-18
2025-06-26,5469,222,0,121541,362,8948,9088, ,2,3,0,121541,18,230,215,-140,15
2025-06-27,5469,998,0,121541,328,9618,8948, ,11,32,0,121541,12,210,230,670,-20
2025-06-30,5469,243,0,121541,474,9385,9616, ,8,12,0,121541,38,236,210,-231,26
2025-07-01,5469,515,2,121541,398,9499,9384, ,4,47,0,121541,1,190,236,115,-46
2025-07-02,5469,153,0,121541,257,9394,9498,X ,2,15,1,121541,1,175,190,-104,-15
2025-07-03,5469,232,0,121541,292,9333,9393,X ,0,175,0,121541,0,0,175,-60,-175
2025-07-04,5469,194,0,121541,339,9188,9333,X ,0,0,0,121541,0,0,0,-145,0
2025-07-07,5469,442,0,121541,201,9429,9188,X ,0,0,0,121541,0,0,0,241,0
2025-07-08,5469,150,0,121541,222,9357,9429, ,0,0,0,121541,0,0,0,-72,0
2025-07-09,5469,171,0,121541,527,9001,9357, ,38,0,0,121541,21,21,0,-356,21
2025-07-10,5469,149,0,121541,114,9036,9001, ,6,6,0,121541,8,23,21,35,2
2025-07-11,5469,580,0,121541,516,9100,9036, ,2,1,0,121541,20,42,23,64,19
2025-07-14,5469,341,0,121541,220,9220,9099, ,0,7,0,121541,2,37,42,121,-5
2025-07-15,5469,652,0,121541,433,9439,9220, ,1,11,0,121541,25,51,37,219,14
2025-07-16,5469,760,0,121541,855,9344,9439, ,19,1,0,121541,12,62,51,-95,11
2025-07-17,5469,541,0,121541,506,9379,9344, ,3,2,0,121541,90,150,62,35,88
2025-07-18,5469,392,0,121541,505,9266,9379, ,5,48,0,121541,7,109,150,-113,-41
2025-07-21,5469,683,0,121541,717,9232,9266, ,2,0,0,121541,34,143,109,-34,34
2025-07-22,5469,1760,0,121541,870,10123,9233, ,23,34,0,121541,26,135,143,890,-8
2025-07-23,5469,1171,1,121541,1207,10086,10123, ,6,8,0,121541,115,242,135,-37,107
2025-07-24,5469,1149,2,121541,819,10412,10084, ,24,27,0,121541,21,236,242,328,-6
2025-07-25,5469,404,102,121541,576,10138,10412, ,6,6,0,121541,29,259,236,-274,23
2025-07-28,5469,1290,1,121541,1070,10356,10137, ,58,6,0,121541,68,321,259,219,62
2025-07-29,5469,567,0,121541,1397,9525,10355, ,3,19,0,121541,13,315,321,-830,-6
2025-07-30,5469,540,1,121541,553,9510,9524, ,8,31,0,121541,47,331,315,-14,16
2025-07-31,5469,646,1,121541,541,9614,9510, ,10,7,0,121541,58,382,331,104,51
2025-08-01,5469,369,1,121541,877,9102,9611, ,2,5,0,121541,12,389,382,-509,7
2025-08-04,5469,373,0,121541,305,9169,9101, ,0,68,0,121541,17,338,389,68,-51
2025-08-05,5469,288,0,121541,317,9140,9169, ,4,2,0,121541,18,354,338,-29,16
2025-08-06,5469,360,1,121541,208,9291,9140, ,10,33,0,121541,32,353,354,151,-1
2025-08-07,5469,980,0,121541,1033,9238,9291, ,30,194,0,121541,34,193,353,-53,-160
2025-08-08,5469,397,0,121541,218,9417,9238, ,3,35,1,121541,43,200,193,179,7
2025-08-11,5469,160,0,121541,428,9149,9417, ,1,37,0,121541,31,194,200,-268,-6
2025-08-12,5469,282,0,121541,414,9017,9149, ,1,21,0,121541,10,183,194,-132,-11
2025-08-13,5469,302,0,121541,548,8771,9017, ,3,2,0,121541,24,205,183,-246,22
2025-08-14,5469,775,0,121541,655,8890,8770, ,14,7,0,121541,33,231,205,120,26
2025-08-15,5469,556,17,121541,243,9186,8890, ,1,10,0,121541,1,222,231,296,-9
2025-08-18,5469,874,0,121541,999,9061,9186, ,4,3,0,121541,31,250,222,-125,28
2025-08-19,5469,1587,0,121541,670,9977,9060, ,6,6,0,121541,10,254,250,917,4
2025-08-20,5469,485,0,121541,728,9734,9977, ,0,24,0,121541,21,251,254,-243,-3
2025-08-21,5469,775,0,121541,269,10239,9733, ,1,5,10,121541,30,266,251,506,15
2025-08-22,5469,218,0,121541,297,10160,10239, ,0,15,0,121541,4,255,266,-79,-11
2025-08-25,5469,1949,0,121541,812,11297,10160, ,9,8,0,121541,67,314,255,1137,59
2025-08-26,5469,1098,0,121541,537,11855,11294, ,7,34,0,121541,2,282,314,561,-32
2025-08-27,5469,975,0,121541,1469,11361,11855, ,5,12,0,121541,125,395,282,-494,113
2025-08-28,5469,3152,0,121541,974,13538,11360, ,184,75,0,121541,12,332,395,2178,-63
2025-08-29,5469,2310,1,121541,1704,14141,13536, ,28,32,0,121541,350,650,332,605,318
2025-09-01,5469,5427,0,121541,1578,17990,14141, ,140,322,0,121541,80,408,650,3849,-242
2025-09-02,5469,1386,0,121541,753,18623,17990, ,33,114,0,121541,17,311,408,633,-97
2025-09-03,5469,2084,0,121541,878,19829,18623, ,26,3,0,121541,90,398,311,1206,87
2025-09-04,5469,1351,1,121541,1115,20064,19829, ,23,71,0,121541,492,819,398,235,421
2025-09-05,5469,596,3,121541,349,20308,20064, ,4,67,0,121541,204,956,819,244,137
2025-09-08,5469,473,51,121541,431,20298,20307, ,2,40,0,121541,137,1053,956,-9,97
2025-09-09,5469,515,0,121541,279,20534,20298, ,0,11,0,121541,234,1276,1053,236,223
2025-09-10,5469,979,0,121541,496,21017,20534, ,6,9,0,121541,114,1381,1276,483,105
2025-09-11,5469,634,1,121541,840,20810,21017, ,6,21,0,121541,27,1387,1381,-207,6
2025-09-12,5469,207,5,121541,253,20759,20810, ,13,255,1,121541,23,1154,1387,-51,-233
2025-09-15,5469,357,26,121541,802,20288,20759, ,16,328,0,121541,32,858,1154,-471,-296
2025-09-16,5469,634,2,121541,205,20714,20287, ,2,268,10,121541,72,652,858,427,-206
2025-09-17,5469,2181,0,121541,1139,21756,20714, ,138,5,0,121541,684,1331,652,1042,679
2025-09-18,5469,4037,1,121541,2044,23748,21756, ,18,17,0,121541,249,1563,1331,1992,232
2025-09-19,5469,4138,25,121541,3960,23900,23747, ,16,16,0,121541,929,2476,1563,153,913
2025-09-22,5469,3359,0,121541,3242,24015,23898, ,49,48,11,121541,698,3115,2476,117,639
2025-09-23,5469,2531,0,121541,4752,21794,24015, ,51,382,0,121541,66,2799,3115,-2221,-316
2025-06-25,6116,873,0,735082,58,31649,30834, ,0,7,0,735082,0,114,121,815,-7
2025-06-26,6116,212,5,735082,1557,30299,31649, ,12,0,3,735082,53,164,114,-1350,50
2025-06-27,6116,619,58,735082,387,30473,30299, ,14,2,0,735082,52,214,164,174,50
2025-06-30,6116,1209,0,735082,320,31362,30473, ,5,62,0,735082,2,154,214,889,-60
2025-07-01,6116,120,13,735082,471,30998,31362, ,6,2,0,735082,1,153,154,-364,-1
2025-07-02,6116,184,7,735082,23,31152,30998, ,0,12,0,735082,0,141,153,154,-12
2025-07-03,6116,55,0,735082,550,30657,31152, ,2,20,0,735082,201,322,141,-495,181
2025-07-04,6116,555,4,735082,40,31168,30657, ,0,178,0,735082,0,144,322,511,-178
2025-07-07,6116,493,4,735082,29,31628,31168, ,2,35,0,735082,2,111,144,460,-33
2025-07-08,6116,290,1,735082,67,31850,31628, ,2,22,0,735082,13,102,111,222,-9
2025-07-09,6116,243,3,735082,53,32037,31850, ,0,3,0,735082,21,120,102,187,18
2025-07-10,6116,702,3,735082,258,32478,32037, ,36,58,0,735082,0,62,120,441,-58
2025-07-11,6116,289,24,735082,60,32683,32478, ,6,1,1,735082,2,62,62,205,0
2025-07-14,6116,40,15,735082,61,32647,32683, ,0,0,0,735082,2,64,62,-36,2
2025-07-15,6116,150,1,735082,64,32732,32647, ,1,31,0,735082,3,36,64,85,-28
2025-07-16,6116,267,40,735082,505,32454,32732, ,0,5,0,735082,1,32,36,-278,-4
2025-07-17,6116,212,25,735082,588,32053,32454, ,0,2,0,735082,2,32,32,-401,0
2025-07-18,6116,522,197,735082,257,32121,32053, ,0,0,1,735082,2,33,32,68,1
2025-07-21,6116,162,50,735082,216,32017,32121, ,2,0,0,735082,3,36,33,-104,3
2025-07-22,6116,694,12,735082,90,32609,32017, ,2,0,4,735082,8,40,36,592,4
2025-07-23,6116,66,0,735082,902,31773,32609, ,6,5,0,735082,66,101,40,-836,61
2025-07-24,6116,50,4,735082,113,31706,31773, ,0,13,0,735082,4,92,101,-67,-9
2025-07-25,6116,117,4,735082,574,31245,31706, ,2,6,0,735082,32,118,92,-461,26
2025-07-28,6116,1438,12,735082,1940,30731,31245, ,94,1,0,735082,132,249,118,-514,131
2025-07-29,6116,597,1,735082,396,30931,30731, ,2,79,0,735082,31,201,249,200,-48
2025-07-30,6116,288,150,735082,465,30604,30931, ,0,37,0,735082,32,196,201,-327,-5
2025-07-31,6116,593,5,735082,482,30710,30604, ,0,73,0,735082,11,134,196,106,-62
2025-08-01,6116,332,7,735082,384,30651,30710, ,1,3,10,735082,2,123,134,-59,-11
2025-08-04,6116,410,30,735082,65,30966,30651, ,0,42,0,735082,16,97,123,315,-26
2025-08-05,6116,209,10,735082,302,30863,30966, ,1,0,0,735082,31,128,97,-103,31
2025-08-06,6116,144,3,735082,618,30386,30863, ,0,25,0,735082,16,119,128,-477,-9
2025-08-07,6116,337,1,735082,168,30554,30386, ,0,13,0,735082,2,108,119,168,-11
2025-08-08,6116,576,30,735082,158,30942,30554, ,0,6,0,735082,0,102,108,388,-6
2025-08-11,6116,18,0,735082,621,30339,30942, ,2,0,0,735082,2,104,102,-603,2
2025-08-12,6116,203,0,735082,1719,28823,30339, ,0,0,0,735082,16,120,104,-1516,16
2025-08-13,6116,74,5,735082,678,28214,28823, ,0,8,0,735082,20,132,120,-609,12
2025-08-14,6116,345,9,735082,191,28359,28214, ,0,0,0,735082,1,133,132,145,1
2025-08-15,6116,69,27,735082,765,27636,28359, ,0,0,0,735082,34,167,133,-723,34
2025-08-18,6116,733,2,735082,2173,26194,27636, ,0,3,0,735082,46,210,167,-1442,43
2025-08-19,6116,301,12,735082,90,26393,26194, ,0,12,0,735082,19,217,210,199,7
2025-08-20,6116,881,10,735082,109,27155,26393, ,0,50,0,735082,26,193,217,762,-24
2025-08-21,6116,644,111,735082,1510,26178,27155, ,1,1,0,735082,48,240,193,-977,47
2025-08-22,6116,660,1,735082,192,26645,26178, ,1,34,0,735082,1,207,240,467,-33
2025-08-25,6116,531,14,735082,293,26869,26645, ,1,3,0,735082,2,206,207,224,-1
2025-08-26,6116,518,112,735082,213,27062,26869, ,1,8,0,735082,2,200,206,193,-6
2025-08-27,6116,217,1,735082,503,26775,27062, ,0,1,0,735082,9,208,200,-287,8
2025-08-28,6116,524,2,735082,1005,26292,26775, ,1,1,0,735082,24,231,208,-483,23
2025-08-29,6116,569,0,735082,168,26693,26292, ,0,9,0,735082,0,222,231,401,-9
2025-09-01,6116,700,0,735082,434,26959,26693, ,1,17,0,735082,0,205,222,266,-17
2025-09-02,6116,160,0,735082,427,26692,26959, ,2,13,0,735082,1,193,205,-267,-12
2025-09-03,6116,1577,2,735082,294,27973,26692, ,2,73,0,735082,20,140,193,1281,-53
2025-09-04,6116,348,10,735082,538,27773,27973, ,0,0,0,735082,27,167,140,-200,27
2025-09-05,6116,950,151,735082,522,28050,27773, ,1,21,3,735082,26,169,167,277,2
2025-09-08,6116,1077,4,735082,287,28836,28050, ,2,0,0,735082,14,183,169,786,14
2025-09-09,6116,688,10,735082,983,28531,28836, ,0,31,0,735082,31,183,183,-305,0
2025-09-10,6116,514,16,735082,361,28668,28531, ,1,16,0,735082,0,167,183,137,-16
2025-09-11,6116,842,2,735082,385,29123,28668, ,0,10,4,735082,0,153,167,455,-14
2025-09-12,6116,126,4,735082,693,28552,29123, ,0,20,0,735082,28,161,153,-571,8
2025-09-15,6116,450,0,735082,222,28780,28552, ,4,17,0,735082,0,144,161,228,-17
2025-09-16,6116,354,70,735082,194,28870,28780, ,2,1,0,735082,0,143,144,90,-1
2025-09-17,6116,1041,0,735082,2383,27528,28870, ,21,0,0,735082,93,236,143,-1342,93
2025-09-18,6116,1532,0,735082,2346,26714,27528, ,10,0,0,735082,145,381,236,-814,145
2025-09-19,6116,1076,92,735082,563,27135,26714, ,0,48,0,735082,19,352,381,421,-29
2025-09-22,6116,1050,0,735082,954,27231,27135, ,1,51,0,735082,17,318,352,96,-34
2025-09-23,6116,898,100,735082,958,27071,27231, ,7,1,0,735082,29,346,318,-160,28
2025-06-25,6515,83,2,8962,57,958,934, ,0,3,0,8962,1,226,228,24,-2
2025-06-26,6515,85,0,8962,88,955,958, ,0,10,0,8962,0,216,226,-3,-10
2025-06-27,6515,41,0,8962,34,962,955, ,0,79,0,8962,2,139,216,7,-77
2025-06-30,6515,51,0,8962,104,909,962,X ,0,18,0,8962,4,125,139,-53,-14
2025-07-01,6515,50,0,8962,54,905,909,X ,0,125,0,8962,0,0,125,-4,-125
2025-07-02,6515,60,4,8962,91,870,905,X ,0,0,0,8962,0,0,0,-35,0
2025-07-03,6515,74,0,8962,126,818,870,X ,0,0,0,8962,0,0,0,-52,0
2025-07-04,6515,97,3,8962,106,806,818, ,0,0,0,8962,0,0,0,-12,0
2025-07-07,6515,57,0,8962,36,827,806, ,2,0,0,8962,25,25,0,21,25
2025-07-08,6515,231,0,8962,118,940,827, ,13,20,0,8962,36,41,25,113,16
2025-07-09,6515,55,0,8962,42,953,940, ,1,33,0,8962,5,13,41,13,-28
2025-07-10,6515,88,0,8962,68,973,953, ,0,3,0,8962,2,12,13,20,-1
2025-07-11,6515,58,0,8962,27,1004,973, ,0,1,0,8962,1,12,12,31,0
2025-07-14,6515,22,0,8962,37,989,1004, ,0,0,0,8962,8,20,12,-15,8
2025-07-15,6515,40,0,8962,18,1011,989, ,0,0,0,8962,1,21,20,22,1
2025-07-16,6515,81,1,8962,31,1060,1011, ,0,1,0,8962,0,20,21,49,-1
2025-07-17,6515,34,0,8962,27,1067,1060, ,0,1,0,8962,1,20,20,7,0
2025-07-18,6515,30,5,8962,12,1080,1067, ,0,1,0,8962,1,20,20,13,0
2025-07-21,6515,128,0,8962,58,1150,1080, ,1,2,0,8962,69,87,20,70,67
2025-07-22,6515,44,0,8962,103,1091,1150, ,0,39,0,8962,3,51,87,-59,-36
2025-07-23,6515,34,1,8962,8,1116,1091, ,0,18,0,8962,11,44,51,25,-7
2025-07-24,6515,86,0,8962,19,1183,1116, ,0,11,0,8962,2,35,44,67,-9
2025-07-25,6515,413,1,8962,179,1416,1183, ,1,17,0,8962,42,60,35,233,25
2025-07-28,6515,276,2,8962,305,1385,1416, ,0,18,0,8962,50,92,60,-31,32
2025-07-29,6515,191,0,8962,141,1435,1385, ,1,10,0,8962,8,90,92,50,-2
2025-07-30,6515,71,2,8962,36,1468,1435, ,0,2,1,8962,0,87,90,33,-3
2025-07-31,6515,101,0,8962,130,1439,1468, ,0,4,0,8962,1,84,87,-29,-3
2025-08-01,6515,71,0,8962,83,1427,1439, ,1,6,16,8962,5,67,84,-12,-17
2025-08-04,6515,106,8,8962,59,1466,1427, ,0,42,0,8962,25,50,67,39,-17
2025-08-05,6515,31,3,8962,72,1422,1466, ,1,4,0,8962,0,46,50,-44,-4
2025-08-06,6515,140,0,8962,240,1322,1422, ,2,17,0,8962,13,42,46,-100,-4
2025-08-07,6515,229,0,8962,171,1380,1322, ,0,3,0,8962,1,40,42,58,-2
2025-08-08,6515,63,0,8962,63,1380,1380, ,0,0,0,8962,0,40,40,0,0
2025-08-11,6515,29,0,8962,94,1315,1380, ,0,3,0,8962,5,42,40,-65,2
2025-08-12,6515,86,0,8962,60,1341,1315, ,0,5,0,8962,0,37,42,26,-5
2025-08-13,6515,105,0,8962,108,1338,1341, ,1,1,0,8962,13,49,37,-3,12
2025-08-14,6515,300,0,8962,299,1339,1338, ,2,4,0,8962,12,57,49,1,8
2025-08-15,6515,167,1,8962,252,1253,1339, ,0,7,0,8962,0,50,57,-86,-7
2025-08-18,6515,77,0,8962,64,1266,1253, ,7,9,0,8962,0,41,50,13,-9
2025-08-19,6515,86,0,8962,96,1256,1266, ,1,7,0,8962,0,34,41,-10,-7
2025-08-20,6515,85,2,8962,140,1199,1256, ,0,4,0,8962,1,31,34,-57,-3
2025-08-21,6515,91,0,8962,28,1262,1199, ,0,0,0,8962,1,32,31,63,1
2025-08-22,6515,21,1,8962,62,1220,1262, ,0,11,0,8962,0,21,32,-42,-11
2025-08-25,6515,69,0,8962,47,1242,1220, ,0,0,0,8962,5,26,21,22,5
2025-08-26,6515,32,0,8962,42,1232,1242, ,0,1,0,8962,1,26,26,-10,0
2025-08-27,6515,306,0,8962,245,1293,1232, ,1,8,0,8962,9,27,26,61,1
2025-08-28,6515,390,0,8962,222,1461,1293, ,8,5,0,8962,3,25,27,168,-2
2025-08-29,6515,385,0,8962,331,1515,1461, ,0,3,0,8962,26,48,25,54,23
2025-09-01,6515,363,1,8962,550,1327,1515, ,11,1,0,8962,52,99,48,-188,51
2025-09-02,6515,218,0,8962,396,1149,1327, ,1,12,0,8962,9,96,99,-178,-3
2025-09-03,6515,178,11,8962,162,1154,1149, ,1,9,10,8962,64,141,96,5,45
2025-09-04,6515,89,0,8962,41,1202,1154, ,26,20,0,8962,20,141,141,48,0
2025-09-05,6515,113,0,8962,31,1284,1202, ,21,13,0,8962,33,161,141,82,20
2025-09-08,6515,94,0,8962,102,1276,1284, ,32,13,0,8962,9,157,161,-8,-4
2025-09-09,6515,115,0,8962,41,1350,1276, ,19,8,0,8962,9,158,157,74,1
2025-09-10,6515,102,1,8962,84,1367,1350, ,23,4,0,8962,2,156,158,17,-2
2025-09-11,6515,166,0,8962,113,1420,1367, ,41,10,0,8962,1,147,156,53,-9
2025-09-12,6515,82,1,8962,139,1362,1420, ,24,9,0,8962,4,142,147,-58,-5
2025-09-15,6515,77,1,8962,93,1345,1362, ,31,5,0,8962,0,137,142,-17,-5
2025-09-16,6515,92,5,8962,69,1363,1345, ,24,0,19,8962,8,126,137,18,-11
2025-09-17,6515,92,0,8962,87,1368,1363, ,30,4,0,8962,4,126,126,5,0
2025-09-18,6515,271,0,8962,154,1485,1368, ,5,6,1,8962,27,146,126,117,20
2025-09-19,6515,186,0,8962,216,1455,1485, ,1,15,0,8962,10,141,146,-30,-5
2025-09-22,6515,183,0,8962,188,1450,1455, ,2,4,1,8962,21,157,141,-5,16
2025-09-23,6515,96,0,8962,178,1368,1450, ,2,8,1,8962,5,153,157,-82,-4
2025-06-25,6719,61,0,21096,174,2716,2829, ,0,1,0,21096,0,12,13,-113,-1
2025-06-26,6719,17,8,21096,9,2716,2716, ,0,0,0,21096,0,12,12,0,0
2025-06-27,6719,45,3,21096,37,2721,2716, ,0,2,0,21096,2,12,12,5,0
2025-06-30,6719,60,4,21096,31,2746,2721, ,0,2,0,21096,0,10,12,25,-2
2025-07-01,6719,6,2,21096,10,2740,2746, ,0,0,0,21096,0,10,10,-6,0
2025-07-02,6719,16,2,21096,17,2737,2740, ,0,2,0,21096,0,8,10,-3,-2
2025-07-03,6719,12,14,21096,16,2719,2737, ,0,0,0,21096,0,8,8,-18,0
2025-07-04,6719,35,11,21096,9,2734,2719, ,0,0,0,21096,0,8,8,15,0
2025-07-07,6719,52,10,21096,10,2766,2734, ,0,4,0,21096,0,4,8,32,-4
2025-07-08,6719,41,1,21096,20,2786,2766, ,0,0,0,21096,0,4,4,20,0
2025-07-09,6719,113,0,21096,13,2886,2786, ,0,0,0,21096,0,4,4,100,0
2025-07-10,6719,150,8,21096,33,2995,2886,X ,0,1,0,21096,4,7,4,109,3
2025-07-11,6719,67,1,21096,22,3039,2995,X ,0,7,0,21096,0,0,7,44,-7
2025-07-14,6719,67,0,21113,13,3093,3039,X ,0,0,0,21113,0,0,0,54,0
2025-07-15,6719,127,0,21113,22,3198,3093,X ,0,0,0,21113,0,0,0,105,0
2025-07-16,6719,58,1,21113,35,3220,3198, ,0,0,0,21113,0,0,0,22,0
2025-07-17,6719,189,3,21113,42,3364,3220, ,0,0,0,21113,3,3,0,144,3
2025-07-18,6719,50,0,21113,30,3384,3364, ,0,1,0,21113,0,2,3,20,-1
2025-07-21,6719,20,3,21113,26,3375,3384, ,0,1,0,21113,0,1,2,-9,-1
2025-07-22,6719,44,0,21113,60,3359,3375, ,0,0,0,21113,1,2,1,-16,1
2025-07-23,6719,6,0,21113,7,3358,3359, ,1,1,0,21113,0,1,2,-1,-1
2025-07-24,6719,7,16,21113,9,3340,3358, ,0,0,0,21113,0,1,1,-18,0
2025-07-25,6719,21,1,21113,7,3353,3340, ,0,0,0,21113,0,1,1,13,0
2025-07-28,6719,12,0,21113,11,3354,3353, ,1,0,0,21113,2,3,1,1,2
2025-07-29,6719,16,1,21113,7,3362,3354, ,0,0,0,21113,0,3,3,8,0
2025-07-30,6719,7,0,21113,33,3336,3362, ,1,0,0,21113,0,3,3,-26,0
2025-07-31,6719,12,3,21113,37,3308,3336, ,0,0,0,21113,9,12,3,-28,9
2025-08-01,6719,3,0,21113,13,3298,3308, ,0,1,0,21113,4,15,12,-10,3
2025-08-04,6719,3,5,21113,4,3292,3298, ,1,0,0,21113,3,18,15,-6,3
2025-08-05,6719,35,5,21113,38,3284,3292, ,0,0,0,21113,21,39,18,-8,21
2025-08-06,6719,142,0,21113,39,3387,3284, ,0,21,0,21113,8,26,39,103,-13
2025-08-07,6719,11,4,21113,25,3369,3387, ,0,2,0,21113,4,28,26,-18,2
2025-08-08,6719,13,1,21113,25,3356,3369, ,0,9,0,21113,2,21,28,-13,-7
2025-08-11,6719,5,1,21113,8,3352,3356, ,0,5,0,21113,0,16,21,-4,-5
2025-08-12,6719,9,0,21113,18,3343,3352, ,0,0,0,21113,1,17,16,-9,1
2025-08-13,6719,4,0,21113,15,3332,3343, ,0,0,0,21113,1,18,17,-11,1
2025-08-14,6719,7,5,21115,4,3330,3332, ,0,12,0,21115,0,6,18,-2,-12
2025-08-15,6719,5,31,21115,9,3295,3330, ,0,2,0,21115,0,4,6,-35,-2
2025-08-18,6719,22,1,21115,473,2843,3295, ,0,1,0,21115,4,7,4,-452,3
2025-08-19,6719,7,3,21115,8,2839,2843, ,0,1,0,21115,0,6,7,-4,-1
2025-08-20,6719,37,3,21115,256,2617,2839, ,1,0,0,21115,2,8,6,-222,2
2025-08-21,6719,3,1,21115,2,2617,2617, ,0,1,0,21115,0,7,8,0,-1
2025-08-22,6719,6,0,21115,7,2616,2617, ,0,0,0,21115,1,8,7,-1,1
2025-08-25,6719,7,6,21115,13,2604,2616, ,0,1,0,21115,0,7,8,-12,-1
2025-08-26,6719,10,4,21115,3,2607,2604, ,0,2,0,21115,0,5,7,3,-2
2025-08-27,6719,17,3,21115,23,2598,2607, ,0,1,0,21115,0,4,5,-9,-1
2025-08-28,6719,30,3,21115,10,2615,2598, ,0,0,0,21115,0,4,4,17,0
2025-08-29,6719,8,0,21115,3,2620,2615, ,1,0,0,21115,1,5,4,5,1
2025-09-01,6719,12,8,21115,187,2437,2620, ,3,1,0,21115,2,6,5,-183,1
2025-09-02,6719,16,2,21115,7,2444,2437, ,0,0,0,21115,0,6,6,7,0
2025-09-03,6719,10,5,21115,15,2434,2444, ,0,1,0,21115,1,6,6,-10,0
2025-09-04,6719,4,2,21115,18,2418,2434, ,0,0,0,21115,0,6,6,-16,0
2025-09-05,6719,14,1,21115,7,2424,2418, ,0,0,0,21115,0,6,6,6,0
2025-09-08,6719,83,3,21115,59,2445,2424, ,0,1,0,21115,2,7,6,21,1
2025-09-09,6719,21,0,21115,5,2461,2445, ,1,0,0,21115,0,7,7,16,0
2025-09-10,6719,29,4,21115,10,2476,2461, ,0,1,0,21115,0,6,7,15,-1
2025-09-11,6719,16,7,21115,19,2466,2476, ,0,0,0,21115,0,6,6,-10,0
2025-09-12,6719,47,1,21115,20,2492,2466, ,0,0,0,21115,3,9,6,26,3
2025-09-15,6719,88,1,21115,30,2549,2492, ,0,0,0,21115,0,9,9,57,0
2025-09-16,6719,40,1,21115,67,2521,2549, ,0,0,0,21115,0,9,9,-28,0
2025-09-17,6719,65,3,21115,84,2499,2521, ,0,0,0,21115,2,11,9,-22,2
2025-09-18,6719,55,9,21115,99,2446,2499, ,4,0,0,21115,1,12,11,-53,1
2025-09-19,6719,18,4,21115,36,2424,2446, ,1,0,0,21115,0,12,12,-22,0
2025-09-22,6719,29,10,21115,62,2381,2424, ,0,0,0,21115,4,16,12,-43,4
2025-09-23,6719,13,1,21115,82,2311,2381, ,0,0,0,21115,0,16,16,-70,0
2025-06-25,6768,153,0,50023,347,2216,2410, ,0,2,0,50023,7,9,4,-194,5
2025-06-26,6768,131,4,50023,78,2265,2216, ,0,4,0,50023,1,6,9,49,-3
2025-06-27,6768,118,0,50023,79,2304,2265, ,0,1,0,50023,2,7,6,39,1
2025-06-30,6768,62,0,50023,41,2325,2304, ,0,4,0,50023,0,3,7,21,-4
2025-07-01,6768,43,0,50023,64,2304,2325, ,0,0,0,50023,0,3,3,-21,0
2025-07-02,6768,40,0,50023,165,2179,2304, ,1,0,0,50023,1,4,3,-125,1
2025-07-03,6768,893,0,50023,295,2777,2179, ,8,0,0,50023,7,11,4,598,7
2025-07-04,6768,186,0,50023,389,2574,2777, ,0,1,0,50023,9,19,11,-203,8
2025-07-07,6768,45,0,50023,134,2485,2574, ,0,6,0,50023,0,13,19,-89,-6
2025-07-08,6768,144,2,50023,171,2456,2485, ,0,3,0,50023,5,15,13,-29,2
2025-07-09,6768,247,0,50023,126,2577,2456, ,3,6,0,50023,5,14,15,121,-1
2025-07-10,6768,69,0,50023,89,2557,2577, ,0,2,0,50023,2,14,14,-20,0
2025-07-11,6768,45,0,50023,19,2583,2557, ,0,3,0,50023,0,11,14,26,-3
2025-07-14,6768,28,0,50023,81,2530,2583, ,0,0,0,50023,1,12,11,-53,1
2025-07-15,6768,15,0,50023,26,2519,2530, ,0,0,0,50023,0,12,12,-11,0
2025-07-16,6768,33,2,50023,9,2541,2519, ,0,1,0,50023,0,11,12,22,-1
2025-07-17,6768,45,8,50023,67,2511,2541, ,0,3,0,50023,0,8,11,-30,-3
2025-07-18,6768,40,2,50023,47,2502,2511, ,0,0,0,50023,0,8,8,-9,0
2025-07-21,6768,25,0,50023,57,2470,2502, ,0,1,0,50023,3,10,8,-32,2
2025-07-22,6768,194,0,50023,74,2590,2470, ,0,2,0,50023,5,13,10,120,3
2025-07-23,6768,25,0,50023,32,2583,2590, ,0,3,0,50023,3,13,13,-7,0
2025-07-24,6768,84,0,50023,45,2622,2583, ,0,3,0,50023,0,10,13,39,-3
2025-07-25,6768,31,0,50023,13,2640,2622, ,0,0,0,50023,0,10,10,18,0
2025-07-28,6768,35,0,50023,63,2612,2640, ,0,1,0,50023,1,10,10,-28,0
2025-07-29,6768,37,1,50023,100,2548,2612, ,0,0,0,50023,0,10,10,-64,0
2025-07-30,6768,24,0,50023,53,2519,2548, ,0,0,0,50023,0,10,10,-29,0
2025-07-31,6768,12,0,50023,30,2501,2519, ,0,1,0,50023,0,9,10,-18,-1
2025-08-01,6768,12,0,50023,6,2507,2501, ,0,0,0,50023,0,9,9,6,0
2025-08-04,6768,14,0,50023,32,2489,2507, ,0,1,0,50023,10,18,9,-18,9
2025-08-05,6768,21,0,50023,73,2437,2489, ,0,1,0,50023,0,17,18,-52,-1
2025-08-06,6768,15,0,50023,157,2295,2437, ,0,0,0,50023,4,21,17,-142,4
2025-08-07,6768,52,0,50023,66,2281,2295, ,0,0,0,50023,0,21,21,-14,0
2025-08-08,6768,88,7,50023,144,2218,2281, ,5,5,0,50023,0,16,21,-63,-5
2025-08-11,6768,38,1,50023,39,2216,2218, ,0,0,0,50023,0,16,16,-2,0
2025-08-12,6768,86,0,50023,131,2171,2216, ,0,1,0,50023,6,21,16,-45,5
2025-08-13,6768,31,0,50023,39,2163,2171, ,0,0,0,50023,9,30,21,-8,9
2025-08-14,6768,124,0,50023,126,2161,2163, ,0,1,0,50023,5,34,30,-2,4
2025-08-15,6768,43,0,50023,65,2139,2161, ,0,0,0,50023,7,41,34,-22,7
2025-08-18,6768,213,0,50023,119,2233,2139, ,0,0,0,50023,0,41,41,94,0
2025-08-19,6768,144,0,50023,58,2319,2233, ,0,0,0,50023,5,46,41,86,5
2025-08-20,6768,42,2,50023,35,2324,2319, ,0,1,0,50023,0,45,46,5,-1
2025-08-21,6768,38,0,50023,12,2350,2324, ,0,0,0,50023,0,45,45,26,0
2025-08-22,6768,30,0,50023,68,2312,2350, ,0,8,0,50023,0,37,45,-38,-8
2025-08-25,6768,12,0,50023,33,2291,2312, ,0,0,0,50023,3,40,37,-21,3
2025-08-26,6768,48,0,50023,13,2326,2291, ,0,0,0,50023,3,43,40,35,3
2025-08-27,6768,6,1,50023,45,2286,2326, ,0,0,0,50023,6,49,43,-40,6
2025-08-28,6768,105,0,50023,78,2313,2286, ,1,0,0,50023,9,58,49,27,9
2025-08-29,6768,33,0,50023,85,2261,2313, ,0,0,0,50023,9,67,58,-52,9
2025-09-01,6768,27,0,50023,10,2278,2261, ,0,0,0,50023,0,67,67,17,0
2025-09-02,6768,98,1,50023,18,2357,2278, ,0,0,0,50023,0,67,67,79,0
2025-09-03,6768,83,0,50023,46,2394,2357, ,0,0,0,50023,0,67,67,37,0
2025-09-04,6768,53,0,50023,40,2407,2394, ,1,0,0,50023,0,67,67,13,0
2025-09-05,6768,30,0,50023,18,2419,2407, ,0,4,0,50023,18,81,67,12,14
2025-09-08,6768,132,0,50023,24,2527,2419, ,0,68,0,50023,2,15,81,108,-66
2025-09-09,6768,10,0,50023,30,2507,2527, ,0,0,0,50023,0,15,15,-20,0
2025-09-10,6768,87,0,50023,22,2572,2507, ,0,1,0,50023,0,14,15,65,-1
2025-09-11,6768,66,15,50023,100,2523,2572, ,0,0,0,50023,0,14,14,-49,0
2025-09-12,6768,21,0,50023,15,2529,2523, ,0,0,0,50023,0,14,14,6,0
2025-09-15,6768,10,0,50023,11,2528,2529, ,0,0,0,50023,0,14,14,-1,0
2025-09-16,6768,17,15,50023,10,2520,2528, ,0,0,1,50023,0,13,14,-8,-1
2025-09-17,6768,18,14,50023,30,2494,2520, ,0,0,0,50023,0,13,13,-26,0
2025-09-18,6768,247,1,50023,163,2577,2494, ,0,4,1,50023,0,8,13,83,-5
2025-09-19,6768,101,0,50023,129,2549,2577, ,0,3,0,50023,0,5,8,-28,-3
2025-09-22,6768,44,0,50023,69,2524,2549, ,0,0,0,50023,0,5,5,-25,0
2025-09-23,6768,75,0,50023,66,2533,2524, ,0,0,0,50023,11,16,5,9,11
2025-06-25,6770,308,15,1047086,516,35518,35741, ,0,22,0,1047086,31,2135,2126,-223,9
2025-06-26,6770,426,11,1047086,546,35387,35518, ,1,491,0,1047086,98,1742,2135,-131,-393
2025-06-27,6770,623,27,1047086,300,35683,35387, ,2,1,0,1047086,43,1784,1742,296,42
2025-06-30,6770,284,5,1047086,244,35718,35683, ,0,35,2,1047086,12,1759,1784,35,-25
2025-07-01,6770,636,14,1047086,321,36019,35718, ,0,11,0,1047086,106,1854,1759,301,95
2025-07-02,6770,2469,6,1047086,978,37504,36019, ,10,212,0,1047086,204,1846,1854,1485,-8
2025-07-03,6770,9410,8,1047086,3997,42909,37504, ,54,167,0,1047086,962,2641,1846,5405,795
2025-07-04,6770,9462,90,1047086,9923,42358,42909, ,195,365,0,1047086,990,3266,2641,-551,625
2025-07-07,6770,1410,10,1047086,2064,41694,42358, ,18,487,0,1047086,601,3380,3266,-664,114
2025-07-08,6770,3112,27,1047086,2777,42002,41694, ,38,823,2,1047086,268,2823,3380,308,-557
2025-07-09,6770,2074,34,1047086,1915,42127,42002, ,11,371,2,1047086,328,2778,2823,125,-45
2025-07-10,6770,1477,18,1047086,893,42693,42127, ,7,614,1,1047086,83,2246,2778,566,-532
2025-07-11,6770,1192,34,1047086,1814,42037,42693, ,70,174,0,1047086,296,2368,2246,-656,122
2025-07-14,6770,503,8,1047228,1103,41429,42037, ,6,243,0,1047228,63,2188,2368,-608,-180
2025-07-15,6770,538,56,1047228,535,41376,41429, ,8,20,0,1047228,54,2222,2188,-53,34
2025-07-16,6770,472,3,1047228,661,41184,41376, ,7,36,0,1047228,42,2228,2222,-192,6
2025-07-17,6770,718,23,1047228,779,41100,41184, ,4,28,0,1047228,86,2286,2228,-84,58
2025-07-18,6770,874,19,1047228,933,41022,41100, ,5,11,0,1047228,42,2317,2286,-78,31
2025-07-21,6770,2151,34,1047228,862,42277,41022, ,7,31,0,1047228,78,2364,2317,1255,47
2025-07-22,6770,2807,18,1047228,3386,41676,42273, ,39,140,0,1047228,36,2260,2364,-597,-104
2025-07-23,6770,2553,6,1047228,1718,42505,41676, ,10,264,0,1047228,129,2125,2260,829,-135
2025-07-24,6770,1929,0,1047228,1013,43421,42505, ,23,247,0,1047228,199,2077,2125,916,-48
2025-07-25,6770,493,29,1047228,400,43485,43421, ,2,107,0,1047228,168,2138,2077,64,61
2025-07-28,6770,845,10,1047228,501,43819,43485, ,4,180,0,1047228,156,2114,2138,334,-24
2025-07-29,6770,755,11,1047228,678,43885,43819, ,10,39,0,1047228,67,2142,2114,66,28
2025-07-30,6770,806,12,1047228,1124,43555,43885, ,7,133,0,1047228,477,2486,2142,-330,344
2025-07-31,6770,819,27,1047228,378,43969,43555, ,2,481,0,1047228,26,2031,2486,414,-455
2025-08-01,6770,296,6,1047228,685,43574,43969, ,7,146,0,1047228,43,1928,2031,-395,-103
2025-08-04,6770,815,311,1047228,162,43916,43574, ,4,210,0,1047228,78,1796,1928,342,-132
2025-08-05,6770,465,26,1047228,762,43593,43916, ,1,94,0,1047228,200,1902,1796,-323,106
2025-08-06,6770,264,10,1047228,663,43184,43593, ,2,180,0,1047228,67,1789,1902,-409,-113
2025-08-07,6770,792,6,1047228,477,43493,43184, ,2,130,0,1047228,137,1796,1789,309,7
2025-08-08,6770,526,16,1047228,543,43460,43493, ,1,36,1,1047228,102,1861,1796,-33,65
2025-08-11,6770,188,8,1047228,178,43462,43460, ,3,135,0,1047228,130,1856,1861,2,-5
2025-08-12,6770,320,234,1047228,946,42602,43462, ,1,9,0,1047228,71,1918,1856,-860,62
2025-08-13,6770,633,14,1047228,822,42399,42602, ,2,52,0,1047228,21,1887,1918,-203,-31
2025-08-14,6770,569,27,1047482,1222,41719,42399, ,0,0,0,1047482,264,2151,1887,-680,264
2025-08-15,6770,316,15,1047482,668,41352,41719, ,0,32,0,1047482,90,2209,2151,-367,58
2025-08-18,6770,396,6,1047482,1468,40274,41352, ,1,170,75,1047482,95,2059,2209,-1078,-150
2025-08-19,6770,402,0,1047482,663,40013,40274, ,1,22,0,1047482,55,2092,2059,-261,33
2025-08-20,6770,524,20,1047482,423,40094,40013, ,3,207,0,1047482,31,1916,2092,81,-176
2025-08-21,6770,379,4,1047482,748,39721,40094, ,1,8,0,1047482,140,2048,1916,-373,132
2025-08-22,6770,420,0,1047482,538,39603,39721, ,13,86,0,1047482,13,1975,2048,-118,-73
2025-08-25,6770,288,10,1047482,1034,38847,39603, ,2,21,0,1047482,17,1971,1975,-756,-4
2025-08-26,6770,322,21,1047482,382,38766,38847, ,2,18,0,1047482,21,1974,1971,-81,3
2025-08-27,6770,234,5,1047482,766,38229,38766, ,2,14,0,1047482,19,1979,1974,-537,5
2025-08-28,6770,327,2,1047482,496,38058,38229, ,0,10,0,1047482,69,2038,1979,-171,59
2025-08-29,6770,761,300,1047482,347,38172,38058, ,2,76,0,1047482,45,2007,2038,114,-31
2025-09-01,6770,289,1,1047482,426,38034,38172, ,1,73,0,1047482,90,2024,2007,-138,17
2025-09-02,6770,533,5,1047482,453,38109,38034, ,6,93,0,1047482,44,1975,2024,75,-49
2025-09-03,6770,443,7,1047482,341,38204,38109, ,1,8,0,1047482,38,2005,1975,95,30
2025-09-04,6770,537,17,1047482,419,38305,38204, ,3,119,0,1047482,110,1996,2005,101,-9
2025-09-05,6770,552,14,1047482,1187,37656,38305, ,10,67,0,1047482,122,2051,1996,-649,55
2025-09-08,6770,2453,20,1047482,1935,38154,37656, ,25,158,0,1047482,159,2052,2051,498,1
2025-09-09,6770,379,32,1047482,1553,36948,38154, ,3,76,0,1047482,58,2034,2052,-1206,-18
2025-09-10,6770,1339,2,1047482,1291,36994,36948, ,70,86,0,1047482,115,2063,2034,46,29
2025-09-11,6770,3338,18,1047482,2518,37796,36994, ,38,34,0,1047482,175,2204,2063,802,141
2025-09-12,6770,11818,22,1047646,6428,43164,37796, ,276,185,0,1047646,486,2505,2204,5368,301
2025-09-15,6770,4820,64,1047646,2855,45065,43164, ,4,303,0,1047646,1923,4125,2505,1901,1620
2025-09-16,6770,2824,25,1047646,7322,40542,45065, ,79,1568,2,1047646,787,3342,4125,-4523,-783
2025-09-17,6770,12361,2,1047646,8979,43922,40542, ,401,356,1,1047646,2015,5000,3342,3380,1658
2025-09-18,6770,21538,1,1047646,7583,57876,43922, ,435,502,0,1047646,2528,7026,5000,13954,2026
2025-09-19,6770,9422,35,1047646,23521,43742,57876, ,540,1419,8,1047646,2208,7807,7026,-14134,781
2025-09-22,6770,8415,934,1047646,3331,47892,43742, ,122,2243,5,1047646,239,5798,7807,4150,-2009
2025-09-23,6770,16090,16,1047646,8066,55900,47892, ,182,487,2,1047646,4125,9434,5798,8008,3636
2025-06-25,8046,190,9,161541,118,6053,5990, ,0,91,0,161541,2,221,310,63,-89
2025-06-26,8046,95,4,161541,129,6015,6053,X ,0,75,10,161541,1,137,221,-38,-84
2025-06-27,8046,117,11,161541,146,5975,6015,X ,0,135,0,161541,0,2,137,-40,-135
2025-06-30,8046,54,13,161541,83,5933,5975,X ,0,0,2,161541,0,0,2,-42,-2
2025-07-01,8046,156,8,161541,214,5867,5933,X ,0,0,0,161541,0,0,0,-66,0
2025-07-02,8046,89,7,161541,131,5818,5867, ,0,0,0,161541,0,0,0,-49,0
2025-07-03,8046,1239,8,161541,913,6136,5818, ,116,0,0,161541,401,401,0,318,401
2025-07-04,8046,1017,7,161541,824,6322,6136, ,1121,88,0,161541,349,662,401,186,261
2025-07-07,8046,1730,14,161541,965,7073,6322, ,143,155,1,161541,139,645,662,751,-17
2025-07-08,8046,697,4,161541,606,7160,7073, ,8,75,2,161541,305,873,645,87,228
2025-07-09,8046,1423,21,161541,1598,6964,7160, ,17,143,0,161541,1090,1820,873,-196,947
2025-07-10,8046,1850,4,161541,1502,7308,6964, ,43,340,0,161541,407,1887,1820,344,67
2025-07-11,8046,1364,2,161541,1184,7486,7308, ,149,211,1,161541,389,2064,1887,178,177
2025-07-14,8046,810,0,161541,1655,6641,7486, ,123,217,0,161541,97,1944,2064,-845,-120
2025-07-15,8046,2852,10,161541,1173,8310,6641, ,5,67,23,161541,814,2668,1944,1669,724
2025-07-16,8046,1646,0,161541,3645,6311,8310, ,42,222,1,161541,1421,3866,2668,-1999,1198
2025-07-17,8046,1991,6,161541,1501,6795,6311, ,10,657,0,161541,51,3260,3866,484,-606
2025-07-18,8046,2417,0,161541,936,8276,6795, ,26,275,214,161541,174,2945,3260,1481,-315
2025-07-21,8046,1373,0,161541,1074,8575,8276, ,35,184,11,161541,82,2832,2945,299,-113
2025-07-22,8046,908,1,161541,1933,7550,8576, ,11,273,0,161541,150,2709,2832,-1026,-123
2025-07-23,8046,3044,0,161541,1812,8782,7550, ,43,161,5,161541,213,2756,2709,1232,47
2025-07-24,8046,1858,6,161541,1450,9184,8782, ,32,68,2,161541,544,3230,2756,402,474
2025-07-25,8046,1914,6,161541,2383,8709,9184, ,88,125,0,161541,441,3546,3230,-475,316
2025-07-28,8046,1208,0,161541,1368,8549,8709, ,24,75,2,161541,106,3575,3546,-160,29
2025-07-29,8046,1652,2,161541,1914,8285,8549, ,24,268,0,161541,43,3350,3575,-264,-225
2025-07-30,8046,583,0,161541,865,8003,8285, ,11,49,0,161541,130,3431,3350,-282,81
2025-07-31,8046,487,3,161541,1122,7365,8003, ,8,243,4,161541,58,3242,3431,-638,-189
2025-08-01,8046,476,11,161541,881,6949,7365, ,10,157,30,161541,65,3120,3242,-416,-122
2025-08-04,8046,681,0,161541,338,7292,6949, ,2,58,0,161541,44,3106,3120,343,-14
2025-08-05,8046,580,1,161541,435,7436,7292, ,20,37,0,161541,30,3099,3106,144,-7
2025-08-06,8046,377,6,161541,543,7264,7436, ,1,103,0,161541,16,3012,3099,-172,-87
2025-08-07,8046,437,1,161541,298,7402,7264, ,2,76,50,161541,39,2925,3012,138,-87
2025-08-08,8046,846,9,161541,789,7450,7402, ,7,199,0,161541,68,2794,2925,48,-131
2025-08-11,8046,1459,4,161541,1317,7588,7450, ,19,116,0,161541,368,3046,2794,138,252
2025-08-12,8046,847,0,161541,531,7904,7588, ,4,95,1,161541,29,2979,3046,316,-67
2025-08-13,8046,494,2,161541,1498,6898,7904, ,37,85,0,161541,62,2956,2979,-1006,-23
2025-08-14,8046,375,2,161541,498,6773,6898, ,5,87,25,161541,29,2873,2956,-125,-83
2025-08-15,8046,681,10,161541,420,7024,6773, ,11,112,5,161541,83,2839,2873,251,-34
2025-08-18,8046,1066,8,161541,1571,6511,7024, ,27,118,34,161541,289,2976,2839,-513,137
2025-08-19,8046,2111,2,161541,1231,7389,6511, ,22,92,0,161541,24,2908,2976,878,-68
2025-08-20,8046,1243,9,161541,1196,7427,7389, ,7,769,0,161541,241,2380,2908,38,-528
2025-08-21,8046,346,26,161541,321,7426,7427, ,0,57,19,161541,92,2396,2380,-1,16
2025-08-22,8046,628,0,161541,325,7729,7426, ,1,79,0,161541,80,2397,2396,303,1
2025-08-25,8046,2988,8,161541,1717,8992,7729, ,11,243,1,161541,437,2590,2397,1263,193
2025-08-26,8046,2724,2,161541,3792,7922,8992, ,25,76,0,161541,105,2619,2590,-1070,29
2025-08-27,8046,4579,4,161541,2023,10474,7922, ,33,68,7,161541,624,3168,2619,2552,549
2025-08-28,8046,1804,3,161541,2761,9514,10474, ,66,269,3,161541,702,3598,3168,-960,430
2025-08-29,8046,2980,0,161541,3667,8827,9514, ,32,844,0,161541,54,2808,3598,-687,-790
2025-09-01,8046,1834,0,161541,2226,8435,8827, ,34,498,6,161541,246,2550,2808,-392,-258
2025-09-02,8046,1139,7,161541,967,8600,8435, ,7,154,1,161541,137,2532,2550,165,-18
2025-09-03,8046,910,4,161541,350,9156,8600, ,9,164,1,161541,31,2398,2532,556,-134
2025-09-04,8046,1503,2,161541,589,10068,9156, ,5,123,1,161541,24,2298,2398,912,-100
2025-09-05,8046,1022,5,161541,293,10792,10068, ,23,50,1,161541,330,2577,2298,724,279
2025-09-08,8046,376,1,161541,735,10432,10792, ,2,160,0,161541,69,2486,2577,-360,-91
2025-09-09,8046,541,1,161541,457,10515,10432, ,6,125,0,161541,8,2369,2486,83,-117
2025-09-10,8046,667,7,161541,387,10788,10515, ,4,30,0,161541,22,2361,2369,273,-8
2025-09-11,8046,1054,8,161541,537,11297,10788, ,7,62,0,161541,78,2377,2361,509,16
2025-09-12,8046,383,5,161541,580,11095,11297, ,13,36,1,161541,221,2561,2377,-202,184
2025-09-15,8046,214,7,161541,603,10699,11095, ,10,172,5,161541,13,2397,2561,-396,-164
2025-09-16,8046,1598,5,161541,1269,11023,10699, ,13,662,0,161541,633,2368,2397,324,-29
2025-09-17,8046,2952,0,161541,2152,11823,11023, ,40,308,0,161541,158,2218,2368,800,-150
2025-09-18,8046,1851,0,161541,1487,12187,11823, ,4,230,0,161541,170,2158,2218,364,-60
2025-09-19,8046,3740,2,161541,3127,12798,12187, ,54,158,3,161541,405,2402,2158,611,244
2025-09-22,8046,4377,0,161541,3870,13305,12798, ,36,194,0,161541,264,2472,2402,507,70
2025-09-23,8046,2354,3,161541,5001,10655,13305, ,36,172,0,161541,80,2380,2472,-2650,-92
2025-06-25,8105,35,1,72140,18,9826,9810, ,0,0,0,72140,6,64,58,16,6
2025-06-26,8105,57,0,72140,29,9854,9826, ,0,0,0,72140,9,73,64,28,9
2025-06-27,8105,165,2,72140,101,9916,9854, ,0,10,0,72140,5,68,73,62,-5
2025-06-30,8105,117,0,72140,11,10022,9916, ,0,4,0,72140,15,79,68,106,11
2025-07-01,8105,15,0,72140,24,10013,10022, ,0,0,0,72140,2,81,79,-9,2
2025-07-02,8105,76,0,72140,4,10085,10013, ,0,0,0,72140,0,81,81,72,0
2025-07-03,8105,147,3,72140,53,10176,10085, ,1,29,0,72140,0,52,81,91,-29
2025-07-04,8105,180,2,72140,191,10163,10176, ,11,2,0,72140,5,55,52,-13,3
2025-07-07,8105,397,51,72140,209,10300,10163, ,10,0,0,72140,23,78,55,137,23
2025-07-08,8105,292,10,72140,56,10526,10300, ,0,18,0,72140,2,62,78,226,-16
2025-07-09,8105,145,1,72140,92,10578,10526, ,0,20,0,72140,27,69,62,52,7
2025-07-10,8105,103,0,72140,53,10628,10578, ,0,7,0,72140,2,64,69,50,-5
2025-07-11,8105,59,0,72140,55,10632,10628, ,0,1,0,72140,0,63,64,4,-1
2025-07-14,8105,1330,2,72140,930,11030,10632, ,6,2,0,72140,105,166,63,398,103
2025-07-15,8105,1061,0,72140,843,11248,11030, ,32,22,0,72140,78,222,166,218,56
2025-07-16,8105,751,0,72140,433,11566,11248, ,5,88,0,72140,21,155,222,318,-67
2025-07-17,8105,333,0,72140,176,11723,11566, ,4,18,0,72140,6,143,155,157,-12
2025-07-18,8105,613,1,72140,551,11784,11723, ,6,12,0,72140,6,137,143,61,-6
2025-07-21,8105,137,5,72140,402,11514,11784, ,1,28,0,72140,10,119,137,-270,-18
2025-07-22,8105,212,1,72140,357,11368,11514, ,0,0,0,72140,7,126,119,-146,7
2025-07-23,8105,82,0,72140,185,11265,11368, ,1,25,0,72140,2,103,126,-103,-23
2025-07-24,8105,65,0,72140,114,11216,11265, ,0,3,0,72140,1,101,103,-49,-2
2025-07-25,8105,66,5,72140,125,11152,11216, ,0,0,0,72140,0,101,101,-64,0
2025-07-28,8105,75,0,72140,194,11033,11152, ,2,1,0,72140,3,103,101,-119,2
2025-07-29,8105,36,535,72140,151,10383,11033, ,1,2,0,72140,3,104,103,-650,1
2025-07-30,8105,95,0,72140,65,10413,10383, ,0,2,0,72140,0,102,104,30,-2
2025-07-31,8105,66,1,72140,60,10418,10413, ,0,2,0,72140,0,100,102,5,-2
2025-08-01,8105,36,0,72140,21,10433,10418, ,0,13,0,72140,0,87,100,15,-13
2025-08-04,8105,70,0,72140,100,10403,10433, ,0,0,0,72140,3,90,87,-30,3
2025-08-05,8105,979,0,72140,550,10832,10403, ,3,0,0,72140,45,135,90,429,45
2025-08-06,8105,303,0,72140,257,10878,10832, ,1,12,0,72140,87,210,135,46,75
2025-08-07,8105,411,0,72140,214,11075,10878, ,3,97,0,72140,4,117,210,197,-93
2025-08-08,8105,121,2,72140,129,11065,11075, ,0,2,0,72140,2,117,117,-10,0
2025-08-11,8105,127,30,72140,77,11085,11065, ,0,28,0,72140,2,91,117,20,-26
2025-08-12,8105,285,0,72140,65,11305,11085, ,0,3,0,72140,0,88,91,220,-3
2025-08-13,8105,137,0,72140,45,11397,11305, ,0,10,0,72140,1,79,88,92,-9
2025-08-14,8105,176,4,72140,76,11493,11397, ,0,0,0,72140,1,80,79,96,1
2025-08-15,8105,40,1,72140,180,11352,11493, ,0,2,0,72140,24,102,80,-141,22
2025-08-18,8105,85,0,72140,669,10768,11352, ,1,8,0,72140,0,94,102,-584,-8
2025-08-19,8105,68,0,72140,75,10761,10768, ,0,0,0,72140,0,94,94,-7,0
2025-08-20,8105,91,0,72140,22,10830,10761, ,0,1,0,72140,1,94,94,69,0
2025-08-21,8105,180,0,72140,134,10876,10830, ,1,2,0,72140,11,103,94,46,9
2025-08-22,8105,118,0,72140,32,10962,10876, ,0,1,0,72140,1,103,103,86,0
2025-08-25,8105,26,0,72140,46,10942,10962, ,0,0,0,72140,0,103,103,-20,0
2025-08-26,8105,41,0,72140,20,10963,10942, ,0,0,0,72140,1,104,103,21,1
2025-08-27,8105,74,0,72140,101,10936,10963, ,1,0,0,72140,27,131,104,-27,27
2025-08-28,8105,46,0,72140,203,10779,10936, ,0,4,0,72140,1,128,131,-157,-3
2025-08-29,8105,180,10,72140,30,10919,10779, ,0,1,0,72140,1,128,128,140,0
2025-09-01,8105,66,4,72140,54,10927,10919, ,0,1,0,72140,1,128,128,8,0
2025-09-02,8105,13,0,72140,33,10907,10927, ,0,41,0,72140,0,87,128,-20,-41
2025-09-03,8105,7,2,72140,43,10869,10907, ,0,0,0,72140,2,89,87,-38,2
2025-09-04,8105,25,1,72140,114,10779,10869, ,0,0,0,72140,1,90,89,-90,1
2025-09-05,8105,45,0,72140,16,10808,10779, ,0,34,0,72140,0,56,90,29,-34
2025-09-08,8105,31,50,72140,69,10720,10808, ,0,0,0,72140,0,56,56,-88,0
2025-09-09,8105,114,0,72140,79,10755,10720, ,0,35,0,72140,0,21,56,35,-35
2025-09-10,8105,38,0,72140,133,10660,10755, ,0,0,0,72140,0,21,21,-95,0
2025-09-11,8105,173,0,72140,298,10535,10660, ,0,1,0,72140,0,20,21,-125,-1
2025-09-12,8105,26,0,72140,64,10497,10535, ,1,0,0,72140,9,29,20,-38,9
2025-09-15,8105,124,0,72140,40,10581,10497, ,0,0,0,72140,1,30,29,84,1
2025-09-16,8105,28,0,72140,41,10568,10581, ,0,2,0,72140,0,28,30,-13,-2
2025-09-17,8105,78,2,72140,70,10574,10568, ,2,3,0,72140,8,33,28,6,5
2025-09-18,8105,34,14,72140,163,10431,10574, ,0,10,0,72140,3,26,33,-143,-7
2025-09-19,8105,45,0,72140,54,10422,10431, ,0,0,0,72140,0,26,26,-9,0
2025-09-22,8105,13,0,72140,12,10423,10422, ,0,0,0,72140,8,34,26,1,8
2025-09-23,8105,472,16,72140,149,10730,10423, ,0,0,0,72140,54,88,34,307,54
2025-06-25,9955,54,0,26128,32,2012,1990, ,1,38,0,26128,28,236,246,22,-10
2025-06-26,9955,36,1,26128,23,2024,2012, ,2,28,0,26128,6,214,236,12,-22
2025-06-27,9955,29,0,26128,20,2033,2024, ,0,8,0,26128,0,206,214,9,-8
2025-06-30,9955,37,0,26128,32,2038,2033, ,0,5,0,26128,4,205,206,5,-1
2025-07-01,9955,24,0,26128,33,2029,2038, ,1,3,0,26128,0,202,205,-9,-3
2025-07-02,9955,15,0,26128,14,2030,2029, ,1,0,0,26128,0,202,202,1,0
2025-07-03,9955,7,0,26128,14,2023,2030, ,0,3,0,26128,0,199,202,-7,-3
2025-07-04,9955,21,0,26128,45,1999,2023, ,0,10,0,26128,0,189,199,-24,-10
2025-07-07,9955,9,0,26128,73,1935,1999, ,0,1,0,26128,9,197,189,-64,8
2025-07-08,9955,9,5,26128,7,1932,1935, ,0,2,0,26128,2,197,197,-3,0
2025-07-09,9955,18,0,26128,13,1937,1932, ,0,1,0,26128,16,212,197,5,15
2025-07-10,9955,10,0,26128,63,1884,1937, ,0,0,0,26128,0,212,212,-53,0
2025-07-11,9955,13,0,26128,16,1881,1884, ,0,8,0,26128,2,206,212,-3,-6
2025-07-14,9955,45,0,26128,34,1892,1881, ,3,0,0,26128,7,213,206,11,7
2025-07-15,9955,9,0,26128,38,1863,1892, ,0,2,0,26128,4,215,213,-29,2
2025-07-16,9955,22,0,26128,3,1882,1863, ,0,13,0,26128,0,202,215,19,-13
2025-07-17,9955,7,0,26128,7,1882,1882, ,0,0,1,26128,5,206,202,0,4
2025-07-18,9955,18,0,26128,6,1894,1882, ,0,2,0,26128,0,204,206,12,-2
2025-07-21,9955,7,0,26128,61,1840,1894, ,0,1,0,26128,1,204,204,-54,0
2025-07-22,9955,43,0,26128,89,1794,1840, ,0,66,0,26128,1,139,204,-46,-65
2025-07-23,9955,17,0,26128,39,1772,1794, ,0,0,0,26128,17,156,139,-22,17
2025-07-24,9955,44,27,26128,18,1771,1772, ,0,10,0,26128,4,150,156,-1,-6
2025-07-25,9955,9,0,26128,23,1757,1771, ,0,0,0,26128,1,151,150,-14,1
2025-07-28,9955,21,0,26128,20,1758,1757, ,0,1,0,26128,0,150,151,1,-1
2025-07-29,9955,33,0,26128,20,1771,1758, ,1,1,0,26128,8,157,150,13,7
2025-07-30,9955,3,0,26128,15,1759,1771, ,0,0,0,26128,0,157,157,-12,0
2025-07-31,9955,14,0,26128,10,1763,1759, ,0,21,0,26128,0,136,157,4,-21
2025-08-01,9955,10,0,26128,15,1758,1763, ,0,1,0,26128,2,137,136,-5,1
2025-08-04,9955,80,1,26128,72,1765,1758, ,1,0,0,26128,6,143,137,7,6
2025-08-05,9955,22,0,26128,30,1757,1765, ,0,1,0,26128,1,143,143,-8,0
2025-08-06,9955,18,0,26128,17,1758,1757, ,0,0,0,26128,0,143,143,1,0
2025-08-07,9955,18,0,26128,27,1749,1758, ,0,15,0,26128,1,129,143,-9,-14
2025-08-08,9955,77,0,26128,89,1737,1749, ,0,1,0,26128,7,135,129,-12,6
2025-08-11,9955,61,3,26128,51,1744,1737, ,0,9,0,26128,0,126,135,7,-9
2025-08-12,9955,22,0,26128,109,1657,1744, ,0,1,0,26128,2,127,126,-87,1
2025-08-13,9955,25,0,26128,78,1604,1657, ,0,0,0,26128,3,130,127,-53,3
2025-08-14,9955,20,5,26128,10,1609,1604, ,2,0,0,26128,1,131,130,5,1
2025-08-15,9955,26,2,26128,12,1621,1609, ,0,5,0,26128,0,126,131,12,-5
2025-08-18,9955,9,1,26128,6,1623,1621, ,0,42,0,26128,6,90,126,2,-36
2025-08-19,9955,6,0,26128,7,1622,1623, ,0,4,0,26128,0,86,90,-1,-4
2025-08-20,9955,23,0,26128,20,1625,1622, ,0,1,0,26128,1,86,86,3,0
2025-08-21,9955,11,0,26128,23,1613,1625, ,0,0,0,26128,2,88,86,-12,2
2025-08-22,9955,16,0,26128,34,1595,1613, ,0,2,0,26128,0,86,88,-18,-2
2025-08-25,9955,43,1,26128,9,1628,1595, ,1,0,0,26128,0,86,86,33,0
2025-08-26,9955,22,0,26128,53,1597,1628, ,0,0,0,26128,0,86,86,-31,0
2025-08-27,9955,7,3,26128,42,1559,1597, ,0,3,0,26128,0,83,86,-38,-3
2025-08-28,9955,44,0,26128,84,1519,1559, ,0,0,0,26128,3,86,83,-40,3
2025-08-29,9955,40,27,26128,38,1494,1519, ,0,0,0,26128,0,86,86,-25,0
2025-09-01,9955,152,0,26128,45,1601,1494, ,9,0,0,26128,1,87,86,107,1
2025-09-02,9955,225,2,26128,154,1670,1601, ,15,33,0,26128,9,63,87,69,-24
2025-09-03,9955,318,0,26128,177,1811,1670, ,0,11,0,26128,20,72,63,141,9
2025-09-04,9955,77,0,26128,48,1840,1811, ,1,2,0,26128,4,74,72,29,2
2025-09-05,9955,213,0,26128,239,1814,1840, ,7,5,0,26128,28,97,74,-26,23
2025-09-08,9955,212,1,26128,28,1997,1814, ,0,4,0,26128,10,103,97,183,6
2025-09-09,9955,78,0,26128,83,1992,1997, ,10,0,0,26128,22,125,103,-5,22
2025-09-10,9955,53,0,26128,48,1997,1992, ,0,1,0,26128,27,151,125,5,26
2025-09-11,9955,38,0,26128,56,1979,1997, ,0,0,0,26128,10,161,151,-18,10
2025-09-12,9955,13,0,26128,60,1932,1979, ,0,3,0,26128,1,159,161,-47,-2
2025-09-15,9955,15,0,26128,14,1933,1932, ,0,7,0,26128,0,152,159,1,-7
2025-09-16,9955,39,0,26128,128,1844,1933, ,2,1,0,26128,12,163,152,-89,11
2025-09-17,9955,255,0,26128,213,1886,1844, ,0,0,0,26128,9,172,163,42,9
2025-09-18,9955,80,0,26128,56,1910,1886, ,0,17,0,26128,1,156,172,24,-16
2025-09-19,9955,90,0,26128,50,1950,1910, ,0,50,0,26128,0,106,156,40,-50
2025-09-22,9955,82,0,26128,101,1931,1950, ,0,2,0,26128,3,107,106,-19,1
2025-09-23,9955,96,0,26128,154,1873,1931, ,0,2,0,26128,3,108,107,-58,1
